a	x
a@l	e
aah	a
abc	ebisi
abc@l	ebisi
abcd@l	ebisidi
abcdefg@k	ebisidiiEfJi
abcs	ebisiz
abigail	@bxgel
able	ebxl
about	xbWt
above	xb^v
absolute	@bsxlut
absolutely	@bsxlutli
absorbent	xbscrbxnt
abu	xbu
abuse	xbyuz
abuses	xbyusIz
accept	@ksEpt
acceptable	@ksEptxbxl
accepted	@ksEptxd
accident	@ksxdEnt
accidentally	@ksxdEntxli
accidently	@ksxdEntli
accidents	@ksxdEnts
accordion	xkcrdixn
account	xkWnt
accused	xkyuzd
accustomed	xk^stxmd
achieve	xCiv
achieved	xCivd
achieves	xCivz
achieving	xCivIG
achoo	xCu
acknowledge	EknalxJ
acknowledged	EknalxJd
acquiesced	@kwIEst
acre	ekR
across	xkras
act	@kt
acting	@ktIG
action	@kCxn
activator	@ktxvetR
active	@ktIv
activities	@ktIvItiz
activity	@ktIvIti
actor	@ktR
actorfactormactor	@ktRf@ktRm@ktR
acts	@kts
actual	@kCuxl
actually	@kCuxli
ad	@d
adam	@dxm
adam's	@dxmz
add	@d
added	@dxd
addicted	xdIktxd
adding	@dIG
adds	@dz
adjustable	xJ^stxbxl
adjustment	xJ^stmxnt
adjustments	xJ^stmxnts
adorable	xdcrxbxl
adore	xdcr
adult	xd^lt
adults	xd^lts
advanced	@dv@nst
adventure	crdvEnCR
advice	crdvYs
advises	crdvYzxz
afford	xfcrd
afraid	xfred
africa	@frIkx
african	@frIkxn
after	@ftR
afternoon	@ftRnun
afterwards	@ftRwRdz
again	xgEn
against	xgEnst
age	eJ
aggie	@gi
aggravated	@grxvetxd
aggravating	@grxvetIG
aggressive	xgrEsIv
agnes	@gnxs
ago	xgo
agree	xgri
agreed	xgrid
ah	a
ahab	eh@b
ahead	xhEd
ahhah	aha
ahoy	xhO
aid	ed
aids	edz
aim	em
aimed	emd
ain't	ent
air	Er
airing	ErIG
airline	ErlYn
airplane	Erplen
airplane's	Erplenz
aisle	Yl
aisles	Ylz
al	@l
aladin	xl@dIn
aladin's	xl@dinz
alarm	xlarm
alcohol	@lkxhal
alex	@leks
alex's	@leksxz
alexander	@leks@ndR
alexander's	@leks@ndRz
alfredo	alfredo
algae	@lJi
ali	@li
alibi	@lIbY
alice	@lIs
alice's	@lIsIz
alicia's	xliSxz
alike	xlYk
alive	xlYv
all	cl
alldone	cld^n
allen	@lxn
alligator	@lIgetR
alligator's	@lIgetRz
allow	xlW
allowed	xlWd
ally	@li
almost	clmost
alone	xlon
along	xlcG
aloud	xlWd
alpha	@lfx
alphabet	@lfxbEt
alphabets	@lfxbEts
already	clrEdi
alright	clrYt
alrightie	clrYti
also	clso
although	clDo
altogether	cltugEDR
always	clwez
am	@m
amazed	xmezd
amazement	xmezmxnt
amazing	xmezIG
amazingly	xmezIGli
ambitious	@mbISxs
ambivalence	@mbIvxlxns
amelia	xmilyx
amen	amEn
america	xmErIkx
among	xm^G
amount	xmWnt
amused	xmyuzd
amusing	xmyuzIG
an	xn
ancient	enCxnt
and	@nd
andrea's	@ndri^z
andrew's	@ndruz
andy	@ndi
andy's	@ndiz
angel	@nJxl
angelica	@nJElIkx
angels	@nJxlz
angle	@ngxl
angry	@ngri
animal	@nxmxl
animals	@nxmxlz
animosity	@nxmasIti
ankle	@nkxl
ankles	@Gkxlz
ann	@n
anne	@n
annie	@ni
annie's	@niz
anniversary	@nxvRsRi
annoying	xnOIG
anorexic	@nxrEksIk
another	xn^DR
anotherthe	xn^DRDx
answer	@nsR
answered	@nsRd
answering	@nsRIG
answers	@nsRz
ant	@nt
anteater	@ntitR
antenna	@ntEnx
antennaes	@ntEnxz
antibiotic	@ntibYatIk
antibiotics	@ntibYatIks
antisocial	@ntisoSxl
ants	@nts
any	Eni
anybody	Enibadi
anyhow	EnihW
anymore	Enimcr
anyone	Eniw^n
anything	EniTIG
anytime	EnitYm
anyway	Eniwe
anyways	Eniwez
anywhere	EniWEr
apart	xpart
apartment	xpartmxnt
aplenty	xplEnti
apology	xpclxJi
apparent	xpErxnt
apparently	xpErxntli
appeals	xpilz
appearance	xpIrxnz
appeared	xpIrd
appetite	@pxtYt
appiesauce	@piscs
apple	@pxl
apples	@pxlz
applesauce	@pxlscs
appleses	@pxlzxz
applied	xplYd
applies	xplYz
apply	xplY
applying	xplYyIG
appointment	xpOntmxnt
appreciate	xpriSiet
appreciates	xpriSiets
approached	xproCt
appropriate	xpropriIt
apricot	@prIkat
apricots	@prikats
apron	eprxn
apronstring	eprxnstrIG
aquarium	xkwErixm
arc	ark
arches	arCxz
are	ar
area	Erix
areas	Erixz
areil	Erexl
aren't	arnt
arfarf	arfarf
argue	argyu
arguing	argyuIG
argument	argyumxnt
arise	xrYz
ark	ark
arm	arm
armadillo	armxdIlo
armhole	armhol
arms	armz
army	armi
aroonie	xruni
around	xrWnd
arrange	xrenJ
arranged	xrenJd
arrangements	xrenJmxnts
arranging	xrenJIG
array	xre
arrived	xrYvd
arriving	xrYvIG
art	art
arthur	arTR
article	artIkxl
articles	artIkxlz
artillery	artIlRi
arts	arts
as	@z
ashamed	xSemd
ashes	@Sxz
ashley	@Sli
ashley's	@Sliz
ashy	@Si
ask	@sk
asked	@skt
asking	@skIG
asks	@sks
asleep	xslip
asparagus	xspErxg^s
aspirate	@spxret
aspirated	@spxretxd
aspirates	@spxrets
aspirating	@spxretIG
assemble	xsEmbxl
asserting	xsRtIG
assistance	xsIstxns
associate	xsosiet
associated	xsosietId
associates	xsosiets
association	xsosieSxn
assortment	xsartmxnt
assume	xsum
assumed	xsumd
at	@t
ate	et
athe	eD
attach	xt@C
attached	xt@Ct
attaches	xt@Cxz
attack	xt@k
attacked	xt@kt
attacking	xt@kIG
attention	xtEnSxn
attic	@tIk
attitude	@txtud
attitude	@txtudz
attractive	xtr@ktIv
augmentin	cgmEntIn
august	cgxst
aunt	@nt
auntie	@nti
aunts	@nts
autograph	ctxgr@f
automatic	ctxm@tIk
automatically	ctxm@tIkli
automobile	ctxmxbil
avenue	@vxnu
averaging	@vrxJIG
avocado	avxCado
avocados	avxCadoz
aw	c
awake	xwek
awakening	xwekxnIG
aware	xwEr
away	xwe
awesome	cs^m
awful	cfxl
awfully	cfli
awfuls	cfxlz
awkward	ckwRd
ax	@ks
aye	Y
b	bi
b@l	bi
baa	ba
baa@o	ba
baba	baba
babac	babak
babar	babar
babars	babarz
babas	babaz
babble	b@bxl
babbling	b@bxlIG
babe	beb
babes	bebz
babies	bebiz
baboo	bxbu
baboon	bxbun
baby	bebi
baby's	bebiz
babycake	bebikek
babycakes	bebikeks
babydoll	bebidcl
babydolls	bebidclz
babysat	bebisIt
babysitter	bebisItR
babysitters	bebisItRz
back	b@k
backdoor	b@kdcr
backed	b@kt
backflips	b@kflIps
background	b@krWnd
backie	b@ki
backing	b@kIG
backordered	b@kcrdRd
backs	b@ks
backtwist	b@ktwIst
backward	b@kwRd
backwards	b@kwRdz
backwash	b@kwaS
backyard	b@kyard
bacon	bekxn
bacteria	b@ktIrix
bad	b@d
badido	bxdido
badly	b@dli
baebae	bebe
bag	b@g
baggie	b@gi
baggies	b@giz
baggy	b@gi
bags	b@gz
bah	ba
bailey	beli
bake	bek
baked	bekt
baker	bekR
baker's	bekRz
bakers	bekRz
bakes	beks
baking	bekIG
balance	b@lxnts
balcony	b@lkxni
bald	bcld
ball	bcl
ball's	bclz
ballerina	b@lxrinx
ballerinas	b@lxrinxz
ballet	b@le
ballgame	bclgem
ballie	bcli
balling	bclIG
balloon	bxlun
balloons	bxlunz
balls	bclz
balmex	bclmEks
balogna	bxloni
baloney	bxloni
balooga	bxlugx
baltimore	baltImcr
bam	b@m
bambi	b@mbi
bambi's	b@mbiz
bambis	b@mbiz
bamboo	b@mbu
banana	bxn@nx
bananas	bxn@nxz
band	b@nd
bandana	b@nd@nx
bands	b@ndz
bang	b@G
banged	b@Gd
banging	b@GIG
banillon	bxnIlxn
banjo	b@nJo
bank	b@Gk
banner	b@nR
bantam	b@ntxm
baps	b@ps
bar	bar
barbecue	barbxkyu
barbells	barbElz
barber	barbR
barbie	barbi
barbies	barbiz
barbwire	barbwYr
barefoot	bErfUt
barefooted	bErfUtxd
barely	bErli
baring	bErIG
bark	bark
barked	barkt
barking	barkIG
barkley	barkli
barks	barks
barley	barli
barn	barn
barney	barni
barney's	barniz
barrel	bErxl
barrels	bErxlz
barrette	bxrEt
barrettes	bxrEts
barron	bErxn
barroon	bxrun
barroons	bxrunz
bars	barz
bart	bart
base	bes
baseball	besbcl
baseballs	besbclz
basement	besmxnt
bashful	b@Sfxl
basic	besIk
basically	besIkli
basics	besIks
basil	bezIl
basil's	bezIlz
basket	b@skIt
basket's	b@skIts
basketball	b@skItbcl
basketballs	b@skItbclz
basketful	b@skItfxl
baskets	b@skIts
baster	bestR
basty	besti
bat	b@t
bath	b@T
bathie	b@Ti
bathing	beDIG
bathingsuit	beDIGsut
bathingsuits	beDIGsuts
bathroom	b@Trum
bathrooms	b@Trumz
baths	b@Ts
bathtime	b@TtYm
bathtub	b@Tt^b
batman	b@tm@n
bats	b@ts
batter	b@tR
batteries	b@tRi
battery	b@tRiz
battery's	b@tRiz
battle	b@txl
batty	b@ti
bay	be
be	bi
beach	biC
bead	bid
beads	bidz
beady	bidi
beak	bik
bean	bin
beanbag	binb@g
beanie	bini
beans	binz
beanstalk	binstak
bear	bEr
bear's	bErz
bearbrown	bErrbrWn
beard	bIrd
bears	bErz
beast	bist
beastly	bistli
beat	bit
beaten	bitxn
beaters	bitRz
beating	bitIG
beatrix	biatrIks
beautician	byutISxn
beautiful	byutxfxl
beautifully	byutIfli
beauty	byuti
beavers	bivRz
bebe	bebe
became	bikem
because	bIk^z
become	bIk^m
becomes	bIk^mz
becoming	bik^mIG
bed	bEd
bed's	bEdz
beddybye	bEdibY
bedroom	bEdrum
beds	bEdz
bedspread	bEdsprEd
bedtime	bEdtYm
bee	bi
bee's	biz
beef	bif
been	bIn
beep	bip
beeper	bipR
beeps	bips
beer	bIr
bees	biz
beet	bit
beetie	biti
beetle	bitxl
beetles	bitxlz
beets	bits
before	bIfcr
beg	bEg
began	bIg@n
beggar	bEgR
begging	bEgIG
begin	bIgIn
beginner	bIgInR
beginning	bIgInIG
begins	bIgInz
begun	bIg^n
behaved	bihevd
behavior	bIhevyR
behind	bIhYnd
being	biIG
beings	biIGz
belch	bElC
belches	bElCxz
belief	bIlif
believe	bIliv
believed	bIlivd
believes	bIlivz
bell	bEl
bellies	bEliz
belligerent	bElIJRxnt
bellowed	bElod
bells	bElz
belly	bEli
bellybutton	bElib^txn
belong	bilcG
belongs	bIlcG
below	bIlo
belt	bElt
belts	bElts
ben	bEn
ben's	bEnz
bench	bEnC
bend	bEnd
bended	bEndxd
bending	bEndIG
beneath	bIniT
benjamin	bEnJxmIn
bent	bEnt
berries	bEriz
berry	bEri
bert	bRt
bert's	bRts
bertha's	bRTxz
beside	bIsYd
besides	bIsYdz
best	bEst
bestest	bEstEst
bet	bEt
beth	bET
better	bEtR
betty	bEti
between	bItwin
beverage	bEvRxJ
beyond	biand
bib	bIb
bibbie	bIbi
bible	bYbxl
bibs	bIbz
bicycle	bYsIkxl
bid	bId
big	bIg
bigger	bIgR
biggest	bIgIst
bike	bYk
bike's	bYks
bikes	bYks
bill	bIl
bills	bIlz
billy	bIli
bin	bIn
bing@o	bIG
bingo	bIGgo
binkie	bIGki
binkies	bIGkiz
binoculars	bYn^kyulRz
binya	bInyx
bird	bRd
bird's	bRdz
birdfeeder	bRdfidR
birdie	bRdi
birdie's	bRdiz
birdies	bRdiz
birds	bRdz
birth	bRT
birthday	bRTde
biscuits	bIskIts
bit	bIt
bite	bYt
bites	bYts
biting	bYtIG
bits	bIts
bitsy	bItsi
bitter	bItR
bitty	bIti
black	bl@k
blackberries	bl@kbEriz
blackberry	bl@kbEri
blackbird	bl@kbRd
blackbirds	bl@kbRdz
blade	bled
blades	bledz
blah	bla
blame	blem
blank	bl@Gk
blanket	bl@GkIt
blanketie	bl@GkIti
blankets	bl@GkIts
blankie	bl@Gki
blankies	bl@Gkiz
blast	bl@st
bleach	bliC
bleached	bliCt
bleaching	bliCIG
bleed	blid
blend	blEnd
blends	blEndz
bless	blEs
blessed	blEst
blessing	blEsIG
blessings	blEsIGz
blew	blu
blind	blYnd
blinds	blYndz
blink	blIGk
blinking	blIGkIG
block	blak
block's	blaks
blockbuster	blakb^stR
blocked	blakt
blockhead	blakhEd
blockie	blaki
blockies	blakiz
blocking	blakIG
blocks	blaks
blond	bland
blonde	bland
blood	bl^d
bloom	blum
blooming	blumIG
blossomed	blasxmd
blouse	blWs
blow	blo
blowing	blowIn
blows	bloz
blowup	blo^p
blue	blu
blue's	bluz
blueberries	blubEriz
blueberry	blubEri
blush	bl^S
blustery	bl^stRi
bo	bo
board	bcrd
boarded	bcrdxd
boat	bot
boats	bots
bob	bab
bobbing	babIG
bobbling	babxlIG
bobby	babi
bobo	bobo
boboneen	bobonin
boboni	boboni
boboon	bobun
boboonie	bobuni
body	badi
bog	bag
bogus	bog^s
boil	bOl
boiled	bOld
boiling	bOlIG
boing	bOG
bologna	bxloni
bond	band
bone	bon
boneen	bonin
boneen's	boninz
boneene	bonin
boneeno	bonino
bones	bonz
bong	baG
bongo	baGgo
bongos	baGgoz
bonk	baGk
bonked	baGkt
bonkie	baGki
bonking	baGkIG
bonnet	banIt
bonny	bani
bony	boni
boo	bu
boobie	bubi
booboo	bubu
boobooing@n	bubuIG
booboon	bubun
booboon's	bubunz
booboonee	bubuni
boobooneen	bubunin
boobooneen's	bubuninz
boobooneeno	bubunino
booboonino	bubunino
booboos	bubuz
boobooshas	bubuSxz
booger	bUgR
boogers	bUgRz
boogie	bUgi
boogies	bUgiz
boogyman	bUgim@n
book	bUk
bookbag	bUkb@g
bookcase	bUkkes
bookie	bUki
bookies	bUkiz
books	bUks
boom	bum
boom@o	bum
boomdie	bumdi
boomerang	bumxr@G
booms	bumz
boomsie	bumzi
booneenie	bunini
boonie	buni
boop	bup
boops@o	bups
boopsieboo	bupsibu
boosh	buS
booshaboosh	buSxbuS
boost	bust
booster	bustR
boot	but
bootiebooshas	butibuSxz
booties	butiz
boots	buts
booty	buti
bop	bap
bop's	baps
boppety	bapxti
bored	bcrd
boring	bcrIG
born	barn
borrowed	barod
borrowing	barowIn
bossing	basIG
boston	bastG
both	boT
bother	baDR
bothered	baDRd
bothering	baDRIG
bothers	baDRz
bottle	batxl
bottles	batxlz
bottom	batxm
bottoms	batxmz
bough	bW
bought	bct
bounce	bWnts
bounced	bWntst
bouncer	bWntsR
bounces	bWntsxz
bouncie	bWntsi
bouncing	bWntsIG
bouncy	bWntsi
bounder	bWndR
bounds	bWndz
bout	bWt
bow	bo
bowed	bWd
bowel	bWl
bowels	bWlz
bowing	bWIG
bowl	bol
bowls	bolz
bows	boz
bowwow	bWwW
bowwow@o	bWwW
box	baks
boxes	baksIz
boy	bO
boy's	bOz
boys	bOz
boyser	bOzR
boyz	bOz
bra	bra
bracelet	breslxt
braid	bred
braiding	bredIG
brain	bren
bran	br@n
branch	br@nC
branches	br@nCxz
brand	br@nd
brandnew	br@ndnu
brass	br@s
brat	br@t
brave	brev
bray	bre
bread	brEd
break	brek
breakable	brekxbxl
breakfast	brEkfxst
breaking	brekIG
breaks	breks
breast	brEst
breath	brET
breathe	briD
breather	briDR
breathing	briDIG
breeze	briz
brenda	brEndx
brenda's	brEndxz
brendan	brEndxn
brian	brYG
brick	brIk
bricks	brIks
bridge	brIJ
bridges	brIJIz
briefcase	brifkes
bright	brYt
brighter	brYtR
brightness	brYtnEs
brigitte	brIJit
brigitte's	brIJits
brilliant	brIlyxnt
bring	brIG
bringing	brIGIG
brings	brIGz
brisco	brIsko
brisco's	brIskoz
bristle	brIsxl
bristles	brIsxlz
britches	brItCxz
brittany	brItni
brittney	brItni
brittney's	brItniz
broad	brcd
broader	brcdR
broccoli	brcCxli
brocovich	brakxvIC
broke	brok
broken	brokxn
brokenhearted	brokxnhartxd
brook	brUk
brooklyn	brUklxn
broom	brum
brooms	brumz
broth	braT
brother	br^DR
brothers	br^DRz
brought	brct
brown	brWn
brownies	brWniz
browns	brWnz
brows	brWz
brr	bR
bruce	brus
bruise	bruz
bruised	bruzd
brunch	br^nC
brush	br^S
brusha	br^Sx
brushed	br^St
brushes	br^SIz
brushing	br^SIG
bub	b^b
bubbilicious	b^bIlISxs
bubble	b^bxl
bubbler	b^bxlR
bubbles	b^bxlz
bubblicious	b^blISxs
bubbly	b^bxli
buckaroo	b^kxru
bucket	b^kIt
buckets	b^kIts
buckle	b^kxl
buckled	b^kxld
buckles	b^kxlz
buckling	b^klIG
bucks	b^ks
bucky	b^ki
bud	b^d
buddies	b^diz
buddy	b^di
buds	b^dz
bug	b^g
bug's	b^gz
bugged	b^gd
buggie	b^gi
bugging	b^gIG
bugs	b^gz
build	bIld
builded	bIldxd
building	bIldIG
buildings	bIldIGz
builds	bIldz
built	bIlt
bull	bUl
bullfrog	bUlfrag
bully	bUli
bullying	bUliIG
bullys	bUliz
bum	b^m
bumblebee	b^mbxlbi
bumblebees	b^mbxlbiz
bumbling	b^mbxlIG
bummed	b^md
bummer	b^mR
bummie	b^mi
bummie's	b^miz
bumming	b^mIG
bump	b^mp
bumped	b^mpt
bumper	b^mpR
bumping	b^mpIG
bumpity	b^mpIti
bumps	b^mps
bumpy	b^mpi
bums	b^mz
bun	b^n
bunch	b^nC
bundle	b^ndxl
bungalow	b^ngxlo
bunnies	b^niz
bunnies's	b^nizxz
bunny	b^ni
bunny's	b^niz
bunnyegg	b^niEg
bunnyrabbit	b^nir@bIt
bunnyrabbits	b^nir@bIts
bunnys	b^niz
buns	b^nz
bunting	b^ntIG
buried	bErid
burke	bRk
burn	bRn
burned	bRnd
burning	bRnIG
burnt	bRnt
burp	bRp
burped	bRpt
burper	bRpR
burpie	bRpi
burping	bRpIG
burps	bRps
burrow	bRo
burt	bRt
bury	bEri
bus	b^s
buses	b^sIz
bush	bUS
bushed	bUSt
bushel	bUSxl
bushes	bUSIz
business	bIznxs
businesses	bIznxsxz
bust	b^st
busted	b^stxd
buster	b^stR
busting	b^stIG
busts	b^sts
busy	bIzi
but	b^t
but's	b^ts
buts	b^ts
butt	b^t
butter	b^tR
butterball	b^tRbcl
butterflies	b^tRflYz
butterfly	b^tRflY
butternut	b^tRn^t
butternutie@n	b^tRn^ti
button	b^txn
buttoned	b^txnd
buttonhole	b^txnhol
buttoning	b^txnIG
buttons	b^txnz
butts	b^ts
buttsie	b^tsi
buy	bY
buying	bYIG
buys	bYz
buzz	b^z
buzzing	b^zIG
by	bY
bye	bY
byebye	bYbY
byebyes	bYbYz
c	si
c@l	si
cabbage	k@bxJ
cabinet	k@bxnIt
cabinets	k@bxnIts
cable	kebxl
caboose	kxbus
cactus	k@ktxs
cage	keJ
cages	keJIz
cake	kek
cake's	keks
cakes	keks
cakie	keki
caking@n	kekIG
calcium	k@lsixm
calculator	k@lkyuletR
calendar	k@lEndR
calf	k@f
california	k@lxfcrnyx
call	kcl
called	kcld
calling	kclIG
calls	kclz
calm	kalm
calories	k@lcriz
calvary	k@lvxri
came	kem
camel	k@mxl
camels	k@mxlz
camera	k@mxrx
cameras	k@mxrxz
camp	k@mp
campbell	k@mbxl
camped	k@mpt
camping	k@mpIG
camps	k@mps
can	k@n
can't	k@nt
cancel	k@nsxl
candies	k@ndiz
candle	k@ndxl
candles	k@ndxlz
candy	k@ndi
cane	ken
cannot	k@nat
cans	k@nz
cantaloupe	k@ntxlop
canton	k@ntxn
cap	k@p
capable	kepxbxl
capris	kxpriz
captain	k@ptxn
car	kar
car's	karz
carbonation	karbxneSxn
card	kard
cardboard	kardbcrd
cardinal	kardxnxl
cardinals	kardxnxlz
cards	kardz
care	kEr
careening	kxrinIG
careful	kErfxl
carefully	kErfxli
cares	kErz
carl	karl
carmen	karmxn
carol	kErxl
carpet	karpxt
carriage	kErxJ
carrie	kEri
carried	kErid
carries	kEriz
carrot	kErxt
carrots	kErxts
carry	kEri
carrying	kErriIG
cars	karz
carseat	karsit
cart	kart
carton	kartxn
cartoon	kartun
cartoons	kartunz
carts	karts
case	kes
cases	kesxz
cassy	k@si
castle	k@sxl
castles	k@sxlz
casts	k@sts
cat	k@t
cat's	k@ts
catalogs	k@txlagz
catalogue	k@txlag
catastrophe	kxt@strxfi
catch	k@C
catcher	k@CR
catches	k@Cxz
catching	k@CIG
catdoor	k@tdcr
categorical	k@tIgcrIkxl
categories	k@tIgcriz
caterpillar	k@tRpIlR
caterpillars	k@tRpIlRz
catnaping	k@tn@pIG
cats	k@ts
caught	kct
cauliflower	kcliflWR
cause	kcz
causing	kczIG
cavalry	k@vxlri
cave	kev
caves	kevz
caw	kc
cdefg@k	sidiiEfJi
ceiling	silIG
ceilings	silIGs
celebrate	sElxbret
celebrated	sElxbretxd
celebrates	sElxbrets
celebrating	sElxbretIG
celebration	sElxbreSxn
celery	sElRi
cell	sEl
cells	sElz
cement	sImEnt
cent	sEnt
center	sEntR
centered	sEntRd
centering	sEntRIG
centers	sEntRz
centipede	sEntIpid
cents	sEnts
century	sEnCRi
cereal	sIrixl
cereal's	sIrixlz
cereals	sIrixlz
certain	sRtxn
certainly	sRtxnli
certificate	sRtIfxCxt
chafing	CefIG
chain	Cen
chains	Cenz
chair	CEr
chairs	CErz
chalk	Cak
chalkboard	Cakbcrd
challenge	C@lEnJ
challenging	C@lEnJIG
chance	C@nts
chances	C@ntsxz
change	CenJ
changed	CenJd
changes	CenJxz
changing	CenJIG
channel	C@nxl
channels	C@nxlz
chap	C@p
character	kErIktR
characteristic	kErIktxrIstIk
characters	kErIktRz
charge	CarJ
charged	CarJd
charges	CarJxz
charging	CarJIG
charlie	Carli
charm	Carm
charming	CarmIG
chart	Cart
chase	Ces
chased	Cest
chases	Cesxz
chasing	CesIG
chat	C@t
check	CEk
checkbook	CEkbUk
checkbook's	CEkbUks
checkbooks	CEkbUks
checking	CEkIG
checkout	CEkWt
checks	CEks
chee	Ci
cheek	Cik
cheekie	Ciki
cheekies	Cikiz
cheeks	Ciks
cheep	Cip
cheer	CIr
cheerful	CIrfxl
cheerio	CIrio
cheerio's	CIrioz
cheerios	CIrioz
cheers	CIrz
cheery	CIri
cheese	Ciz
cheeseburger	CizbRgR
cheeto	Cito
chef	SEf
cherries	CEriz
cherrio	CErio
chest	CEst
chester	CEstR
chew	Cu
chewed	Cud
chewing	CuwIG
chews	Cuz
chewy	Cuwi
chi	Ci
chichi	CiCi
chichi's	CiCiz
chick	CIk
chick's	CIks
chickadee	CIkxdi
chicken	CIkxn
chickennoodle	CIkxnnudxl
chickens	CIkxnz
chickie	CIki
chickie's	CIkiz
chickies	CIkiz
chicks	CIks
chico	Ciko
chihuahua	Ciwawa
child	CYld
children	CIldrxn
chili	CIli
chill	CIl
chillier	CIliR
chilling	CIlIG
chillon	CIlxn
chilly	CIli
chime	CYm
chimes	CYmz
chimney	CImni
chimp	CImp
chimpanzee	CImp@nzi
chin	CIn
china	CYnx
chinese	CYniz
chinie	CIni
chinnie	CIni
chip	CIp
chipmunks	CIpm^Gks
chips	CIps
chirp	CRp
chirping	CRpIG
chitlins	CItxlxnz
chocolate	CcklIt
choice	COs
choices	COsxz
choke	Cok
choking	CokIG
cholesterol	kxlEstRal
chomp	Ccmp
choo	Cu
choo@o	Cu
chooc@o	Cuk
choochoo	CuCu
choochoo@o	CuCu
choose	Cuz
chop	Cap
chopped	Capt
chore	Ccr
chores	Ccrz
chose	Coz
chris	krIs
christ	krYst
christened	krIsxnd
christening	krIsxnIG
christmas	krIsmxs
christopher	krIstxfR
chubby	C^bi
chuckie	C^ki
chugga@o	C^gx
chunky	C^Gki
church	CRC
churches	CRCxz
chute	Sut
cigarette	sIgxrEt
cinderella	sIndxrElx
cinderella's	sindxrElxz
cindy	sIndi
cindy's	sIndiz
cinnamon	sInxmxn
circle	sRkxl
circled	sRkxld
circles	sRkxlz
circular	sRkyulR
circulation	sRkyuleSxn
circumstances	sRkxmst@nsIz
circus	sRkxs
citrus	sItrxs
city	sIti
civilization	sIvxlxzeSxn
civilized	sIvxlYzd
clamp	kl@mp
clap	kl@p
clappie	kl@pi
clapping	kl@pIG
class	kl@s
clattering	kl@tRIG
claus	klcz
clay	kle
clean	klin
cleaned	klind
cleaner	klinR
cleaner's	klinRz
cleanest	klinEst
cleaning	klinIG
cleans	klinz
cleanup	klin^p
clear	klIr
clearance	klIrxnz
cleared	klIrd
clearer	klIrR
clearly	klIrli
clever	klEvR
click	klIk
clicker	klIkR
clicking	klIkIG
clifford	klIfRd
clifford's	klIfRdz
climb	klYm
climbed	klYmd
climber	klYmR
climbing	klYmIG
climbs	klYmz
clings	klIG
clinic	klInIk
clinics	klInIks
clink	klIGk
clinking	klIGkIG
clip	klIp
clipped	klIpt
clippers	klIpRz
clipping	klIpIG
clips	klIps
cloaks	kloks
clobber	klabR
clock	klak
clop	klap
close	kloz
closed	klozd
closely	klosli
closer	klosR
closes	klozxz
closet	klczIt
closing	klozIG
cloth	klcT
clothes	kloz
clothing	kloDIG
cloud	klWd
clouding	klWdIG
clouds	klWdz
cloudy	klWdi
clover	klovR
clown	klWn
clowns	klWnz
club	kl^b
cluck	kl^k
clue	klu
clues	kluz
clumps	kl^mps
clumpy	kl^mpi
clumsily	kl^msIli
clunk	kl^Gk
clunky	kl^Gki
clutter	kl^tR
cluttering	kl^tRIG
coaster	kostR
coasters	kostRz
coat	kot
coats	kots
cob	kab
cobweb	kabwEb
cobwebs	kabwEbz
coca	kokx
cock	kak
cockadoodledoo	kakxdudxldu
cockle	kakxl
cocoa	koko
cocoon	kxkun
code	kod
coffee	kcfi
coins	kOnz
coke	kok
cola	kolx
colada	koladx
cold	kold
cold's	koldz
colder	koldR
coleman	kolmxn
collapse	kxl@ps
collar	kalR
collect	kxlEkt
collection	kxlEkSxn
college	kalxJ
color	k^lR
color's	k^lRz
colored	k^lRd
colorful	k^lRfxl
coloring	k^lRIG
colors	k^lRz
colts	kolts
column	kal^m
columns	kal^mz
comb	kom
combed	komd
combie	kombi
combination	kambIneSxn
combine	kxmbYn
combing	komIG
combs	komz
come	k^m
comedy	kamxdi
comes	k^mz
comfort	k^mfRt
comfortable	k^mftRbxl
comfortably	k^mftRbli
comforter	k^mfRtR
comforting	k^mfRtIG
comfy	k^mfi
coming	k^mIG
commanded	kxm@ndxd
commander	kxm@ndR
comment	kamEnt
commercial	kxmRSxl
commercials	kxmRSxlz
common	kamxn
communicate	kxmyunIket
communication	kxmyunIkeSxn
company	kxmpxni
compared	kxmpErd
complain	kxmplen
complaining	kxmplenIG
complains	kxmplenz
complete	kxmplit
completed	kxmplitxd
completely	kxmplitli
complicated	kamplIketxd
complication	kamplIkeSxn
computer	kxmpyutR
concentrate	kansxntret
concentrating	kansxntretIG
concentric	kxnsEntrIk
concept	kansEpt
concerned	kxnsRnd
concerns	kxnsRnz
concert	kansRt
concerts	kansRts
condensation	kandEnseSxn
conditioner	kxndISxnR
conditioning	kxndISxnIG
condo	kando
condos	kandoz
cone	kon
confident	kanfIdEnt
confuse	kxnfyuz
confused	kxnfyuzd
confusing	kxnfyuzIG
congestion	kxnJEsCxn
congratulate	kxngr@Culet
connect	kxnEkt
connecting	kxnEktIG
connection	kxnEkSxn
connections	kxnEkSxnz
connie	kani
connotes	kxnots
conscious	kanSxs
consider	kxnsIdR
considerate	kxnsIdRxt
considered	kxnsIdRd
considering	kxnsIdRIG
considers	kxnsIdRz
consistent	kxnsIstxnt
consistently	kxnsIstxntli
conspiracy	kxnspRxsi
constant	kanstxnt
constantly	kanstxntli
constellation	kanstxleSxn
construct	kxnstr^kt
contact	kant@kt
contain	kxnten
containable	kxntenxbxl
contained	kxntend
container	kxntenR
containers	kxntenRz
containing	kxntenIG
contains	kxntenz
content	kantEnt
contents	kantEnts
context	kantEkst
continually	kxntInyuxli
continue	kxntInyu
continued	kxntInyud
contrary	kantrEri
control	kxntrol
controlled	kxntrold
controller	kxntrolR
controls	kxntrolz
convenience	kxnvinyEnts
conversation	kanvRseSxn
conversations	kanvRseSxnz
cook	kUk
cooked	kUkt
cookie	kUki
cookies	kUkiz
cooking	kUkIG
cooks	kUks
cool	kul
cooled	kuld
cooler	kulR
cooling	kulIG
coop	kup
cooperate	koapRet
cooperating	koapRetIG
cooperative	koapRxtIv
coordinate	koardInet
coordination	koardIneSxn
copied	kapid
coppertone	kapRton
cops	kaps
copyright	kapirYt
coral	karxl
cord	kcrd
cords	kcrdz
corduroy	kcrdxrO
corduroy's	kcrdxrOz
cork	kcrk
corked	kcrkt
corn	kcrn
corner	kcrnR
cornfield	kcrnfild
cornish	kcrnIS
corny	kcrni
corral	kxr@l
correct	kxrEkt
correctly	kxrEktli
correspondence	kcrxspandxns
cosby	kczbi
cost	kast
costs	kasts
cotton	katxn
cottontail	katxntel
couch	kWC
couches	kWCIz
cough	kcf
coughing	kcfIG
could	kxd
couldn't	kxdxnt
counselor	kWnsxlR
count	kWnt
counted	kWntId
counter	kWntR
countertop	kWntRtap
counting	kWntIG
countries	k^ntriz
country	k^ntri
counts	kWnts
county	kWnti
couple	k^pxl
coupon	kupan
coupons	kupanz
course	kcrs
courting	kartIG
cousin	k^zxn
cousins	k^zxnz
cover	k^vR
covered	k^vRd
covering	k^vRIG
covers	k^vRz
cow	kW
cow's	kWz
cowabunga	kWxb^ngx
cowboy	kWbO
cowpokie	kWpoki
cows	kWz
cozy	kozi
crab	kr@b
crabbie	kr@bi
crabbing	kr@bIG
crabby	kr@bi
crack	kr@k
cracked	kr@kt
cracker	kr@kR
crackers	kr@kRz
crackery	kr@kRi
cracky	kr@ki
cradle	kredxl
cradles	kredxlz
cramped	kr@mpt
cranberries	kr@nbEriz
cranberry	kr@nbEri
crane	kren
cranium	krenixm
crank	kr@Gk
crankiness	kr@GkinEs
cranky	kr@Gki
crap	kr@p
crash	kr@S
crashed	kr@St
crashes	kr@Sxz
crashing	kr@SIG
crawl	krcl
crawled	krcld
crawler	krclR
crawling	krclIG
crawls	krclz
crayon	krean
crayons	kreanz
crazed	krezd
crazy	krezi
cream	krim
creamy	krimi
creates	kriets
creative	kiretIv
creatively	krietIvli
creature	kriCR
creatures	kriCRz
credit	krEdIt
credited	krEdItxd
crediting	krEdItIG
credits	krEdIts
creek	krik
creep	krip
creepy	kripi
crew	kru
crib	krIb
cribbie	krIbi
crickets	krIkxts
cried	krYd
crinkles	krIGkxlz
crinkling	krIGkxlIG
crinkly	krIGkxli
crispier	krIspiR
crispiest	krIspiEst
crispy	krIspi
crisscross	krIskras
critter	krItR
croakity	krokxti
crock	krak
crocodile	krakxdYl
crocodiles	krakxdYlz
crocodiles'	krakxdYlz
crocuses	kroCxsxs
crooked	krUkxd
crooks	krUks
cross	kras
crossed	krast
crossing	krasIG
crosss	kras
crow	kro
crowd	krWd
crowded	krWdxd
crowed	krod
crown	krWn
crud	kr^d
cruise	kruz
crumb	kr^m
crumble	kr^mbxl
crumbs	kr^mz
crunch	kr^nC
crunchies	kr^nCiz
crunchy	kr^nCi
crush	kr^S
crust	kr^st
crusted	kr^stxd
crusty	kr^sti
cry	krY
crybaby	krYbebi
crying	krYIG
crystals	krIstxlz
cub	k^b
cubby	k^bi
cube	kyub
cubes	kyubz
cucumber	kyuk^mbR
cucumbers	kyukZmbRz
cuddly	k^dxli
cuetip	kyutIp
cup	k^p
cupboard	k^bRd
cupboard's	k^bRdz
cupcake	k^pkek
cupcake's	k^pkeks
cupcakes	k^pkeks
cupfuls	k^pfUlz
cups	k^ps
cups	k^ps
curb	kRb
curds	kRdz
curious	kyUrixs
curl	kRl
curled	kRld
curly	kRli
current	kRxnt
curse	kRs
curtain	kRtxn
curtains	kRtxnz
curvy	kRvi
cushion	kUSxn
cushioned	kUSxnd
cushions	kUSxnz
cut	k^t
cute	kyut
cutest	kyutIst
cutesy	kutsi
cutey	kyuti
cutie	kyuti
cutiepie	kyutipY
cutting	k^tIG
cymbals	sImbxlz
czech	CEk
czechoslovakia's	CEkxslxvakixz
d	di
d@l	di
da	da
dab	d@b
dab@c	d@b
dabby@c	d@b
dad	d@d
dad'll	d@dxl
dad's	d@dz
dada	d@d@
dada's	d@d@z
dadada	d@d@d@
dadada's	d@d@d@z
dadada@o	d@d@d@
dadadada@o	d@d@d@d@
daddy	d@di
daddy'd	d@did
daddy's	d@diz
daffodil	d@fxdIl
daffodils	d@fxdIlz
daffy	d@fi
daily	deli
dainty	denti
dairy	dEri
daisies	deziz
daisy	dezi
dakota	dxkota
dakota's	dxkotaz
dale	del
dalmatian	d@lmeSxn
dalmatians	d@lmeSxnz
damage	d@mxJ
damaged	d@mxJd
damages	d@mxJxz
damaging	d@mxJIG
dame	dem
damn	d@m
damp	d@mp
dan	d@n
dan's	d@nz
dance	d@ns
dances	d@nsxz
dancing	d@nsIG
dandelion	d@ndilYxn
dandy	d@ndi
dang	deG
dangerous	denJRxs
daniel	d@nyxl
dapper	d@pR
dare	dEr
daring	dErIG
dark	dark
darling	darlIG
darn	darn
dat	d@t
date	det
daughter	dctR
david	devId
davis	devIs
dawn	dcn
dawn's	dcnz
day	de
day's	dez
daycare	dekEr
daydreaming	dedrimIG
days	dez
daytime	detYm
daze	dez
dazey	dezi
dead	dEd
deal	dil
dear	dIr
deborah	dEbrx
debra	dEbrx
december	disEmbR
decent	disxnt
decibels	dEsxbxlz
decide	dIsYd
decided	dIsYdId
decisions	dIsIZxnz
deck	dEk
declare	dIklEr
declared	dIklErd
declares	dIklErz
declaring	dIklErIG
decoration	dEkareSxn
decorations	dEkcreSxnz
deep	dip
deepest	dipxst
deer	dIr
defender	dIfEndR
definitely	dEfxnItli
definition	dEfxnISxn
defrost	dIfrcst
degree	dIgri
degrees	dIgriz
dehydrated	dihYdretxd
delay	dIle
delete	dIlit
deleting	dIlitIG
delicious	dIlISxs
delighted	dIlYtId
deliver	dIlIvR
delivers	dIlIvRz
dell	dEl
deluxe	dil^ks
demand	dIm@nd
demolition	dEmxlISxn
demonstrate	dEmxnstret
dennis	dEnIs
dense	dEns
dentist	dEntIst
dentist's	dEntIsts
deny	dInY
depend	dIpEnd
depended	dIpEndxd
depending	dIpEndIG
depends	dIpEndz
deposit	dIpazIt
deprive	dIprYv
deprived	dIprYvd
derived	dIrYvd
desert	dEzRt
deserve	dIzRv
design	dIzYn
desire	dIzYR
desitin	dEzItIn
desk	dEsk
despise	dIspYz
dessert	dIzRt
destroy	dIstrO
destroying	dIstrOIG
destruction	dIstr^kSxn
destructive	dIstr^ktIv
detergent	dItRJEnt
detergents	dItRJEnts
determine	dItRmxn
determined	dItRmxnd
detour	ditar
device	dIvYs
devil	dEvxl
devon	dEvxn
devotion	dIvoSxn
devour	divWr
dew	du
dextrous	dEkstrxs
dial	dYxl
dialect	dYxlEkt
dialing	dYxlIG
dials	dYxlz
diamond	dYmxnd
diamonds	dYmxndz
diaper	dYpR
diapers	dYpRz
diapie	dYpi
diarrhea	dYxrix
dickory	dIkRi
dictionary	dIkSxnEri
did	dId
diddle	dIdxl
didey	dYdi
dideys	dYdiz
didi@o	didi
dididi@o	dididi
didn't	dIdxnt
die	dY
died	dYd
dieing	dYIG
dies	dYz
diesha	dYiSx
diet	dYxt
dieting	dYxtIG
diets	dYxts
difference	dIfrxns
differences	dIfrxnsxz
different	dIfrxnt
differentiate	dIfxrEnSiet
differently	dIfrxntli
difficult	dIfIk^lt
difficulty	dIfIk^lti
dig	dIg
digby	dIgbi
digger	dIgR
digging	dIgIG
digits	dIJIt
digs	dIgz
dillards	dIlRdz
dillon	dIlxn
dillon's	dIlxnz
dimples	dImpxlz
ding	dIG
dining	dYnIG
dinner	dInR
dinners	dInRz
dinnertime	dInRtYm
dinosaur	dYnxscr
dinosaur's	dYnxscrz
dip	dIp
dips	dIps
dipsie	dIpsi
dipsy	dIpsi
direct	dIrEkt
directing	dIrEktIG
direction	dIrEkSxn
directions	dIrEkSxnz
dirt	dRt
dirt's	dRts
dirty	dRti
dis	dIs
disappear	dIsxpIr
disappeared	dIsxpIrd
disappearing	dIsxpIrIG
disappointing	dIsxpOntIG
disaster	dIz@stR
disc	dIsk
discontent	dIskxntEnt
discover	dIsk^vR
discovered	dIsk^vRd
discoverer	dIsk^vRR
discovery	dIsk^vRi
discs	dIsks
discuss	dIsk^s
discussed	dIsk^st
discussion	dIsk^Sxn
disguised	dIskYzd
disgust	dIsg^st
disgusted	dIsg^stxd
disgusting	dIsg^stIG
dish	dIS
dishes	dISxz
dishrag	dISr@g
dishwasher	dISwaSR
disinfected	dIsInfEktxd
dismantle	dIsm@ntxl
dismay	dIsme
disney	dIzni
disney's	dizniz
disobedient	dIsobidixnt
disobey	dIsobe
disposal	dIzpozxl
dispose	dIzpoz
disposition	dIspxzISxn
distinct	dIstIGkt
distinction	dIstIGkSxn
distinguishes	dIstIGgwISIz
distracted	dIstr@ktxd
distracting	dIstr@ktIG
distraction	dIstr@kSxn
distracts	dIstr@kts
disturb	dIstRb
ditty	dIti
dive	dYv
dived	dYvd
dives	dYvz
divine	dIvYn
diving	dYvIG
dizzy	dIzi
do	du
do@si	dosi
dock	dak
doctor	daktR
doctor's	daktRz
dodge	daJ
does	d^z
doesn't	d^zxnt
dog	dcg
dog's	dcgz
doggie	dcgi
doggie's	dcgiz
doggies	dcgiz
doggone	dcgan
doggy	dcgi
doggy's	dcgiz
doghouse	dcghWs
dogs	dcgz
doing	duIG
doll	dal
doll's	dalz
dollar	dalR
dollars	dalRz
dollhouse	dalhWs
dollie	dali
dollie's	daliz
dollies	daliz
dolls	dalz
dolly	dali
dolly's	daliz
dolphin	dalfIn
dolphins	dalfInz
dome	dom
domestic	dxmEstIk
don	dan
don't	dont
donald	danxld
donald's	danxldz
done	d^n
dong	daG
donkey	daGki
donkeys	daGkiz
donna	danx
donovan	danxvxn
donut	donxt
doo	du
doodle	dudxl
doodoo	dudu
doopsie	dupsi
door	dcr
door's	dcrz
doorbell	dcrbEl
doorbells	dcrbElz
doors	dcrz
doorstop	dcrstap
doorway	dcrwe
doozy	duzi
doremifasolatido@si	doremifasolatido
dorm	darm
dos	duz
dot	dat
doting	dotIG
dotty	dati
double	d^bxl
doubling	d^blIG
doubt	dWt
dough	do
doughnut	don^t
doughnuts	don^ts
dove	dov
dover	dovR
down	dWn
downie	dWni
download	dWnlod
downloaded	dWnlodxd
downstairs	dWnstErz
downstream	dWnstrim
downtown	dWntWn
downy	dWni
doze	doz
dozen	d^zxn
drag	dr@g
dragged	dr@gd
dragging	dr@gIG
dragon	dr@gxn
dragon's	dr@gxnz
dragonfly	dr@gxnflY
dragons	dr@gxnz
drags	dr@gz
drags	dr@gz
drain	dren
drainage	drenxJ
drama	dramx
dramatic	drm@tIk
drank	dr@Gk
drape	drep
draw	drc
drawer	drcr
drawers	drcrz
drawing	drcIG
draws	drcz
dreadful	drEdfxl
dream	drim
dreamed	drimd
dreaming	drimIG
dreams	drimz
dreamy	drimi
drenched	drEnCt
dress	drEs
dressed	drEst
dresser	drEsR
dresses	drEsIz
dressing	drEsIG
drew	dru
dried	drYd
drill	drIl
drink	drIGk
drink's	drIGks
drinkie	drIGki
drinking	drIGkIG
drinks	drIGks
drip	drIp
dripping	drIpIG
drippy	drIpi
drips	drIps
drive	drYv
driver	drYvR
drives	drYvz
driveway	drYvwe
driving	drYvIG
drool	drul
drooling	drulIG
drooly	druli
droopy	drupi
drop	drap
dropped	drapt
dropping	drapIG
drops	draps
drove	drov
drown	drWn
drum	dr^m
drum's	dr^mz
drummer	dr^mR
drumming	dr^mIG
drummond	dr^mxnd
drums	dr^mz
drunk	dr^Gk
drunken	dr^Gkxn
dry	drY
dryer	drYR
drying	drYIG
drys	drYz
dub	d^b
duck	d^k
duckie	d^ki
duckie's	d^kiz
duckies	d^kiz
ducklings	d^klIGz
ducks	d^ks
dude	dud
due	du
dueling	dulIG
dug	d^g
dukes	duks
dum	d^m
dumb	d^m
dumbo	d^mbo
dummy	d^mi
dump	d^mp
dumped	d^mpt
dumping	d^mpIG
dumpling	d^mplIG
dumpty	d^mpti
dumpty's	d^mptiz
duplo	duplo
duress	dUrEs
during	dUrIG
dust	d^st
dusted	d^stxd
dusting	d^stIG
dustpan	d^stp@n
dusty	d^sti
dvd	dividi
dwight	dwYt
dya	dyx
dye	dY
dyed	dYd
dyeisha	dYiSx
dyeisha's	dYiSxz
dyes	dYz
dyiesha	dYiSx
dying	dYIG
e	i
e@l	i
e@l-s	i
each	iC
ear	Ir
ear's	Irz
earache	Irek
eardrum	Irdr^m
earlier	RliR
early	Rli
earned	Rnd
earphones	Irfonz
earring	IrIG
earrings	IrIGz
ears	Irz
earth	RT
earthquake	RTkwek
ease	iz
easier	iziR
easiest	iziIst
easily	izli
easter	istR
easy	izi
eat	it
eaten	itxn
eater	itR
eating	itIG
eats	its
ecosystem	ikosIstxm
ecta@q	Ektx
eddie	Edi
eden	idxn
edge	EJ
edges	Egxz
edible	Edxbxl
educational	EJUkeSxnxl
edward	EdwRd
eel	il
eensie	insi
eeyore	iar
effort	EfRt
efg@k	iEfJi
egg	Eg
eggfooyung	Egfuy^G
eggs	Egz
eh	E
eight	et
eighteen	etin
eighth	eT
either	iDR
el	El
elastic	Il@stIk
elbow	Elbo
elbows	Elboz
eleanor	ElxnR
electrical	IlEktrIkxl
electrician	IlEktrISxn
electricity	IlEktrIsIti
electrocute	IlEktrpkyut
electrocuted	IlEktrokyutxd
electrolytes	IlEktrolYts
electronically	IlEktranIkli
elegant	Elxgxnt
elephant	Elxfxnt
elephant's	Elxfxnts
elephants	Elxfxnts
eleven	IlEvxn
eleventh	IlEvxnT
elijah	IlYJx
elisse	Elis
elizabeth	IlIzxbET
elizabeth's	IlIzxbETs
ella	Elx
ellie	Eli
elmo	Elmo
elmo's	Elmoz
else	Els
else's	ElsIz
eluded	IludId
elves	Elvz
email	imel
embarrassed	EmbErxst
emergency	ImRJxnsi
emily	EmIli
emmy	Emi
emmy's	Emiz
emote	Imot
emotional	ImoSxnxl
emperor's	EmpRRz
empty	Empti
enamel	In@mxl
encourage	EnkRIJ
encouraged	EnkRIJd
encouraging	EnkRIJIG
end	End
ended	EndId
endlessly	Endlxsli
ends	Endz
enemy	Enxmi
energy	EnRJi
engine	EnJxn
english	IGglIS
enjoy	EnJO
enjoyed	EnJOd
enjoying	EnJOIG
enjoys	EnJOz
enormous	Inarmxs
enough	In^f
enter	EntR
entered	EntRd
entering	EntRIG
enters	EntRz
entertained	EntRtend
entertaining	EntRtenIG
entertainment	EntRtenmxnt
enthusiastic	EnTuzi@stIk
entice	EntYs
entire	EntYr
entirely	EntYrli
entrance	Entrxns
entrapment	Entr@pmxnt
entry	Entri
envelope	Envxlop
envelopes	Envxlops
environment	EnvYrxnmxnt
equipment	IkwIpmxnt
er	R
eric	ErIk
erin	ErIn
ernie	Rni
ernie's	Rniz
escape	Eskep
escaped	Eskept
especially	IspESxli
estate	Estet
eternal	itRnxl
etti	Eti
european	yUrxpixn
evaporate	Iv@pRet
evaporated	Iv@pRetxd
eve	iv
even	ivxn
evening	ivnIG
event	IvEnt
eventually	IvEnCxli
ever	EvR
every	Evri
everybody	Evribadi
everybody's	Evribadiz
everyone	Evriw^n
everyone's	Evriw^nz
everyplace	Evriples
everything	EvriTIG
everything's	EvriTIGz
everywhere	EvriwEr
evil	ivxl
ew	u
ewe	yu
ewie	yui
exact	Igz@kt
exactly	Igz@ktli
exalted	Igzaltxd
examples	Igz@mpxlz
excellent	EgsElxnt
except	IksEpt
excess	EksEs
excited	IksYtId
excitement	IksYtmxnt
exciting	IksYtIG
excuse	Iksyus
excuses	IkskyusIz
exercise	EksRsYz
exercises	EksRsYzxz
exercising	EksRsYzIG
exersaucer	EksRscsR
exert	IgzRt
exhibits	EgzIbIts
exists	IgzIsts
exodus	Eksodxs
expect	IkspEkt
expectations	IkspEkteSxnz
expected	IkspEktxd
expecting	IkspECtIG
expects	IkspEkts
expedition	EkspxdISxn
expensive	IkspEnsIv
experience	IkspIrixns
experiment	IkspErImxnt
explain	Iksplen
explanation	IksplxneSxn
exploded	Iksplodxd
explore	Iksplcr
exploring	IksplcrIG
explosion	IksploZxn
exposed	Ikspozd
express	IksprEs
expresses	IksprEsxz
expression	IksprESxn
extent	IkstEnt
external	IkstRnxl
extinguisher	EkstIGgwISR
extra	Ekstrx
extract	Ekstr@kt
extracted	Ekstr@ktxd
extracting	Ekstr@ktIG
extracts	Ekstr@kts
extraordinarily	IkstrcrdxnErxli
extraordinary	IkstrcrdxnEri
extremely	Ikstrimli
eye	Y
eyeball	Ybcl
eyebrow	YbrW
eyebrows	YbrWz
eyeglass	Ygl@s
eyeglasses	Ygl@sxz
eyeore	iar
eyes	Yz
eyesight	YsYt
eyore	iar
eyore's	iarz
f	Ef
f@l	Ef
fa@si	fasi
fabulous	f@byulxs
face	fes
facecloth	fesklaT
faced	fest
faces	fesxs
facie	fesi
facing	fesIG
fact	f@kt
fade	fed
fair	fEr
fairies	fEriz
fairly	fErli
fairy	fEri
faithful	feTfxl
fake	fek
faked	fekt
faker	fekR
fakes	feks
faking	fekIG
fall	fcl
fallen	fclxn
falling	fclIG
falls	fclz
false	fcls
familiar	fxmIlyR
families	f@mliz
family	f@mli
famous	femxs
fan	f@n
fan's	f@nz
fancy	f@nsi
fanny	f@ni
fantabalocious	f@nt@bxloSxs
fantastic	f@nt@stIk
far	far
faraway	farxwe
farm	farm
farmer	farmR
farmer's	farmRz
farmyard	farmyard
fart	fart
farted	fartxd
farther	farDR
fartie	farti
fascinated	f@sxnetId
fascinating	f@sxnetIG
fascination	f@sxneSxn
fast	f@st
fasten	fcrsxn
fastens	fcrsxnz
faster	f@stR
fat	f@t
fates	fets
father	faDR
father's	faDRz
fathers	faDRz
fault	fclt
favor	fevR
favorite	fevrIt
favorites	fevrIts
favoritest	fevrItxst
fawn	fcn
faye	fe
fear	fIr
feast	fist
feather	fEDR
feathers	fEDRz
feathery	fEDRi
fed	fEd
fee	fi
feed	fid
feeder	fidR
feeding	fidIG
feeds	fidz
feel	fil
feeling	filIG
feelings	filIGz
feels	filz
fees	fiz
feet	fit
feet'll	fitxl
feetie	fiti
feeties	fitiz
feets	fits
feetsies	fitsiz
feisty	fYsti
fell	fEl
fella	fElx
fellow	fElo
felt	fElt
fence	fEnts
fenced	fEntst
fennel	fenxl
ferocious	fxroSxs
ferris	fErIs
ferry	fEri
fetch	fEtC
fettuccini	fEtxCini
fever	fivR
few	fyu
fiber	fYbR
fickle	fIkxl
fiddle	fIdxl
fiddles	fIdxlz
fido	fYdo
field	fild
fifferfefferfeff	fIfRfEfRfEf
fifteen	fIftin
fifteenth	fIftinT
fifth	fIfT
fiftieth	fIfiET
fifty	fIfti
fig	fIg
fight	fYt
fighter	fYtR
fighting	fYtIG
figs	fIgz
figure	fIgyR
figured	fIgyRd
figures	fIgyRz
figuring	fIgyRIG
fill	fIl
filled	fIld
filling	fIlIG
film	fIlm
filthy	fIlTi
fin	fIn
finally	fYnxli
find	fYnd
finding	fYndIG
findow@n	fIndo
finds	fYndz
fine	fYn
finger	fIGgR
fingernail	fIGgRnel
fingernails	fIGgRnelz
fingerprints	fIGgRprInts
fingers	fIGgRz
finicky	fInIki
finish	fInIS
finished	fInISt
finishing	fInISIG
fins	fInz
fiona	fionx
fir	fR
fire	fYR
firefly	fYrflY
fireplace	fYrples
fires	fYrz
firmly	fRmli
first	fRst
fish	fIS
fishbowl	fISbol
fisher	fISR
fishes	fISxz
fishie	fISi
fishie's	fISiz
fishies	fISiz
fishing	fISIG
fist	fIst
fists	fIsts
fit	fIt
fits	fIts
fitti	fIti
fitting	fItIG
fittis	fItIs
fitzgerald	fItzJErxld
fitzpatrick's	fItsp@trIks
five	fYv
fix	fIks
fixable	fIksxbxl
fixed	fIkst
fixes	fIksxz
fixing	fIksIG
fixit	fIksIt
flag	fl@g
flair	flEr
flairs	flErz
flakes	fleks
flamingo	flxmIGgo
flap	fl@p
flaps	fl@ps
flash	fl@S
flashcard	fl@Skard
flashes	fl@Sxz
flashlight	fl@SlYt
flat	fl@t
flavor	flevR
flavored	flevRd
flavorful	flevRfxl
fleas	fliz
fleet	flit
flew	flu
flicked	flIkt
flip	flIp
flipflop	flIpflap
flipflops	flIpflaps
flipping	flIpIG
flips	flIps
flirting	flUrtIG
float	flot
floating	flotIG
floats	flots
floor	flcr
floor's	flcrz
floors	flcrz
flop	flap
floppy	flapi
flopsy	flapsi
flouncy	flWntsi
flour	flWr
flow	flo
flower	flWR
flower's	flWRz
flowers	flWRz
flowing	floIG
flows	floz
fluff	fl^f
fluffy	fl^fi
fluids	fluIdz
flush	fl^S
flutter	fl^tR
flutters	fl^tRz
fly	flY
flyer	flYR
flying	flYIG
flys	flYz
flyswatter	flYswatR
foam	fom
focussed	fok^st
fold	fold
folded	foldId
folding	foldIG
folks	foks
follow	falo
followed	falod
following	falowIG
follows	faloz
followtheleader	faloDxlidR
food	fud
foods	fudz
fool	ful
fooled	fuld
fooling	fulIG
foot	fUt
foot's	fUts
football	fUtbcl
footie	fUti
footprints	fUtprInts
foots	fUts
footsies	fUtsiz
for	fcr
foraging	fcrxJIG
forbidden	fcrbIdxn
forced	fcrst
forcing	fcrsIG
forehead	f@hEd
forest	fcrIst
forever	fcrEvR
forget	fRgEt
forgets	fRgEts
forgetting	fRgEtIG
forgive	fRgIV
forgot	fRgat
forgotten	fRgatxn
fork	fcrk
forks	fcrks
formal	fcrmxl
formed	fcrmd
formula	fcrmyxlx
formula's	fcrmyxlxz
formulated	fcrmyxletxd
forsake	fcrsek
forth	fcrT
fortune	fcrCun
forty	fcrti
forum	fcrxm
forward	fcrwRd
fossil	fasxl
foul	fWl
found	fWnd
foundation	fWndeSxn
fountain	fWntxn
four	fcr
fours	fcrz
fourteen	fcrtin
fourteen	fcrtin
fourteenth	fcrtinT
fourth	fcrT
fourths	fcrTs
fox	faks
foxes	faksxz
frame	frem
frank	fr@Gk
frankly	fr@Gkli
freak	frik
freaking	frikIG
fred	frEd
freddy	frEdi
freddy's	frEdiz
free	fri
freedom	frid^m
freeze	friz
freezer	frizR
french	frEnC
fresh	frES
friction	frIkCxn
friday	frYde
fridge	frIJ
fried	frYd
friend	frEnd
friend's	frEndz
friendly	frEndli
friends	frEndz
fries	frYz
frighten	frYtxn
frightened	frYtxnd
frill	frIl
frilly	frIli
frilly's	frIliz
frisbee	frIzbi
frog	frcg
frog's	frcgz
froggie	frcgi
froggie's	frcgiz
frogs	frcgz
from	frxm
front	fr^nt
fronts	fr^nts
frontsies	fr^ntsiz
froot	frut
frosting	frastIG
frosty	frasti
frown	frWn
froze	froz
frozen	frozxn
fruit	frut
fruits	fruts
frustrated	fr^stretxd
frustrating	fr^stretIG
frutti	fruti
fry	frY
frying	frYIG
fufu@c	fufu
full	fUl
fumble	f^mbxl
fun	f^n
function	f^GkSxnz
functions	f^GkSxnz
funniest	f^niEst
funny	f^ni
fur	fR
furby	fRbi
furious	fyRixs
furniture	fRnICR
furry	fRi
further	fRTR
fuss	f^s
fussbucket	f^sb^kxt
fussed	f^st
fusser	f^sR
fussies	f^siz
fussing	f^sIG
fussings	f^sIGz
fusspot	f^spat
fussy	f^si
futon	futan
future	fyuCR
fuzz	f^z
fuzzies	f^ziz
fuzzy	f^zi
g@l	Ji
gabby	g@bi
gabby's	g@biz
gaga	gaga
gail	gel
gail's	gelz
gained	gend
galleria	g@lRix
galley	g@li
galoshes	gxlaSxz
game	gem
games	gemz
gap	g@p
garage	gxraJ
garbage	garbxJ
garden	gardxn
garden's	gardxnz
garland	garl@nd
garlic	garlIk
garret's	gErEts
garrett	gErEt
gas	g@s
gasped	g@spt
gastroenteritis	g@stroEntxrYtIs
gat	g@t
gate	get
gate's	gets
gates	gets
gather	g@DR
gathered	g@DRd
gatorade	getRed
gave	gev
gazing	gezIG
gear	gIr
gears	gIrz
gee	Ji
geese	gis
gels	JElz
gene	Jin
general	JEnRxl
generally	JEnRxli
generate	JenRet
generations	JenReSxnz
generous	JEnRxs
genesis	JEnxsIs
genie	Jini
genie's	Jiniz
genius	Jinyxs
gentle	JEntxl
gentleman	Jentxlmxn
gently	Jentli
george	JcrJ
georgia	JcrJyx
gerber	gRbR
gesundheit	gxz^ndhYt
get	gEt
getieup	gEti^p
gets	gEts
getting	gEtIG
ghetto	gEto
ghost	gost
giant	JYxnt
gibberish	JIbRIS
giddyup	gIdi^p
gift	gIft
gifts	gIfts
gigantic	JYg@ntIk
giggle	gIgxl
gigglegigglegoogaga	gIgxlgIgxlgugaga
gigglegigglegoogoo	gIgxlgIgxlgugu
gigglegigglegoogooga	gIgxlgIgxlguga
gigglegigglegoogoogoo	gIgxlgIgxlgugugu
giggles	gIgxlz
gigi	JiJi
gigi's	JiJiz
gimme	gImi
gimmick	gImIk
gimmicks	gImIks
ginger's	JInJRz
giraffe	Jxr@f
giraffe's	Jxr@fs
giraffes	Jxr@fs
girded	gRdxd
girder	gRdR
girl	gRl
girl's	gRlz
girla	gRlx
girlfriend	gRlfrEnd
girlie	gRli
girls	gRlz
git	gIt
give	gIv
given	gIvxn
giver	gIvR
gives	gIvz
giving	gIvIG
glad	gl@d
gladys	gl@dxs
glass	gl@s
glasses	gl@sIz
globe	glob
gloomy	glumi
glorified	glcrIfYd
glorify	glcrIfY
glorious	glcrixs
glory	glcri
gloss	glcs
glosses	glcsxz
glove	gl^v
gloves	gl^vz
glubglub	gl^bgl^b
glue	glu
glued	glud
glump	gl^mp
gnat	n@t
go	go
goading	godIG
goal	gol
goat	got
goats	gots
gobble	gabxl
god	gad
god's	gadz
godmother	gadm^Dr
gods	gadz
godzilla	gadzIlx
goers	goRz
goes	goz
goggles	gagxlz
going	goIG
gold	gold
golden	goldxn
goldfish	goldfIS
goldie	goldi
goldilocks	goldilaks
golf	gclf
golly	gali
gone	gcn
gonna	gxnx
gonzales	gcnzalEz
good	gUd
goodamus	gUdxmxs
goodbye	gUdbY
goodest	gUdxst
goodness	gUdnIs
goodnight	gUdnYt
goody	gUdi
goof	guf
goofy	gufi
goofy's	gufiz
google	gugxl
googoo	gugu
googooeyed	guguYd
googoogigglegaga	gugugIgxlgaga
googoogigglegagagiggle	gugugIgxlgagagIgxl
googoogoggles	gugugagxlz
goopy	gupi
goose	gus
gooseberry	gusbEri
goosie	gusi
gordon	gcrdxn
gorgeous	gcrJxs
gorilla	gxrIlx
gorillas	gxrIlxz
gosh	g^S
got	gat
gotcha	gatCx
gots	gats
gotta	gatx
gotten	gatxn
gown	gWn
gowns	gWnz
grab	gr@b
grabbed	gr@bd
grabbing	gr@bIG
grabs	gr@bz
grace	gres
gracefully	gresfxli
gracious	greSxs
grade	gred
gradually	gr@Jxli
graduation	gr@JueSxn
graham	gr@m
grain	gren
gram	gr@m
grammatical	grxm@tIkxl
grammatically	grxm@tIkli
grammie	gr@mi
grammy	gr@mi
gramps	gr@mps
grams	gr@mz
grand	gr@nd
grandad	gr@nd@d
grandaddy	gr@nd@di
granddaddy	gr@nd@di
grandma	gr@nma
grandma's	gr@nmaz
grandmama	gr@ndmamx
grandmother	gr@ndm^DR
grandmother's	gr@nm^DR
grandpa	gr@mpa
grandpa's	gr@mpxz
grandparents	gr@npErxnts
grandpas	gr@npxz
granny	gr@ni
granny's	gr@niz
granola	grxnolx
grant	gr@nt
grape	grep
grapefruit	grepfrut
grapes	greps
grasp	gr@sp
grass	gr@s
grasses	gr@sxz
grasshopper	gr@shapR
grate	gret
grateful	gretfxl
gratefully	gretfxli
grater	gretR
gratings	gretIGz
gravel	gr@vxl
gravity	gr@vIti
gravy	grevi
gray	gre
grayish	greIS
grease	gris
greasy	grisi
great	gret
greatest	gretxst
greatly	gretli
greats	grets
greece	gris
greedy	gridi
greek	grik
green	grin
greg	grEg
gregory	grEgcri
gregory's	grEgcriz
gretel	grEtxl
grew	gru
grey	gre
grief	grif
griffin	grIfxn
grill	grIl
grilled	grIld
grin	grIn
grinch	grInC
grinchie	grInCi
grind	grYnd
grinding	grYndIG
grip	grIp
grit	grIt
grits	grIts
gritty	grIti
groaning	gronIG
groceries	grosriz
grocery	grosri
gross	gros
grouch	grWC
groucho	grWCo
grouchy	grWCi
ground	grWnd
groundhog	grWndhcg
group	grup
groupings	grupIGz
grover	grovR
grow	gro
growing	groIG
growl	grWl
growled	grWld
growling	grWlIG
grown	gron
grownups	gron^ps
growth	groT
grumpy	gr^mpi
grundy	gr^ndi
grunt	gr^nt
grunted	gr^ntxd
grunting	gr^ntIG
grunts	gr^nts
guard	gard
guards	gardz
gucci	guCi
guess	gEs
guest	gEst
guests	gEsts
guide	gYd
guilty	gIlti
guitar	gItar
gum	g^m
gummies	g^miz
gump	g^mp
gums	g^mz
gun	g^n
guns	g^nz
gus	g^s
guy	gY
guy's	gYz
guys	gYz
guzenheit@s	gEzUntYt
gym	JIm
h@l	eC
ha	ha
habit	h@bIt
habits	h@bIts
had	h@d
hades	hediz
hadn't	h@dxnt
hafta	h@ftx
hag	h@g
haha	haha
hailey	heli
hair	hEr
hair's	hErz
hairbrush	hErbr^S
haircut	hErk^t
hairdo	hErdu
haired	hErd
hairie	hEri
hairies	hErriz
hairs	hErrz
hairy	hErri
hakunamatata@si	hxkUnxmxtatx
haley's	heliz
half	h@f
halfs	h@fs
halfsister	h@fsIstR
halfway	h@fwe
hall	hcxl
halle@si	halE
hallehallehalle@si	halEhalEhalE
hallelujah	halEluya
halloween	h@lowin
hallway	hclwe
halo	helo
ham	h@m
hamburger	h@mbRgR
hammer	h@mR
hammock	h@m^k
hand	h@nd
hand's	h@ndz
handbook	h@ndbUk
handed	h@ndId
handfuls	h@ndfUlz
handicapped	h@ndik@pt
handing	h@ndIG
handkerchiefs	h@GkRCifs
handle	h@ndxl
handlebars	h@ndxlbarz
handled	h@ndxld
handles	h@ndxlz
handling	h@ndxlIG
handmedown	h@ndmidWn
handmedowns	h@ndmidWnz
hands	h@ndz
handsie	h@ndzi
handsies	h@ndziz
handsome	h@ns^m
handy	h@ndi
handyman	h@ndim@n
hang	h@G
hanger	heGgR
hanger's	heGgRz
hangers	heGgRz
hanging	h@GIG
hangs	h@Gz
hannah	h@nx
hannah's	h@nxz
hansel	h@nsxl
happen	h@pxn
happened	h@pxnd
happening	h@pxnIG
happens	h@pxnz
happiest	h@pixst
happily	h@pxli
happiness	h@pinEs
happy	h@pi
happybirthday	h@pibRTde
hard	hard
harder	hardR
hardest	hardIst
hardheaded	hardhEdxd
hardly	hardli
hare	hEr
hare's	hErz
harmful	harmfxl
harmless	harmlEs
harmonica	harmanIkx
harness	harnIs
harry	hErri
harvard	harvRd
harvest	harvEst
has	h@z
hash	h@S
hasn't	h@zxnt
hassle	hezxl
hat	h@t
hatchling	h@CllG
hate	het
hated	hetId
hates	hets
hats	h@ts
have	h@v
haven't	h@vxnt
having	h@vIG
hawk	hck
hawn	hcn
hay	he
hayley	heli
haystack	hest@k
haystacks	hest@ks
hazard	h@zRd
he	hi
he'd	hid
he'll	hil
he's	hiz
head	hEd
headache	hEdek
headache	hEdek
headband	hEdb@nd
headband	hEdb@nd
headbutt	hEdb^t
headbutt	hEdb^t
headbutted	hEdb^txd
headbutted	hEdb^txd
headbutting	hEdb^tIG
headbutting	hEdb^tIG
headbutts	hEdb^ts
headbutts	hEdb^ts
headed	hEdxd
heading	hEdIG
headphones	hEdfonz
headphones	hEdfonz
heads	hEdz
heal	hil
heal	hil
heals	hilz
health	hElT
health	hElT
healthy	hElTi
healthy	hElTi
heap	hip
heap	hip
heaped	hipt
heaped	hipt
hear	hIr
heard	hRd
hearing	hIrIG
hearing	hIrIG
hears	hIrz
heart	hart
heart's	harts
heart's	harts
heartbeat	harbit
heartbeat	harbit
heartie	harti
heartie	harti
heat	hit
heat	hit
heated	hitxd
heated	hitxd
heater	hitR
heater	hitR
heater's	hitRz
heater's	hitRz
heating	hitIn
heating	hitIn
heaven	hEvEn
heaven	hEvEn
heavenly	hEvEnxli
heavenly	hEvEnxli
heavens	hEvxn
heavier	hEviR
heavier	hEviR
heavy	hEvi
hebrews	hibruz
hebrews	hibruz
hedgehog	hEJhag
hedgehog	hEJhag
hedgehog's	hEJhagz
hedgehog's	hEJhagz
hee	hi
hee	hi
heel's	hilz
heel's	hilz
heels	hilz
height	hYt
height	hYt
heinie	hYni
heinie	hYni
held	hEld
helicopter	hElikaptR
hell	hEl
hello	hElo
helmet	hElmIt
help	hElp
helped	hElpt
helper	hElpR
helpful	hElpfxl
helping	hElpIG
helps	hElps
helter	hEltR
hen	hEn
henry	hEnri
henry's	hEnriz
hens	hEnz
her	hR
hera	hErx
hercules	hRkyxliz
here	hIr
here're	hIrR
here's	hIrz
heres	hRz
heros	hRoz
hers	hRz
herself	hRsElf
hey	he
heybie	hebi
hi	hY
hicciuppies	hIki^piz
hiccihicciuppies	hIkihIki^piz
hiccup	hIk^p
hiccups	hIk^ps
hickies	hIkiz
hickieuppies	hIki^piz
hickory	hIkcri
hid	hId
hidden	hIdxn
hide	hYd
hideandseek	hYd@ndsik
hiding	hYdIG
high	hY
highchair	hYCEr
highchairs	hYCErz
higher	hYR
highest	hYEst
highfive	hYfYv
highfives	hYfYvz
hijklmnop@k	eCYJekeElEmEnopi
hike	hYk
hikers	hYkRz
hill	hIl
hills	hIlz
him	hIm
himself	hImsElf
hinge	hInJ
hint	hInt
hip	hIp
hippety	hIpEti
hippo	hIpo
hippopotamus	hIpopatxmxs
hippos	hIpoz
hips	hIps
hired	hYrd
his	hIz
hisself	hisElf
hit	hIt
hits	hIts
hitting	hItIG
hiya	hYyx
hmm	hxm
hmmthat's	hxmD@ts
ho	ho
hoe	ho
hog	hag
hogging	hagIG
hogwash	hagwaS
hokey	hoki
hold	hold
holder	holdR
holding	holdIG
holds	holdz
holdup	hold^p
hole	hol
holes	holz
holey	holi
holiday	hclIde
holler	hclR
hollering	hclRIG
holly	hcli
hollyhock	hclihak
hollywood	hcliwUd
holy	holi
home	hom
homemade	hommed
homes	homz
homework	homwRk
honestly	anEstli
honey	h^ni
honey's	h^niz
honeysuckle	h^nis^kxl
honk	haGk
honker	haGkR
honking	haGkIG
hoo@o	hu
hoochie	huCi
hoochoo	huCu
hood	hUd
hook	hUk
hooked	hUkt
hooking	hUkIG
hooks	hUks
hoop	hup
hoops	hups
hooray	hure
hoot	hut
hop	hap
hope	hop
hoped	hopt
hopeful	hopfxl
hopefully	hopfxlli
hopes	hops
hophop	haphap
hopie	hopi
hoping	hopIG
hopped	hapt
hoppety	hapIti
hopping	hapIG
hoppity	hapIti
hoppy	hapi
hops	haps
hopscotch	hapskaC
horn	hcrn
horner	hcrnR
horns	hcrnz
horrible	hcrIbxl
horribly	hcrIbxli
horse	hcrs
horseradish	hcrsr@dIS
horses	hcrsIz
horsie	hcrsi
horsie's	hcrsiz
horsieback	hcrsIb@k
horsies	hcrsIz
hose	hoz
hospital	haspItxl
hostas	hcstxz
hostile	hastIl
hosts	hosts
hot	hat
hotdog	hatdag
hotmitt	hatmIt
hots	hats
hound	hWnd
hour	WR
hours	WRz
house	hWs
housecoat	hWskot
houses	hWsIz
how	hW
how'd	hWd
how're	hWar
how's	hWz
however	hWEvR
howling	hWlIG
hows	hWz
huber	hubR
hubers	hubRz
hue	hu
huff	h^f
huffed	h^ft
hug	h^g
huge	hyuJ
hugged	h^gd
hugger	h^gR
hugging	h^gIG
huggy	h^gi
hugs	h^gz
huh	h^
hum	h^m
human	hyumxn
humming	h^mIG
humor	humR
hump	h^mp
humpty	h^mpti
hundred	h^ndrEd
hundreds	h^ndrEdz
hung	h^G
hungrier	h^GgriR
hungry	h^Ggri
hunhunh	^n^n
hunkamunka	h^nkxm^Gkx
hunt	h^nt
hunting	h^ntIG
hurley's	hRliz
hurray	hRre
hurried	hRrid
hurries	hRriz
hurry	hRri
hurrying	hRriIG
hurt	hRt
hurting	hRtIG
hurts	hRts
husband	h^zbxnd
husband's	h^zbxndz
hush	h^S
hut	h^t
hydrant	hYdrEnt
hydrogen	hYdrxJEn
hyena	hYinx
hymnal	hImnxl
hyper	hYpR
hypoallergenic	hYpo@lRJEnIk
i	Y
i'd	Yd
i'll	Yl
i'm	Ym
i've	Yv
i@l	Y
iago	yago
ice	Ys
ichabod	Ikxbad
icie	Ysi
icky	Iki
icy	Ysi
idea	Ydix
ideas	Ydixz
identify	YdEntxfY
idiot	Idixt
if	If
ignorance	IgnRxnts
ignore	Igncr
ignoring	IgncrIG
iguana	Igwanx
ijklmnop@k	YJekeElEmEnopi
ill	Il
illusory	IluzRi
illustrated	Il^stretEd
imaginary	Im@JxnEri
imagination	Im@JxneSxn
imagine	Im@JIn
imagining	Im@JInIG
imitate	ImItet
imitates	ImItets
imitating	ImitetIG
imitative	ImItetIv
immediately	ImidiItli
implies	ImplYz
important	Impcrtxnt
impossibility	ImpasxbIlxti
impossible	Impasxbxl
imposter	ImpxstR
impressed	ImprEst
improper	ImprapR
improperly	ImprapRli
in	In
inanimate	In@nxmIt
inappropriate	InxpropriIt
incessently	InsEsxntli
inches	InCxz
inching	InCIG
inchworm	InCwRm
including	InkludIG
income	Ink^m
increase	Inkris
incredible	InkrEdxbxl
incredibly	InkrEdxbli
indeed	Indid
indeedie	Indidi
independent	IndxpEndEnt
independently	IndxpEndEntli
indestructible	Indistr^ktxbxl
india	Indix
indian	Indixn
indians	Indixnz
indigo	IndIgo
individual	IndxvIJxl
individuals	IndxvIJxlz
indoors	Indcrz
inexpensive	InIkspEnsIv
infant	Infxnt
infantry	Infxntri
infection	InfEkSxn
infections	InfEkSxnz
infinity	InfInxti
inflicting	InflIktIG
influence	Influxnts
inform	Infcrm
informed	Infcrmd
informing	InfcrmIG
informs	Infcrmz
infrastructures	Infrxstr^kCRz
initiated	InISietId
injuries	InJRiz
injury	InJRi
ink	iGk
inning	InIG
innocent	Inxsxnt
innovative	InovetIv
input	InpUt
inside	InsYd
insist	InsIst
insistent	InsIstEnt
insists	InsIsts
inspire	InspYR
instance	Instxns
instantly	Instxntli
instead	InstEd
instructions	Instr^kSxnz
instrument	Instr^mGt
instruments	Instr^mGts
intense	IntEnts
intent	IntEnt
interaction	IntR@kSxn
interest	IntrIst
interested	IntrxstId
interesting	IntrxstIG
internet	IntRnEt
interpret	IntRprIt
interrupt	IntR^pt
into	Intu
intrigued	Intrigd
introduced	Intrxdust
invent	InvEnt
invented	InvEntxd
investigate	InvEstxget
investigator	InvEstxgetR
invisible	InvIsIbxl
invitation	InvIteSxn
invitations	InvIteSxnz
invited	InvYtxd
invites	InvYts
inviting	InvYtIG
involved	Invalvd
involves	Invalvz
iron	YRn
ironed	YRnd
ironing	YRnIG
irons	YRnz
irritable	Iritxbxl
irritate	IrItet
irritated	IrItetxd
irritates	IrItets
irritating	IrItetIG
is	Iz
isaac	YzIk
isabel	Izxbxl
isaiah	Isex
island	Ilxnd
island's	Ilxndz
isn't	Izxnt
israel	IzrExl
israelite	IzrelYt
it	It
it'd	Itxd
it'll	Itxl
it's	Its
italian	It@lyxn
italy	Itxli
itch	ItC
itches	ICIz
itching	ICIG
itchy	ICi
items	Ytxmz
its	Its
itself	ItsElf
itsy	Itsi
itty	Iti
ivy	Yvi
j	Je
j's	Jez
j@l	Je
jabbering	J@bRIG
jack	J@k
jacket	J@kIt
jackets	J@kIts
jackie	J@ki
jackrabbit	J@kr@bIt
jacks	J@ks
jacob	J@kxb
jacob's	J@kxbz
jafar	Jxfar
jafar's	Jxfarz
jail	Jel
jake	Jek
jam	J@m
james	Jemz
jammie@s	J@mi
jammies	J@miz
jane	Jen
jane's	Jenz
janie's	Jeniz
jar	Jar
jarred	Jard
jars	Jarz
jasmine	J@zmxn
jaw	Jc
jaws	Jcz
jay	Je
jaylen	Jelxn
jaylen's	Jelxnz
jealous	JElxs
jeans	Jinz
jeez	Jiz
jeff	JEf
jeff's	JEfs
jeffrey	JEfri
jeffrey's	JEfriz
jello	JElo
jelly	JEli
jellyfish	JElifIS
jemima	JOmYmx
jeremiah	JErxmYx
jeremy	JErxmi
jerk	JRk
jerome	Jxrom
jerry	jEri
jesse	JEsi
jesus	Jizxs
jesus's	Jizxsxz
jethro	JETro
jewelry	Juxlri
jewish	JuIS
jig	JIg
jiggety	JIgxti
jiggling	JIgxlIG
jill	JIl
jim	JIm
jim's	JImz
jimmy	JImi
jingle	JIGgxl
jingles	JIGgxlz
jingly	JIGgxli
job	Jab
jodie	Jodi
joe	Jo
joey	Joi
jog	Jcg
jogging	JcgIG
john	Jcn
john's	Jcnz
johnny	Jcni
johns	Jcnz
join	JOn
joke	Jok
joking	JokIG
jolly	Jcli
jonah	Jonx
jordan	Jcrdxn
jordan's	Jcrdxnz
jordan's	Jcrdxnz
joseph	Josxf
joshua	JaSux
joy	JO
joyful	JOfxl
judge	J^J
judy	Judi
judy's	Judiz
jug	J^g
juggling	J^gxlIG
juice	Jus
juices	Jusxz
juicie	Jusi
juicy	Jusi
julia	Julix
julie	Juli
july	JxlY
jumble	J^mbxl
jumbled	J^mbxld
jump	J^mp
jumped	J^mpt
jumper	J^mpR
jumping	J^mpIG
jumpingjack	J^mpIGJ@k
jumpingjacks	J^mpIGJ@ks
jumps	J^mps
june	Jun
june's	Junz
jungle	J^Ggxl
junior	JunyR
junk	J^Gk
junkajunka	J^GkxJ^Gkx
junky	J^Gki
just	J^st
jut	J^t
k	ke
k@l	ke
kaboom	kxbum
kaboomie@o	kxbumi
kanga	k@Ggx
kanga's	k@Ggxz
kangaroo	k@Ggxru
kangaroos	k@Ggxruz
kansas	k@nzxs
karate	kxrati
karen	kErxn
karen's	kErxnz
kate	ket
katherine	k@TrIn
katie	keti
katy	keti
kay	ke
kay's	kez
kayla	kelx
keaton	kitxn
keaton's	kitxnz
keep	kip
keeper	kipR
keeping	kipIG
keeps	kips
keisha	kiSx
kekek@p	keke
kelly	kEli
kelsey	kElsi
ken	kEn
kenny	kEni
kept	kEpt
kerchief	kRCif
kerchoo	kRCu
ketchup	kEC^p
kettle	kEtxl
kevin's	kEvxnz
key	ki
key's	kiz
keyboard	kibard
keys	kiz
kick	kIk
kickball	kIkbcl
kicked	kIkt
kicking	kIkIG
kicks	kIks
kid	kId
kid's	kIdz
kiddie	kIdi
kidding	kIdIG
kiddo	kIdo
kidney	kIdni
kids	kIdz
kids'	kIdz
kiki	kiki
kill	kIl
killed	kIld
killing	kIlIG
kills	kIlz
kim	kIm
kimani	kImani
kind	kYnd
kinda	kYndx
kindly	kYndli
kinds	kYndz
king	kIG
king's	kIGz
kingdom	kIGdxm
kings	kIGz
kiss	kIs
kissable	kIsxbxl
kissed	kIst
kisses	kIsIz
kissie	kIsi
kissies	kIsiz
kissing	kIsIG
kit	kIt
kitchen	kICxn
kite	kYt
kitten	kItxn
kittens	kItxnz
kitties	kItiz
kitty	kIti
kitty's	kItiz
kittycakes	kItikeks
kittycat	kItik@t
kittycats	kItik@ts
kittykitty	kItikIti
kiwi	kiwi
kleenex	klinEks
knack	n@k
knapsack	n@ps@k
knee	ni
kneedeep	nidip
kneel	nil
kneeling	nilIG
knees	niz
knew	nu
knick	nIk
knife	nYf
knifes	nYfs
knob	nab
knobs	nabz
knock	nak
knocked	nakt
knocking	nakIG
knocks	naks
knot	nat
know	no
knowledge	nalIJ
known	non
knows	noz
knox	naks
koala	koalx
kool	kul
krista	krIstx
kristen	krIstxn
kristen's	krIstxnz
kristin	krIstxn
kungfu	k^Gfu
kwanzaa	kwanzx
kyle	kYl
kyle's	kYlz
l	El
l@l	El
la	la
la@si	la
label	lebxl
labels	lebxlz
lace	les
laced	lest
laces	lesIz
lacing	lesIG
lack	l@k
lacking	l@kIG
ladder	l@dR
ladies	lediz
lady	ledi
lady's	lediz
ladybug	ledib^g
lake	lek
lamb	l@m
lambie	l@mi
lambs	l@mz
lame	lem
lamp	l@mp
land	l@nd
landed	l@ndEd
landing	l@ndIG
landings	l@ndIGz
lane	len
language	l@GgwIJ
lantern	l@ntRn
lap	l@p
lapful	l@pfxl
laps	l@ps
large	larJ
last	l@st
latch	l@tC
latches	l@tCxz
late	let
lately	letli
later	letR
latest	letIst
latin	l@tIn
laugh	l@f
laughed	l@ft
laughing	l@fIG
laughs	l@fs
laundromat	landrxm@t
laundry	lcndri
laura	lcrx
laura's	lcrxz
lauren	lcrxn
lauren's	lcrxnz
law	lc
lawn	lan
lawnmower	lanmowR
lawrence	lcrEnts
lay	le
layed	led
laying	leIG
lays	lez
lazy	lezi
leader	lidR
leading	lidIG
leaf	lif
leafy	lifi
leaking	likIG
lean	lin
leaned	lind
leaning	linIG
leap	lip
leaped	lipt
leaping	lipIG
leaps	lips
learn	lRn
learned	lRnd
learning	lRnIG
learns	lRnz
leash	liS
least	list
leave	liv
leaves	livz
leaving	livIG
led	lEd
ledge	lEJ
lee	li
left	lEft
leftie	lEfti
leftover	lEftovR
leftovers	lEftovRz
lefty	lEfti
leg	lEg
legend	lEJEnd
leggie	lEgi
leggings	lEgIGz
lego	lEgo
legos	lEgoz
legs	lEgz
lemme	lEmi
lemon	lEmxn
lemons	lEmxnz
lena	linx
lena's	linxz
leopard	lEpRd
less	lEs
let	lEt
let's	lEts
lets	lEts
letter	lEtR
letters	lEtRz
letting	lEtIG
lettuce	lEtxs
level	lEvxl
lever	lEvR
levis	livYz
lexington	lEksIGtxn
library	lIbrxri
lick	lIk
licked	lIkt
licking	lIkIG
licks	lIks
lid	lId
lid's	lIdz
lids	lIdz
lie	lY
lied	lYd
lies	lYz
life	lYf
lifesaver	lYfsevR
lifesavers	lYfsevRz
lift	lIft
liftie	lIfti
lifting	lIftIG
lifts	lIfts
light	lYt
light's	lYts
lightbulb	lYtb^lb
lightbulbs	lYtb^lbz
lighted	lYtxd
lightening	lYtnIG
lighter	lYtR
lightning	lYtnIG
lights	lYts
lightyear	lYtyIr
like	lYk
liked	lYkt
likely	lYkli
likes	lYks
liking	lYkIG
lil	lIl
lilies	lIliz
lillian	lIlixn
lily	lIli
lilypad	lIlip@d
lima	lYmx
limbs	lImz
lime	lYm
limit	lImIt
limits	lImIts
linda	lInd@
lindsey's	lIndziz
line	lYn
lined	lYnd
linen	lInEn
lingo	lIGgo
lining	lYnIG
links	lIGk
lint	lInt
lion	lYxn
lions	lYxnz
lip	lIp
lippie	lIpi
lips	lIps
lipstick	lIpstIk
liquid	lIkwId
liquids	lIkwIdz
lisa	lisx
list	lIst
listen	lIsxn
listened	lIsxnd
listening	lIsxnIG
listens	lIsxnz
lists	lIsts
lit	lIt
liter	litR
litter	lItR
litters	lItRz
little	lItxl
littler	lItxlR
littlest	lItxlEst
live	lIv
lived	lIvd
liver	lIvR
lives	lIvz
living	lIvIG
liz	lIz
lizard	lIZRd
lizard's	lIzRdz
load	lod
loads	lodz
loaf	lof
loan	lon
loans	lonz
loaves	lovz
lobster	lcbstR
lobsters	lcbstRz
lock	lak
locked	lakt
locking	lakIG
locks	laks
log	lcg
lola	lolx
lollipop	lalipap
lollipops	lalipaps
lolly	lcli
lolo	lolo
london	l^nd^n
lonely	lonli
lonesome	lonsxm
long	lcG
longed	lcGgd
longer	lcGgR
longest	lcGgEst
look	lUk
looka	lUkx
looked	lUkt
lookee	lUki
lookie	lUki
looking	lUkIG
lookit	lUkIt
looks	lUks
loom	lum
looneytoons	lunitunz
loons	lunz
loop	lup
looped	lupt
loops	lups
loose	lus
loosed	lust
loosen	lusxn
loosens	lusxnz
lop	lap
lopsided	lapsYdEd
lord	lcrd
lord's	lcrdz
lordie	lcrdi
lordy	lcrdi
loren	lcrxn
lori	loRi
lose	luz
loses	luzIz
losing	luzIG
lost	lcst
lot	lat
lot's	lats
lotion	loSxn
lots	lats
lou	lu
loud	lWd
louder	lWdR
loudie	lWdi
love	l^v
loved	l^vd
lovely	l^vli
lover	l^vR
loves	l^vz
lovie	l^vi
loving	l^vIG
lovings	l^vIGz
low	lo
lowed	lod
lower	lowR
luck	l^k
luckily	l^kxli
lucky	l^ki
lucy	lusi
luggage	l^gxJ
luggages	l^gxJxz
luis	lUwIs
lujah@si	luyx
lump	l^mp
lumpy	l^mpi
lunatic	lunxtIk
lunatics	lunxtIks
lunch	l^nC
lunchie	l^nCi
lunchmeat	l^nCmit
lunchtime	l^nCtYm
lure	lUr
luther	luTR
lydia	lIdix
lying	lYIG
lynn	lIn
lyricists	lIrIsIsts
lysol	lYscl
m	Em
m@l	Em
ma	ma
ma'am	m@m
ma@q	ma
mac	m@k
macarena	makxrEnx
macaroni	m@kxroni
macaroniandcheese	m@kxroni@ndCiz
macaronis	m@kxroniz
macdonald	mxkdanxld
macgruff	mxkgr^f
machine	mxSin
machines	mxSinz
mad	m@d
made	med
madman	m@dmxn
mag	m@g
magarina	m@gxrinx
magazine	m@gxzin
magazines	m@gxzin
magba	m@gbx
magenta	mxJEntx
maggarina	m@gxrInx
maggie	m@gi
maggie's	m@giz
magic	m@JIk
magical	m@gIkxl
magically	m@gIkli
magnet	m@gnIt
magnets	m@gnIts
mags	m@gz
magsterina	m@gstRInx
maid	med
maids	medz
mail	mel
mailbox	melbaks
mailboxes	melbaksxz
mailed	meld
mailing	melIG
maillady	melledi
mailman	melm@n
mails	melz
main	men
maine	men
mainly	menli
maintenance	mentxnxnts
make	mek
maked	mekt
makes	meks
makeup	mek^p
making	mekIG
malfunction	m@lf^GCxn
malfunctioned	m@lf^GCxnd
malfunctioning	m@lf^GCxnIG
malfunctions	m@lf^GCxnz
mall	mcl
mallet	m@lIt
malnutrition	m@lnutrISxn
malt	malt
malto	malto
mama	mamx
mama's	mamxz
mama@q	mamx
mamama	mamama
mamma	mamx
mammals	m@mxlz
mammy	m@mi
mamoo@q	mamu
man	m@n
manage	m@nEJ
managed	m@nEJd
mandy	m@ndi
mandy's	m@ndiz
maneuvering	mxnuvRIG
manger	menJR
mango	meGgo
manipulate	mxnIpyxlet
manniken	m@nIkIn
manually	m@nyuxli
many	mEni
map	m@p
marble	marbxl
march	marC
marcha	marCx
marcher	marCR
marches	marCIz
marco	marko
marco's	markoz
margaret	margrEt
margarine	marJxrIn
marianne's	m@rI@nz
marie	mxri
marie's	mxriz
marigolds	mErIgold
marino	mxrino
mark	mark
mark	mark
marked	markt
marker	markR
markers	markRz
market	markIt
marking	markIG
marks	marks
marks	marks
marmalade	marmxled
marni	marni
marriage	mErIJ
married	mErid
marry	mEri
mars	marz
marsh	marS
marshalls	marSxlz
marshmallow	marSmElo
marshmallows	marrSmEloz
martha	marrTx
mary	meri
mary's	meriz
mash	m@S
mashed	m@st
mashing	m@SIG
mason	mesxn
mass	m@s
massage	mxscZ
massive	m@sIv
master	m@stR
mastercard	m@stRCard
masterpieces	m@stRpisIz
mat	m@t
match	m@C
matches	m@CIz
matching	m@CIG
mate	met
mates	mets
material	mxtIrixl
matt	m@t
matter	m@tR
matters	m@tRz
matthew	m@Tyu
matthew's	m@Tyuz
mattress	m@trxs
maura	mcrx
maura's	mcrxz
max	m@ks
max's	m@ksxz
maximum	m@ksIm^m
may	me
maybe	mebi
mayonnaise	meyxnez
mayor	meyR
mcdonald	mxkdanxld
mcdonalds	mxkdanxldz
mcgregor	m^kgrEgR
mcgregor's	m^kgrEgRz
mcmuffin	mxkm^fIn
me	mi
me's	miz
meadow	mEdo
meal	mil
mealtime	miltYm
mean	min
meaned	mind
meanie	mini
means	minz
meant	mEnt
meantime	mintYm
meanwhile	minwYl
measure	mESUr
measures	mESUrz
measuring	mESUrIG
meat	mit
meatballs	mitbclz
meatloaf	mitlof
meaty	miti
mechanical	mxk@nIkxl
meddle	mEdxl
meddled	mEdxld
meddles	mEdxlz
meddlesome	mEdxlsxm
meddling	mEdxlIG
medical	mEdikxl
medicine	mEdIsxn
medicine's	mEdisxnz
medium	midixm
meeko	miko
meet	mit
meeting	mitIG
meets	mits
meg	mEg
mega	mEgx
megablocks	mEgxbl^ks
megan	mEgxn
melanie	mElxni
melissa	mElIsx
melon	mElxn
melt	mElt
meltdown	mEltdWn
melted	mEltEd
melting	mEltIG
melts	mElts
membrane	mEmbren
meme	meme
memee	mimi
memorize	mEmxrYz
memory	mEmxri
men	mEn
mention	mEnSxn
mentioned	mEnSxnd
meow	miW
meow@o	miW
merchant	mRCEnt
mercies	mRsiz
mercy	mRsi
mermaid	mRmed
merrily	mErxli
mesh	mES
mess	mEs
message	mEsxJ
messages	mEsxJxz
messed	mEst
messer	mEsR
messes	mEsxz
messing	mEsIG
messy	mEsi
met	mEt
metal	mEtxl
method	mETxd
mets	mEts
mew	mu
mi@si	mi
mice	mYs
michael	mYkxl
michael's	mYkxlz
micies	mYsiz
mickey	mIki
mickey's	mIkiz
mickie	mIki
micky	mIki
microphone	mYkrxfon
microphone's	mYkrxfonz
microphones	mYkrxfonz
microwave	mYkrxwev
middle	mIdxl
midmorning	mIdmcrnIG
midnight	mIdnYt
midwest	mIdwEst
might	mYt
mighty	mYti
mike	mYk
mike's	mYks
mikey	mYki
mikie	mYki
mile	mYl
miles	mYlz
military	mIlxtEri
milk	mIlk
milkie	mIlki
milkies	mIlkiz
milky	mIlki
million	mIlyxn
millions	mIlyxnz
mimi	mimi
mind	mYnd
mine	mYn
minestrone	mInxstroni
minnie	mIni
minnies	mIniz
minnows	mInoz
mint	mInt
minute	mInIt
minutes	mInIts
miranda	mIr@ndx
mirror	mIrR
mirrors	mIrRz
miserable	mIzRxbxl
misery	mIzxri
miss	mIs
missed	mIst
missing	mIsIG
mission	mISxn
missus	mIsIz
missy	mIsi
mistake	mIstek
mistaken	mIstekxn
mister	mIstR
mistreat	mIstrit
mistress	mIstrIs
mit@l	EmYti
mittens	mItxn
mix	mIks
mixed	mIkst
mixer	mIksR
mixes	mIksxz
mixing	mIksIG
mkay	xmke
mmhm	xmhxm
mm	xm
mhm	xmhxm
ohgoodness	ogUdnIs
mygoodness	mYgUdnIs
ohmygoodness	omYgUdnIs
guzenheit@snle	gxz^ndhYt
mms	xmz
mmm	xm
mmming	xmIG
mmms	xmz
mo	mo
moaning	monIG
moat	mot
mobile	mobxl
mockingbird	makIGbRd
mode	mod
model	mcdxl
modeling	mcdxlIG
moira	mOrx
molar	molR
mom	mam
mom'll	mamxl
mom's	mamz
moment	momnt
moments	momnts
momma	mcmx
momma's	mcmxz
mommies	mamiz
mommy	mami
mommy'll	mamixl
mommy's	mamiz
moms	mcmz
monday	m^nde
money	m^ni
moneys	m^ni
monica	manIkx
monitor	manItR
monkey	m^Gki
monkey's	m^Gkiz
monkeys	m^Gkiz
monst	manst
monster	manstR
monster's	manstRz
monsters	manstRz
monstrous	manstR^s
month	m^nT
months	m^nTs
moo	mu
moo@o	mu
mooboosh	mubuS
moocow	mukW
mood	mud
moody	mudi
mookaboosh	mukxbuS
moomoo	mumu
moomooshas	mumuSxz
moon	mun
moonlight	munlYt
moose	mus
moosh	muS
mooshaboosh	muSxbuS
mooshaboosha	muSxbuSx
mooshabooshas	muSxbuSxz
mooshas	muSxz
mooshasboosh	muSxzbuS
mooshboosh	muSbuS
mooshbooshas	muSbuSxs
mooshieboosh	muSibuS
mooshiebooshas	muSibuSxz
mooshmoosh	muSmuS
mooski	muski
mootas	mutxz
mootash	mut@S
mootie	muti
mootieboosh	mutibuS
mootiebooshas	mutibuSxz
mootiemoo	mutimu
mootiemooshas	mutimuSxz
mop	map
mopped	mapt
moppet	mapxt
mopping	mapIG
mops	maps
mopsy	mapsi
more	mcr
morgan	mcrgG
morgan's	mcrgGz
morgie	mcrgi
morgie's	mcrgiz
morning	mcrnIG
moses	mozxs
mosquito	mxskito
mosquitos	mxskitoz
moss	mas
most	most
mostest	mostEst
mostly	mostli
mother	m^DR
mother's	m^DRz
motherland	m^DRl@nd
mothers	m^DRz
moths	mcTs
motive	motIv
motor	motR
motorbike	motRbYk
motorcycle	motRsYkxl
mount	mWnt
mountain	mWntxn
mountains	mWntxnz
mountaintop	mWntxntap
mouse	mWs
mouse's	mWsxz
mouses	mWsxz
mousie	mWsi
mouth	mWT
mouthful	mWTfxl
mouthie	mWTi
mouthing	mWTIG
mouthpiece	mWTpis
mouths	mWDz
move	muv
moved	muvd
movement	muvmEnt
movements	muvmEnts
moves	muvz
movie	muvi
movies	muviz
moving	muvIG
mow	mo
mower	mowR
mowing	mowIG
ms	xmz
much	m^C
mud	m^d
muddy	m^di
mufasa	mufasx
muffet	m^fxt
muffin	m^fIn
muffins	m^fInz
mug	m^g
mugs	m^gz
mulan	mulan
mulberry	mxlbEri
mules	myulz
multicolored	m^ltik^lRz
multiple	m^ltIpxl
multitalented	m^ltit@lxntxd
mum	m^m
mumbling	m^mblIG
mummy	m^mi
munch	m^nC
munchkin	m^nCkIn
muppet	m^pIt
muppets	m^pIts
murphy	mRfi
muscleman	m^sxlm@n
muses	muzEz
museum	myuzixm
mush	m^S
mushed	m^St
mushing	m^SIG
mushroom	m^Srum
mushrooms	m^Srumz
mushy	m^Si
music	myuzIk
musical	musikxl
muskrats	m^skr@ts
must	m^st
mustache	m^st@S
mustard	m^stRd
mustn't	m^sxnt
mutilate	myutxlet
my	mY
myself	mYsElf
mystery	mIstRi
n	En
n@l	En
nah	na
nail	nel
nails	nelz
naked	nekxd
nala	nalx
name	nem
name's	nemz
named	nemd
names	nemz
naming	nemIG
nan	n@n
nan's	n@nz
nana	n@nx
nana's	nanxz
nananana	nanxnanx
nap	n@p
napkin	n@pkIn
napkins	n@pkInz
nappie	n@pi
nappies	n@piz
napping	n@pIG
nappy	n@pi
naps	n@ps
naptime	n@ptYm
nas	naz
nasty	n@sti
nathan	neTxn
nation	neSxn
nations	neSxnz
natural	n@tUrxl
naturally	n@Crxli
naughty	ncti
nautilus	nctIlxs
navigate	n@vxget
navy	nevi
near	nIr
nearby	nIrbY
nearer	nIrR
nearly	nIrli
neat	nit
neatest	nitEst
neatly	nitli
neato	nito
necessarily	nEsxsErxli
necessary	nEsxsEri
neck	nEk
necklace	nEklIs
necklaces	nEklxsxz
neckties	nEktYz
ned	nEd
need	nid
needed	nidId
needing	nidIG
needle	nidxl
needs	nidz
negative	nEgxtIv
neglecting	nxglEktIG
neigh	ne
neighbor	nebR
neighbor's	nebRz
neighborhood	nebRhUd
neighborly	nebRli
neighbors	nebRz
neither	niDR
nellie	nEli
neon	nian
nephew	nEfyu
nephew's	nEfyuz
nerve	nRv
nerves	nRvz
nervous	nRvxs
nest	nEst
nesting	nEstIG
nests	nEsts
net	nEt
neuter	nutR
neutral	nutrxl
never	nEvR
new	nu
newborns	nubarnz
newport	nupcrt
news	nUz
newspaper	nuzpepR
newt	nUt
next	nEkst
nibbled	nIbxld
nice	nYs
nicely	nYsli
nicer	nYsR
nick	nIk
nickel	nIkxl
nickelodeon	nIkxlodixn
nicole	nIkoxl
niece	nis
nigerians	nYJIrixnz
night	nYt
night's	nYts
nightgown	nYtgWn
nightgowns	nYtgWnz
nightie	nYti
nightlight	nYtlYt
nightmare	nYtmEr
nightnight	nYtnYt
nights	nYts
nightshirt	nYtSRt
nighttime	nYttYm
nilly	nIli
nine	nYn
nineteen	nYntin
ninety	nYndi
ninja	nInJx
nino	nino
ninth	nYnT
nipple	nIpxl
nixie	nIksi
no	no
noah	nox
noah's	noxz
noba@c	nobx
nobody	nobadi
nobody's	nobadiz
nodded	nadxd
nodding	nadIG
noggin	nagIn
noise	nOz
noises	nOzIz
noisy	nOzi
none	n^n
nonexistent	nanIgzIstxnt
nono	nono
nonono@si	nonono
nononoing	nononoIG
noodle	nudxl
noodles	nudxlz
nookcase@n	nUkes
noontime	nUntYm
nope	nop
nopes	nops
nopie	nopi
nor	nar
normal	ncrmxl
normally	ncrmxli
north	narT
nose	noz
nosed	nozd
nosedives	nozdYvz
noses	nozIz
nosey	nozi
nosie	nozi
not	nat
note	not
notes	nots
nothing	n^TIG
nothing's	n^TIGz
notice	notIs
noticed	notIst
notices	notIsxz
noticing	notIsIG
novelty	navxlti
november	novEmbR
now	nW
nowhere	nowEr
nudieper	nudipR
nudist	nudIst
nugget	n^gEt
nuggets	n^gEts
nuhuh	n^^
nuisance	nusEnts
num	n^m
number	n^mbR
numbers	n^mbRz
nummies	n^miz
nummy	n^mi
numnum	n^mn^m
nurse	nRs
nursery	nRsxri
nurses	nRsIz
nursing	nRsIG
nut	n^t
nutcracker	n^tkr@kR
nutrient	nutrixnt
nutritional	nutrISxnxl
nutritious	nutrISxs
nuts	n^ts
nutty	n^ti
o	o
o'clock	xklak
o'clocker	oklakR
o'clocks	xklaks
o@l	o
o@l-s	o
oatmeal	otmil
oats	ots
obedient	obidiEnt
obekaybe	obikebi
obey	obe
obi	obi
obi's	obiz
obie	obi
objects	abJIks
observed	xbzRvd
observing	xbzRvIG
obsessed	xbsEst
obtained	xbtend
obvious	abvixs
obviously	abvixsli
occasion	xkeSxn
occasionally	xkeZxnxl
occurred	xkRd
ocean	oSxn
octagon	aktxgan
october	aktobR
octopi	aktxpY
octopus	aktxp^s
odd	ad
of	xv
off	cf
off@n	af
offensive	xfEnsIv
offer	afR
offered	afRd
offers	cfRz
offhand	cfh@nd
office	cfIs
official	xfISxl
officially	xfISxli
often	cfxn
oh	o
ohio	ohYo
oil	Oxl
oiled	Old
oink	OGk
oink@o	OGk
oinkoink	OGkOGk
ointment	OntmEnt
ok	oke
okay	oke
okeydokey	okidoki
old	old
olden	oldxn
older	oldR
olive	alIv
olives	alIvz
olivia	xlIvix
omega	omEgx
on	an
once	w^ns
one	w^n
one's	w^nz
ones	w^nz
onesie	w^nsi
onie	w^ni
onion	^nyxn
onions	^nyxnz
online	anlYn
only	onli
onsie	w^nsi
onsies	w^nsiz
onto	antu
oop	up
oops	ups
oopsadaisy	upsxdezi
oopsadaisys	upsxdeziz
oopsie	upsi
oopsiedoozies	upsiduziz
oopsiedoozy	upsiduzi
oopsies	upziz
op@c	ap
open	opxn
opened	opxnd
opener	opxnR
opening	opxnIG
opens	opxnz
operation	apxreSxn
operator	cpRatR
opinion	xpInyxn
opportunity	apRtunIti
opposed	xpozd
opposite	apxzIt
opposites	apxsIts
option	apCG
options	apCGz
or	cr
orange	crInJ
oranges	crInJxz
orangish	crInJIS
orangutan	cr@Ggxt@n
order	crdR
ordered	crdRd
ordering	crdRIG
orderly	crdRli
ordinary	crdInEri
organize	crgxnYz
organized	crgxnYzd
originally	xrIJxnxli
orioles	criolz
ornaments	crnxmEnts
orphan	crfxn
orthodontic	crTxdantIk
orthodontics	crTxdantIks
orthodontist	crTxdantIst
orthodontist's	crTxdantIsts
orthodontists	crTxdantIsts
oscar	askR
oscar's	askRz
ostrich	astrIC
otay	ote
other	^DR
others	^DRz
otherwise	^DRwYz
ouch	WC
ouchie	WCi
ouchies	WCiz
ought	ct
oughtta	ctx
ounce	Wnts
ounces	Wntsxz
our	ar
ours	arz
ourself	arsElf
out	Wt
outdoor	Wtdcr
outdoors	Wtdcrz
outer	WtR
outfit	WtfIt
outgrown	Wtgron
outlaw	Wtlc
outlet	WtlEt
outlets	WtlEts
outrageous	WtreJxs
outside	WtsYd
outtalk	Wttck
oval	ovxl
oven	^vxn
over	ovR
overalls	ovRclz
overboard	ovRbcrd
overflow	ovRflo
overflowing	ovRfloIG
overload	ovRlod
overnight	ovRnYt
overtime	ovRtYm
overzealous	ovRzEl^s
ow	W
owe	o
owie	Wi
owl	Wxl
owl's	Wxlz
owls	Wxlz
own	on
owned	ond
owner	onR
owowow@o	WWW
oyster	OstR
p	pi
p@l	pi
pacie	pesi
pacifier	p@sIfYR
pacifiers	p@sIfYR
pack	p@k
package	p@kxJ
packages	p@kxJxz
packed	p@kt
packet	p@kEt
packing	p@kIG
packs	p@ks
pad	p@d
pad's	p@dz
paddy	p@di
page	peJ
paged	peJd
pager	peJR
pages	peJIz
paging	peJIG
paid	ped
pail	pel
pain	pen
painful	penfxl
paint	pent
painted	pentxd
painting	pentIGz
pair	pEr
pairs	pErz
pajama	pxJamx
pajamaies	pxjamxz
pajamas	pxJ@mxz
pal	p@xl
palace	p@lIs
paly	peli
pamper	p@mpR
pamper's	p@mpRz
pampers	p@mpRz
pan	p@n
pancake	p@nkek
pancakes	p@nkeks
panda	p@ndx
panicked	p@nIkt
pans	p@nz
pant	p@nt
panther	p@nTR
panties	p@ntiz
panting	p@ntIG
pantry	p@ntri
pants	p@nts
pantsie	p@ntsi
pantsies	p@ntsiz
papa	papx
papaya	pxpYyx
paper	pepR
papers	pepRz
paperwork	pepRwRk
papou	pxpu
parade	pxred
parading	pxredIG
paranoid	pErxnOd
parcheesi	parCizi
pardon	pardxn
parents	pErEnts
parents's	pErEntsxz
park	park
parked	parkt
parkie	parki
parlor	parlR
parrot	pErxt
parsnipie	parsnIpi
parsnips	parsnIps
part	part
participate	partIsIpet
particular	pRtIkyxlR
particularly	partICulRli
parting	partIG
partner	partnR
parts	parts
party	parti
pass	p@s
passed	p@st
passenger	p@sEnJR
passes	p@sIz
passing	p@sIG
password	p@swRd
past	p@st
pasta	pastx
paste	pest
pasty	pesti
pat	p@t
patch	p@C
patched	p@Ct
patches	p@Cxz
patching	p@CIG
patchy	p@Ci
path	p@T
patience	peSxnts
patient	peSxnt
patients	peSxnnts
patio	p@tio
patrice	pxtris
patrick	p@trIk
patricks	p@triks
pats	p@ts
patted	p@tId
patterns	p@tRnz
patting	p@tIG
patty	p@ti
pattycake	p@tikek
pattycaking	p@tikekIG
pattytake	p@titek
paul	pcl
paul's	pclz
paula	pclx
pause	pcz
paused	pczd
pausing	pczIG
pavement	pevmxnt
pavilioned	pxvIlyxnd
paw	pc
paws	pcz
pay	pe
paycheck	peCEk
payed	ped
paying	peIG
payment	pemxnt
payments	pemxnts
payperview	pepRvyu
pea	pi
peace	pIs
peaceful	pIsfxl
peach	piC
peaches	piCxz
peanut	pin^t
peanutbutter	pin^tb^tR
peanuts	pin^ts
pear	pEr
pearie	pEri
pearl	pRl
pearly	pRli
pears	pErz
peary	pEri
peas	piz
pedals	pEdxlz
pedialyte	pidixlYt
pee	pi
peed	pid
peeing	piIG
peek	pik
peeka	pikx
peekaboo	pikxbu
peeks	piks
peel	pil
peeled	pild
peeling	pilIG
peels	pilz
peep	pip
peeped	pipt
peepee	pipi
peepees	pipiz
peeping	pipIG
peers	pIrz
pees	piz
peeyou	piyu
peeyoustinky	piyustIGki
peg	pEg
pegasus	pEgasxs
pegger	pEgR
peggie	pEgi
pegs	pEgz
pen	pEn
pencil	pEnsxl
pencils	pEnsxlz
penguin	pEGgwIn
penguins	pEGgwInz
penney	pEni
pennies	pEniz
penny	pEni
pens	pEnz
pentagon	pEntxgan
peonies	pixniz
peony	pixni
people	pipxl
people's	pipxlz
pepe	pepe
pepper	pEpR
pepper's	pEpRz
peppers	pEpRz
pepsi	pEpsi
per	pR
percent	pRsEnt
perfect	pRfIkt
perfectly	pRfIktli
perform	pRfcrm
performed	pRfcrmd
performer	pRfcrmR
performing	pRfcrmIG
performs	pRfcrmz
perfume	pRfyum
perhaps	pRh@ps
period	pIrixd
permission	pRmISxn
peroxide	pRaksYd
perpendicular	pRpxndIkyxlR
persistent	pRsIstEnt
person	pRsxn
person's	pRsxnz
personal	pRsxnxl
personality	pRsxn@lIti
personnel	pRsxnEl
perspective	pRspEktIv
perspiration	pRspReSxn
pesky	pEski
pester	pEstR
pet	pEt
petal	pEtxl
petals	pEtlz
pete	pit
peter	pitR
peter's	pitRz
pets	pEts
petted	pEtxd
petting	pEtIG
phil	fIl
phillip	fIlIp
philosophy	fIlasofi
phone	fon
phone's	fonz
phones	fonz
phonics	faniks
phony	foni
photo	foto
photogenic	fotogEnIk
photographic	fotogr@fIk
photosynthesis	fotosInTesIs
phrase	frez
piano	pi@no
picachu	pikaCu
pick	pIk
picked	pIkt
picking	pIkIG
pickle	pIkxl
pickles	pIkxlz
picks	pIks
picky	pIki
picnic	pIknIk
picnics	pIknIks
picture	pIkCR
pictures	pIkCRz
pie	pY
piece	pis
pieces	pisIz
pies	pYz
pig	pIg
pigeon	pIJxn
pigeons	pIJxn
piggie	pIgi
piggies	pIgiz
piggy	pIgi
piggy's	pIgiz
piglet	pIglIt
piglet's	pIglEts
piglets	pIglEts
pigpen	pIgpEn
pigs	pIgz
pigtail	pIgtexl
pike	pYk
pile	pYl
piles	pYlz
pillow	pIlo
pillows	pIloz
pin	pIk
pina	pinx
pinch	pInC
pinched	pInCt
pinchie	pInCi
pinching	pInCIG
pine	pYn
pineapple	pYn@pxl
pineapples	pYn@pxlz
pinecones	pYnkonz
pink	pIGk
pinkie	pIGki
pinky	pIGki
pinnochio	pInokio
pins	pInz
pinto	pInto
pipe	pYp
piper's	pYpRz
piping	pYpIG
pipsqueak	pIpskwik
pissant@n	pIs@nt
pissy	pIsi
pit	pIt
pitched	pICt
pitcher	pItCR
pitiful	pItifxl
pizza	pIzx
pjs	piJez
place	ples
placed	plest
places	plesxz
plain	plen
plainly	plenli
plan	pl@n
plane	plen
planet	pl@nIt
planing	plenIG
plant	pl@nt
planted	pl@ntxd
plants	pl@nts
plastic	pl@stIk
plate	plet
plates	plets
platinum	pl@txnxm
platter	pl@tR
play	ple
played	pled
player	pleR
playful	plefxl
playground	plegrWnd
playgroup	plegrup
playhouse	plehWs
playing	pleIG
playoffs	plecfs
playpen	plepEn
playpenie	plepEni
playroom	plerum
plays	plez
playtex	pletEks
playtime	pletYm
pleasant	plEzxnt
please	pliz
pleased	plizd
pleasure	plEZR
plenty	plEnti
plop	plap
plops	plaps
plow	plW
plug	pl^g
plugged	pl^gd
plugs	pl^gz
plum	pl^m
plums	pl^mz
plunged	pl^nJd
plus	pl^s
pluto	pluto
pochahontas	pokxhantxs
pocket	pakIt
pocketbook	pakItbUk
pockets	pakIts
pod	pad
point	pOnt
pointed	pOntId
pointer	pOntR
pointers	pOntRz
pointing	pOntIG
points	pOnts
pointy	pOnti
poison	pOsIn
poisonous	pOsinxs
poke	pok
pokecenter	poksEntR
poked	pokt
pokefood	pokfud
pokemon	pokiman
pokes	poks
pokey	poki
pokie	poki
poking	pokIG
polar	polR
pole	pol
poles	polz
police	pxlis
policeman	pxlIsmxn
policy	palIsi
polish	palIS
polished	palISt
polishes	palISxz
polishing	palISIG
polite	pxlYt
politely	pxlYtli
polkadot	polkxdat
polo	polo
polyester	paliEstR
pond	pand
pony	poni
ponytail	ponitel
poo	pu
poo's	puz
poodle	pudxl
pooh	pu
pooh's	puz
poohs	puz
pooie	pui
pookie	puki
pool	pul
poop	pup
poopie	pupie
poopied	pupId
poopies	pupIz
pooping	pupIG
poopoo	pupu
poopoos	pupuz
poops	pups
poopsie	pupsi
poopsie^boo	pupsibu
poopsieboo	pupsibu
poor	pUr
poos	puz
pop	pap
popbeads	papbidz
popcorn	papkcrn
popeye	papY
popped	papt
poppetypoppoppop	papEtipappappap
popping	papIG
poppy	papi
popsicle	papsIkxl
popular	papyulR
popup	pap^p
porch	parC
porcupine	parkyxpYn
porridge	parIJ
portfolio	pcrtfolio
porthole	pcrthol
pose	poz
poser	pozR
posies	poziz
position	posISxn
positive	pazxtIv
possible	pasxbxl
possibly	pasxbli
possums	pas^mz
post	post
posted	postxd
poster	postR
posting	postIG
posts	posts
posy	posi
pot	pat
potato	pxteto
potatos	pxtetoz
potent	potxnt
potholder	patholdR
potpourri	potpori
pots	pats
potted	patId
potter	patR
potty	pati
pottytrain	patitren
pouch	pWC
pouches	pWCxz
pouncy	pWntsi
pound	pWnd
pounding	pWndIG
pounds	pWndz
pour	par
poured	pard
pouring	pcrIG
pours	parz
pouting	pWtIG
pouty	pWti
pow	pW
powder	pWdR
powells	pWlz
power	pWR
powerful	pWrfxl
practically	pr@ktICxli
practice	pr@ktIs
practicing	pr@ktIsIG
prairie	prEri
praise	prez
praised	prezd
pray	pre
prayer	prer
prayers	prerz
precious	prESxs
precisely	prIsYsli
prefer	prIfR
prefers	prIfRz
pregnant	prEgnxnt
prehistoric	prihIstcrIk
premiums	primi^mz
preparation	prEpxr@Sxn
prepare	prIpEr
preschool	priskul
prescription	prxskrIpSxn
prescriptions	prxskripSxnz
presence	prEzxnts
present	prEzxnt
presents	prEzxnts
preserver	prIzRvR
press	prEs
pressed	prEst
pressing	prEsIG
pressure	prESR
pretend	prItEnd
pretending	prItEndIG
prettier	prItiR
pretties	prItis
pretty	prIti
pretzel	prEtzxl
pretzels	prEtzxlz
prevents	prIvEnts
price	prYs
prick	prIk
pricked	prIkt
prickly	prIkli
primarily	prYmErxli
primary	prYmEri
prime	prYm
prince	prInts
princess	prInsEs
principle	prInsxpxl
printed	prIntxd
prior	prYR
priority	prYarIti
private	prYvxt
privilege	prIvxlxJ
prize	prYz
pro	pro
probably	prabxli
problem	prablxm
problems	prablxmz
procedure	prxsiJR
process	prcsIs
produce	produs
produced	produst
product	prad^kt
products	prad^kts
professor	profEsR
profiling	profYlIG
program	progr@m
project	praJEkt
projects	praJEkts
promise	pramIs
promised	pramIst
promises	pramIsIz
promote	prxmot
pronunciation	prxn^nsieSxn
proof	pruf
propeller	propElR
proper	prapR
properly	prapRli
protect	protEkt
protected	protEktId
protecting	protEktIG
protection	protEkSxn
protein	protin
protest	protEst
protesting	protEstIG
proud	prWd
prove	prUv
provider	prxvYdR
proving	pruvIG
prowl	prWxl
prunes	prunz
psalm	zalm
psalms	zalmz
psghettios	pskEtioz
psycho	sYko
publish	p^blIS
pucker	p^kR
puckering	p^kRIG
pudding	pUdIG
puddle	p^dxl
puddleduck	p^dxld^k
puddles	p^dxlz
puddy	p^di
puff	p^f
puffed	p^ft
pull	pUl
pulled	pUld
pulling	pUlIG
pullover	pUlovR
pulls	pUlz
pumba	pumbx
pump	p^mp
pumpkin	p^mpkIn
pumpkins	p^mpkInz
punch	p^nC
punishment	p^nISmxnt
punkin	p^nkin
punky	p^nki
pup	p^p
puppet	p^pIt
puppets	p^pIts
puppies	p^piz
puppy	p^pi
puppy's	p^piz
puppydog	p^pidcg
pups	p^ps
purchase	pRCIs
purifier	pRIfYR
purple	pRpxl
purpose	pRpxs
purr	pR
purse	pRs
push	pUS
pushed	pUSt
pushes	pUSxz
pushing	pUSIG
pushovers	pUSovRz
pussycat	pUsiC@t
put	pUt
puts	pUts
putted	pUtEd
putting	pUtIG
puzzle	p^zxl
puzzles	p^zxlz
q@l	kyu
qrs@k	kyuarEs
quack	kw@k
quackeroo	kw@kxru
quacking	kw@kIG
quackquack	kw@kkw@k
quail	kwel
quails	kwelz
quality	kwclIti
quarrel	kwcrxl
quarter	kwartR
quarters	kwartRz
quasimodo	kwazimodo
queeka	kwikx
queekie	kwiki
queekiemoo	kwikimu
queekola	kwikolx
queekster	kwikstR
queen	kwin
quesadillas	kEsxdiyxz
question	kwEsCxn
questionable	kwEsCxnxbxl
questioning	kwesCxnIG
quick	kwIk
quickly	kwIkli
quiet	kwYIt
quieter	kwYItR
quietly	kwYEtli
quietness	kwYEtnxs
quilt	kwIlt
quilts	kwIlts
quincy	kwInsi
quit	kwIt
quite	kwYt
quitter	kwItR
quiver	kwIvR
quivering	kwIvRIG
quiz	kwIz
quizzed	kwIzd
quote	kwot
r	ar
r@l	ar
rabbit	r@bIt
rabbit's	r@bits
rabbits	r@bIts
raccoon	r@kun
raccoon's	r@kunz
raccoons	rxkunz
race	res
raced	rest
races	resxz
raceway	reswe
racing	resIG
radiator	redietR
radio	redio
radio's	redioz
radios	redioz
radish	r@dIS
rag	r@g
raggedy	r@gIdi
rags	r@gz
rahab	rxhab
rail	rexl
railing	rexlIG
railroad	rexlrod
rain	ren
rainbow	renbo
raincoat	renkot
raindrops	rendraps
rained	rend
raineth	renIT
raining	renIG
rains	renz
rainy	reni
raise	rez
raisin	rezIn
raisinbran	rezInbr@n
raising	rezIG
raisins	rezInz
rake	rek
ram	r@m
ramble	r@mbxl
rambling	rxmblIG
ramen	ramxn
ramshacking	r@mS@kIG
ran	r@n
ranch	r@nC
rang	r@G
range	r@nJ
rap	r@p
rap's	r@ps
rapped	r@pt
rapping	r@pIG
raps	r@ps
rarely	rErli
rascal	r@skxl
rash	r@S
rashes	r@SEz
raspberry	r@zbEri
rat	r@t
rather	r@DR
rats	r@ts
rattle	r@txl
rattles	r@txlz
rattly	r@tli
raven	revxn
ravens	revxnz
ray	re
raying	reyIG
raymond	remxnd
rays	rez
razor	razR
re@si	re
reach	riC
reached	riCt
reaches	riCxz
reaching	riCIG
react	ri@kt
read	rid
reading	ridIG
reads	ridz
ready	rEdi
real	ril
realistic	rixlIstIk
realize	rixlYz
realized	rixlYzd
really	rili
reapplied	riaplYd
rear	rIr
rearrange	ri^renJ
rearranged	ri^renJd
rearranges	ri^renJxz
rearranging	ri^renJIG
reason	rizxn
reassured	rixSRd
reattach	rixt@C
rebuild	ribIld
receipt	rIsit
receipts	rIsits
receive	rIsiv
received	rIsivd
receiver	rIsivR
receives	rIsivz
receiving	rIsivIG
recently	risxntli
recharges	riCarJxz
recite	rIsYt
recognize	rEkxgnYz
recognizes	rEkxgnYzIz
recognizing	rEkxgnYzIG
recommended	rEkxmEndId
record	rEkRd
recorded	rEkcrdxd
recorder	rIkcrdR
recorder's	rEkcrdRz
recordie	rEkcrdi
recording	rIkcrdIG
recordings	rIkcrdIGz
records	rEkRdz
recovered	rEk^vRd
rectangle	rEkt@Ggxl
recyclable	risYklxbxl
recycling	risYkxlIG
red	rEd
redhead	rEdhEd
redid	ridId
redo	ridu
reference	rEfrxns
refill	rifIl
reflection	rEflEkSxn
refraction	rEfr@kSxn
refrigerant	rEfrIJRxnt
refrigerator	rIfrIJxretR
refuge	rEfuJ
refused	rifUzd
regarding	rigardIG
reggie	rEJi
register	rEJIstR
registered	rEJIstRd
registering	rEJIstRIG
registers	rEJIstRz
regressing	rIgrEsIG
regular	rEgyxlR
regularly	rEgyxlRli
regulate	rEgulet
regurgitated	rEgRJItetxd
reindeer	rendIr
rejected	rEJEktxd
rejoice	riJOs
relate	rIlet
related	riletxd
relationship	rIleSxnSIp
relax	rIl@ks
relaxed	rIll@kst
relaxing	rIl@ksIG
relay	rile
released	rIlIst
relieves	rIlivz
religious	rIlIJ^s
relocate	riloket
remco	rEmko
remedy	rEmxdi
remember	rImEmbR
remembered	rImEmbRd
remembers	rImEmbRz
remifasolatido@si	rEmifasolatido
remind	rImYnd
reminded	rImYndId
reminding	rImYndIG
reminds	rImYndz
remote	rImot
remove	rImuv
removed	rImuvd
renewed	rinud
rent	rEnt
rented	rEntxd
renting	rEntIG
rents	rEnts
repaint	ripent
repairman	ripErm@n
repeat	rIpit
repeated	rIpitId
repeating	rIpitIG
repetition	rEpItISxn
replace	riples
replant	ripl@nt
replied	riplYd
reply	riplY
report	ripcrt
reported	ripcrtxd
repot	ripat
representative	rEprizEntxtIv
reptar	rEptar
republic	rip^blIk
requires	riKwYRz
rescue	rEskyu
rescued	rEskyud
rescues	rEskyuz
resealable	risilxbxl
resistant	rEsIstxnt
respect	rxspEkt
respond	rIspand
responding	rxspandIG
response	rIspans
rest	rEst
restaurant	rEstRant
resting	rEstIG
restrain	rIstren
restrained	rIstrend
result	rIz^lt
resulted	rIz^ltxd
resulting	rIz^ltIG
results	rIz^lts
retarded	ritardxd
retardo	rItardo
retired	ritYRd
return	rItRn
returned	rItRnd
returning	rItRnIG
returns	rItRnz
reunion	riyuny^n
reveal	rIvil
reversal	rIvRsxl
reverse	rIvRs
reversible	rIvRsIbxl
review	rIvyu
reward	rIwcrd
rex	rEks
rhinoceros	rYncsErxs
rhinoceroses	rYncsErxsxz
rhyme	rYm
rhymes	rYmz
rhyming	rYmIG
rhythm	rITxm
ribbet	rIbIt
ribbon	rIbxn
ribbons	rIbxnz
ribs	rIbz
rice	rYs
rich	rIC
richard	rICRd
rick	rIk
ricky	rIki
rid	rId
ride	rYd
riders	rYdRz
rides	rYdz
ridiculous	rIdIkyxlxs
riding	rYdIG
right	rYt
rightie	rYti
ring	rIG
ringer	rIGgR
ringing	rIGIG
rings	rIGz
rinse	rInts
rinsed	rIntst
rinsing	rIntsIG
rip	rIp
ripe	rYp
ripped	rIpt
ripping	rIpIG
rips	rIps
risen	rIzxn
river	rIvR
rivers	rIvRz
road	rod
roadblock	rodblak
roadrunner	rodr^nR
roads	rodz
roaming	romIG
roar	rcr
roast	rost
robbin's	rcbInz
robert	rcbRt
roberts	rcnRts
robin	rcbIn
robitussin	robit^sIn
rock	rak
rockandroll	rak@ndrol
rocker	rakR
rockers	rakRz
rocketship	rakEtSIp
rockie	rcki
rocking	rakIG
rockingchair	rckIGCEr
rockinghorse	rckIGhcrs
rocks	raks
roll	rol
rolled	rold
roller	rolR
rolling	rolIG
rolls	rolz
rolypoly	rolipoli
rommy	rami
romper	rampR
ron	rcn
roo	ru
roof	ruf
roofing	rufIG
room	rum
room's	rumz
rooms	rumz
roomy	rumi
roosteen	rustin
rooster	rustR
roosters	rustRz
root	rut
rope	rop
rose	roz
roses	rozIz
rosey	rozi
rosie	rozi
rosies	roziz
ross	rcs
rosy	rozi
rote	rot
rotten	rctxn
rough	r^f
rougher	r^fR
round	rWnd
router	rWtR
routine	rutin
routines	rutinz
rove	rov
rover	rovR
row	ro
roy	rO
rub	r^b
rubbed	r^nd
rubber	r^bR
rubbery	r^bRi
rubbing	r^bIG
rubs	r^bz
ruby	rubi
rude	rud
ruffle	r^fxl
ruffly	r^fxli
rug	r^g
rugrat	r^gr@t
rugrats	r^gr@ts
rugs	r^gz
ruin	ruIn
rule	rul
rules	rulz
rumbling	r^mblIG
run	r^n
runaway	r^nxwe
runner	r^nR
running	r^nIG
runny	r^ni
runs	r^nz
rush	r^S
rushed	r^St
rushing	r^SIG
russell	r^sxl
rustles	r^stxlz
rustling	r^stxlIG
rutabaga	rUtxbegx
ryan	rYxn
rye	rY
s	Es
s@l	Es
sad	s@d
sadly	s@dli
safe	sef
safer	sefR
safest	sefEst
safety	sefti
said	sEd
sailboat	selbot
sailed	seld
sailing	selIG
sailor	selR
sailors	selRz
saint	sent
sakes	seks
salad	s@lxd
salads	s@lxdz
sale	sel
sally	s@li
salmon	s@mxn
salsa	sclsx
salt	sclt
salvation	s@lveSxn
sam	s@m
samantha	sxm@nTx
same	sem
samich	s@mIC
sammy	s@mi
sample	s@mpxl
sampling	s@mpxlIG
samuel	s@myUxl
sand	s@nd
sandal	s@ndxl
sandals	s@ndxlz
sandman	s@ndm@n
sandwich	s@ndwIC
sandy	s@ndi
sang	s@G
sanitize	s@nItYz
santa	s@ntx
santas	s@ntxz
sara	s@rx
sarah	s@rx
sat	s@t
satisfied	s@tIsfYd
satisfies	s@tIsfYz
satisfy	s@tIsfY
satisfying	s@tIsfYIG
saturday	s@tRde
sauce	scs
saucer	scsR
saucers	scsRz
sauces	scsxz
sausage	scsEJ
save	sev
saved	sevd
saves	sevz
saving	sevIG
savings	sevIGz
saw	sc
say	se
saybut	seb^t
saychugga@o	seC^gx
saying	seIG
says	sEz
scale	skexl
scamper	sk@mpR
scare	skEr
scarecrow	skErkro
scared	skErd
scarf	skarf
scaring	skErIG
scarry	skEri
scary	skEri
scary's	skEriz
scattering	sk@tRIG
scene	sIn
scenes	sInz
scent	sEnt
schedule	skEJUl
scheduled	skEJxld
schedules	skEJxlz
scheduling	skEJxlIG
schnucks	Sn^ks
school	skul
schoolhouse	skulhWs
science	sYEnts
scissorhand	sIzRh@nd
scissors	sIzRz
scooby	skubi
scoop	skup
scooping	skupIG
scoot	skut
scooter	skutR
scooting	skutIG
scored	skard
scorpion	skarpixn
scott	skat
scottish	skctIS
scramble	skr@mbxl
scrambled	skr@mbxld
scrape	skrep
scraped	skrept
scraping	skrepIG
scratch	skr@C
scratch	skr@C
scratched	skr@Ct
scratches	skr@Cxz
scratching	skr@CIG
scratching	skr@CIG
scratchy	skr@Ci
scream	skrim
screaming	skrimIG
screams	skrimz
screech	skriC
screecher	skriCR
screen	skrin
screw	skru
screwdriver	skrudrYvR
screwed	skrUd
screwy	skrUwi
scribble	skrIbxl
scribbles	skrIbxlz
scrub	skr^b
scrubbed	skr^bd
scrubbie	skr^bi
scrubby	skr^bi
scrumbilicious@n	skr^mbIlISxs
scrumblicious@n	skr^mblISxs
scrumptious	skr^mpCxs
scuba	skubx
scurry	skRi
sea	si
seafood	sifud
seagulls	sig^lz
seal	sil
seal's	silz
sealie	sili
sean	Scn
search	sRC
searched	sRCt
seashells	siSElz
seashore	siScr
season	sizxn
seasoning	sizxnIG
seasons	sizxnz
seat	sit
seats	sits
sebastian	sxb@sCxn
sec	sEk
second	sEkxnd
seconds	sEkxndz
secret	sikrEt
secrets	sikrEts
sectioned	sEkSxnd
sections	sEkSxnz
secure	sxkyUr
see	si
seeandsay	si@ndse
seed	sid
seeds	sidz
seeing	siIG
seek	sik
seem	sim
seemed	simd
seemingly	simIGli
seems	simz
seen	sin
sees	siz
seesaw	sisc
segment	sEgmxnt
seize	siz
selection	sIlEkSxn
self	sElf
sell	sEl
selling	sElIG
sells	sElz
seltzer	sEltzR
semicircle	sEmIsRkxl
send	sEnd
sending	sEndIG
sends	sEndz
sense	sEns
sensitive	sEnsItIv
sent	sEnt
sentence	sEntxns
sentences	sEntxnsIz
separate	sEpxret
separation	sEpxreSxn
september	sEptEmbR
sequential	sIkwEnSxl
series	siriz
serious	sIrixs
seriously	sirixsli
serpent	sUrpxnt
serve	sRv
served	sRvd
serves	sRvz
service	sUrvIs
serving	sRvIG
sesame	sEsxmi
session	sESxn
set	sEt
setting	sEtIG
settle	sEtxl
settled	sEtxld
seuss	sus
seuss's	susIz
seven	sEvxn
seventeen	sEvEntin
seventeenth	sEvEntinT
seventh	sEvEnT
seventy	sEvEnti
several	sEvrxl
sew	so
sewed	sod
sewer	suR
sewing	soIG
sewingmachine	soIGmxSin
sewn	son
sews	soz
sex	sEks
sexual	sEkSuxl
sexy	seksi
sgabettios	skxbEtioz
shabby	S@bi
shade	Sed
shades	Sedz
shadow	S@do
shadows	S@doz
shady	Sedi
shaggy	S@gi
shake	Sek
shaked	Sekt
shakes	Seks
shaking	SekIG
shaky	Seki
shall	Sxl
shallots	S@lxts
shallow	S@lo
shame	Sem
shampoo	S@mpu
shape	Sep
shaped	Sept
shapes	Seps
share	SEr
shared	SErd
sharing	SErIG
shark	Sark
sharks	Sarks
sharon	SErxn
sharp	Sarp
shave	Sev
shaving	SevIG
she	Si
she'd	Sid
she'll	Sil
she's	Siz
sheared	SIrd
shedding	SEdIG
sheedy	Sidi
sheep	Sip
sheet	SIt
sheets	SIts
sheila	SIlx
shelby	SElbi
shelf	SElf
shell	SEl
shells	SElz
shena	Sinx
shepherd	SEpRd
sheriff	SErIf
sherri	SERi
sherry	SEri
shes	Siz
shh	S
shield	Sild
shielded	Sildxd
shift	SIft
shifts	SIfts
shimmering	SImRIG
shimmy	SImi
shin	SIn
shine	SYn
shining	SYnIG
shiny	SYni
ship	SIp
ships	SIps
shirt	SRt
shirt's	SRts
shirts	SRts
shiver	SIvR
shock	Sak
shocked	Sakt
shod	Sad
shoe	Su
shoe's	Suz
shoelace	Sules
shoelaces	SulesIz
shoeless	SulEs
shoes	Suz
shoesies	Suziz
shoestring	SustrIG
shoestrings	SustrIGz
shook	SUk
shoot	Sut
shooting	SutIG
shop	Sap
shopper	SapR
shopping	SapIG
short	Scrt
shorter	ScrtR
shortly	Scrtli
shorts	Scrts
shot	Sat
shots	Sats
should	SUd
should've	SUdxv
shoulda	SUdx
shoulder	SoldR
shoulders	SoldRz
shouldn't	SUdxnt
shout	SWt
shouted	SWtxd
shouting	SWtIG
shove	sh^v
shoved	Sovd
shovel	sh^vxl
shoveled	sh^vxl
shoveling	sh^vxlIG
shovels	sh^vxlz
show	So
showed	Sod
shower	SWR
showing	SoIG
shows	Soz
shred	SrEd
shrimp	SrImp
shriveled	SrIvxld
shut	S^t
shutter	S^tR
shutters	S^tRz
shutting	S^tIG
shy	SY
sibling	sIblIG
sick	sIk
sickie	sIki
sid	sId
side	sYd
sides	sYdz
sidewalk	sYdwck
sidewalks	sYdwcks
sideways	sYdwez
sidney	sIdni
sidney's	sIdniz
sieve	siv
sigh	sY
sighed	sYd
sight	sYt
sign	sYn
signal	sIgnxl
signed	sYnd
signs	sYnz
silence	sYlEnts
silent	sYlEnt
silky	sIlki
sill	sIl
sillier	sIliR
silly	sIli
sillywilly	sIliwIli
silver	sIlvR
silverware	sIlvRwEr
simba	sImbx
simmer	sImR
simmered	sImRd
simmering	sImRIG
simmers	sImRz
simple	sImpxl
simply	sImpli
since	sIns
sing	sIG
singing	sIGIG
sings	sIGz
sink	sIGk
sip	sIp
sipped	sIpt
sipper	sIpR
sippie	sIpi
sips	sIps
sir	sR
siree	sRi
siren	sYrxn
sirree	sRri
sissy	sIsi
sister	sIstR
sister's	sIstRz
sisters	sIstRz
sit	sIt
sits	sIts
sitting	sItIG
situation	sICueSxn
six	sIks
sixpence	sIkspEnts
sixteen	sIkstin
sixteenth	sIkstinT
sixty	sIksti
size	sYz
sized	sYzd
skanky	sk@Gki
skateboard	sketbcrd
skateboards	sketbcrdz
skates	skets
skating	sketIG
skelter	skEltR
skies	skYz
skill	skIl
skills	skIlz
skin	skIn
skinnier	skIniR
skinny	skIni
skip	skIp
skipped	skIpt
skips	skIps
skirt	skRt
skirts	skRts
skull	sk^l
skunk	sk^Gk
sky	skY
slam	sl@m
slammed	sl@md
slamming	sl@mIG
slams	sl@mz
slapped	sl@pt
slash	sl@S
slave	slev
sleek	slik
sleep	slip
sleeper	slipR
sleepie	slipi
sleepies	slipiz
sleeping	slipIG
sleeps	slips
sleepy	slipi
sleepyhead	slipihEd
sleet	slit
sleeting	slitIG
sleets	slits
sleeve	sliv
sleeves	slivz
slept	slEpt
slew	slu
slice	slYs
slick	slIk
slid	slId
slide	slYd
slides	slYdz
sliding	slYdIG
slight	slYt
slightest	slYtIst
slime	slYm
slimy	slYmi
slink	slIGk
slinky	slIGki
slip	slIp
slipped	slIpt
slipper	slIpR
slipper's	slIpRz
slippers	slIpRz
slippery	slIpRi
slippies	slIpiz
slipping	slIpIG
slippy	slIpi
slips	slIps
slob	slcb
slobber	slabR
slobbered	slabRd
slobbering	slabRIG
slobbers	slabRz
slobingslobingdobbin	slabIGslabIGd^bxn
slopping	slcpIG
sloppy	slcpi
slosh	slcS
slot	slct
slouch	slWC
slouching	slWCIG
slow	slo
slower	slowR
slowing	slowIG
slowly	sloli
slows	sloz
slug	sl^g
slumber	sl^mbR
slumbers	sl^mbRz
slurping	slRpIG
smack	sm@k
smackerel	sm@kRxl
smackerel@c	sm@kRxl
smacking	sm@kIG
smakerel@c	sm@kRxl
small	smcl
smaller	smclR
smallness	smalnxs
smart	smart
smarter	smartR
smartest	smartEst
smartie	smarti
smarty	smarti
smartypants	smartip@nts
smashing	sm@SIG
smell	smEl
smelled	smEld
smelling	smElIG
smells	smElz
smelly	smEli
smile	smYl
smiled	smYld
smiles	smYlz
smiley	smYli
smiling	smYlIG
smith	smIT
smoke	smok
smoky	smoki
smooth	smuT
smoother	smuTR
smorgasbord	Smcrgxsbcrd
smuch	sm^C
smush	sm^S
smushed	sm^St
smushing	sm^SIG
snack	sn@k
snack's	sn@ks
snackie	sn@ki
snacking	sn@kIG
snacks	sn@ks
snail	snel
snails	snelz
snake	snek
snakes	sneks
snakie	sneki
snap	sn@p
snapped	sn@pt
snappie	sn@pi
snapping	sn@pIG
snaps	sn@ps
snatch	sn@C
snatched	sn@tCt
sneak	snIk
sneakers	snikRz
sneaking	snIkIG
sneaky	snIki
sneeze	sniz
sneezed	snizd
sneezes	snizEs
sneezing	snizIG
sniff	snIf
snip	snIp
snipped	snIpt
snipper	snIpR
snippers	snIpRz
snippy	snIpi
snoops	snups
snooze	snuz
snoring	sncrIG
snort	sncrt
snorting	sncrtIG
snot	snat
snotty	snati
snow	sno
snow's	snoz
snowballs	snobclz
snowblower	snobloR
snowed	snod
snowflakes	snofleks
snowing	snoIG
snowman	snom@n
snowman's	snomxnz
snowmen	snomEn
snows	snoz
snowsuit	snosut
snowy	snowi
snuck	sn^k
snuff	sn^f
snuffy	sn^fi
snug	sn^g
snuggle	sn^gxl
snuggled	sn^gxld
snuggly	sn^gli
so	so
so@si	so
soak	sok
soaked	sokt
soaking	sokIG
soaky	soki
soap	sop
soappies	sopiz
soapy	sopi
soccer	sakR
sock	sak
sockie	saki
sockies	sakiz
socks	saks
socksies	saksiz
soda	sodx
sodas	sodxz
sodium	sodixm
sofa	sofx
soft	scft
softball	scftbcl
softest	scftxst
softly	scftli
software	scftwEr
soggy	sagi
soiled	sOxld
sold	sold
soldier	solJR
soldiers	solJRz
solid	salId
solidified	sxlIdxfYd
solomon	salxmxn
some	sxm
somebody	s^mbadi
somebody's	s^mbadiz
someday	s^mde
somehow	s^mhW
someone	s^mw^n
someone's	s^mw^nz
someplace	s^mples
somersault	s^mRsclt
somersaults	s^mRsclts
something	s^mTIG
something's	s^mTIGz
sometime	s^mtYm
sometimes	s^mtYmz
somewhat	s^mw^t
somewhere	s^mWEr
son	s^n
song	scG
songlike	ScGlYk
songs	scGz
sonic	sanIk
sonny	s^ni
sonogram	sanxgr@m
sons	s^nz
soon	sun
sooner	sunR
sophie	sofi
sophisticated	sxfIstIketId
sopped	sapt
sorcerer	scrCIRR
sore	scr
sorry	scri
sort	scrt
sorted	scrtxd
sorter	scrtR
sorts	scrts
sound	sWnd
sounded	sWndId
sounding	sWndIG
sounds	sWndz
soup	sup
soups	sUps
soupy	sUpi
sour	sWR
source	scrs
south	sWT
space	spes
spaceship	speSIp
spaghetti	spxgEti
spaghettio	spxgEtio
spaghettios	spxgEtioz
span	sp@n
spanish	sp@nIS
spank	sp@Gk
spanked	sp@Gkt
spare	spEr
sparkle	sparkxl
sparkly	sparkli
sparky	sparki
sparrow	spEro
speak	spik
speaker	spikR
speaking	spikIG
speaks	spiks
special	spESxl
specific	spIsIfIk
specks	spEks
specter	spEktR
spectrum	spEktrxm
speed	spid
speeds	spidz
speedy	spidi
spell	spEl
spelling	spElIG
spend	spEnd
spended	spEndxd
spends	spEndz
spent	spEnt
sphere	sfIr
spice	spYs
spices	spYsxz
spider	spYdR
spike	spYk
spill	spIl
spilled	spIld
spilling	spIlIG
spills	spIlz
spin	spIn
spinach	spInIC
spines	spYnz
spinning	spInIG
spins	spInz
spirit	spIrIt
spit	spIt
spits	spIts
spitting	spItIG
splash	spl@S
splashasplashasplasha	spl@Sxspl@Sxspl@Sx
splashed	spl@St
splashie	spl@Si
splashing	spl@SIG
splat	spl@t
splendid	splEndId
splendor	splEdR
splishiesplashie	splISispl@Si
splishsplash	splISspl@S
splishysplashy	splISispl@Si
split	splIt
splitsplacksplash	splItspl@kspl@S
spoil	spOxl
spoiled	spOld
spoke	spok
sponge	sp^nJ
sponges	sp^nJxz
spontaneously	spantenixs
spool	spul
spools	spulz
spoon	spun
spoonful	spunfxl
spoonfuls	spunfxlz
spoons	spunz
sport	spcrt
sports	spcrts
spot	spat
spot's	spats
spots	spats
spotty	spati
spout	spWt
sprat	spr@t
spray	spre
spraying	spreIG
spread	sprEd
spreads	sprEdz
spring	sprIG
springs	sprIGz
springtime	sprIGtYm
sprinkler	srIGkxlR
sprint	sprInt
spruce	sprus
spud	sp^d
spunky	sp^nki
spy	spY
spying	spYIG
square	skwEr
squares	skwErz
squarular	skwEryxlR
squash	skwcS
squashed	skwcSt
squashie	skwcSi
squashies	skwcSiz
squawky	skwcki
squeak	skwik
squeaked	skwikt
squeaker	skwikR
squeaking	skwikIG
squeaks	skwiks
squeaky	skwiki
squeal	skwil
squealed	skwild
squeeze	skwiz
squeezed	skwizd
squeezes	skwizxz
squeezing	skwizIG
squid	skwId
squinting	skwIntIG
squirm	skwRm
squirming	skwRmIG
squirmy	skwRmi
squirrel	skwRxl
squirrellie	skwRxli
squirrellies	skwRxliz
squirrels	skwRxlz
squirt	skwRt
squirted	skwRtxd
squirting	skwRtIG
squish	skwIS
squished	skwISt
squishing	skwISIG
squishy	skwISi
ssh	S
stable	stebxl
stack	st@k
stacked	st@kt
stacking	st@kIG
stacks	st@ks
stage	steJ
stages	steJIz
stain	sten
stair	stErz
stairs	stErz
stale	stel
stale	stel
stalking	stckIG
stall	stcl
stamp	st@mp
stance	st@nts
stand	st@nd
standing	st@ndIG
standpoint	st@ndpOnt
stands	st@ndz
staples	stepxlz
star	star
starch	starC
stare	stEr
starfish	starfIS
staring	stErIG
stars	starz
start	start
started	startId
starting	startIG
startle	startxl
startled	startxld
starts	starts
starve	starv
starved	starvd
starves	starvz
starving	starvIG
stash	st@S
static	st@tIk
staticing@n	st@tIkIG
staticky	st@tIki
staticling@n	st@tIkklIG
station	steSxn
statue	st@Cu
stay	ste
stayed	sted
staying	steIG
stays	stez
steadfast	stEdf@st
steadier	stEdiR
steady	stEdi
steak	stek
steak's	steks
steal	stil
stealing	stilIG
steals	stilz
steam	stim
steamed	stImd
steep	stIp
steer	stIr
steering	stIrIG
stegosaurus	stEgxscrxs
stem	stEm
step	stEp
stephanie	stEfxni
stepped	stEpt
stepping	stEpIG
steps	stEps
stereo	stErio
stereos	stErioz
steve	stiv
steven	stivxn
stew	stu
stick	stIk
sticker	stIkR
stickers	stIkRz
stickie	stIki
stickies	stIkiz
sticking	stIkIG
stickle	stIkxl
stickleback	stIkxlb@k
sticks	stIks
sticky	stIki
stikle	stIkxl
stile	stYxl
still	stIl
stimulated	stImyuletxd
sting	stIG
stingy	stInJi
stink	stIGk
stinkaroosies	stIGkxruziz
stinker	stIGkR
stinkier	stIGkiR
stinkies	stIGkiz
stinkiest	stIGkixst
stinking	stIGkIG
stinkpot	stIGkpat
stinks	stIGks
stinky	stIGki
stir	stR
stirring	stRIG
stitches	stICxz
stock	stak
stocking	stckIG
stole	stol
stomach	st^mxk
stomachache	st^mxkek
stomp	stamp
stomped	stampt
stomping	stampIG
stoneham	stonxm
stones	stonz
stood	stUd
stool	stul
stop	stap
stopped	stapt
stopper	stapR
stopping	stapIG
stops	staps
store	stcr
stores	stcrz
stories	stcriz
storm	stcrm
stormy	starmi
story	stcri
storybook	staribUk
stout	stWt
stove	stov
straight	stret
straighten	stretxn
straightened	stretxnd
straightens	stretxnz
straining	strenIG
strange	strenJ
stranger	strenJR
strap	str@p
strapped	str@pt
straps	str@ps
straw	strc
strawberries	strcbEriz
strawberry	strcbEri
streaks	strIks
stream	strIm
street	strit
streetlight	stritlYt
streetlights	stritlYts
streets	strits
strength	strEGT
strengthening	strEGTxnIG
stress	strEs
stressed	strEst
stretch	strEC
stretches	strECxz
stretching	strECIG
strike	strYk
string	strIG
stringing	strIGIG
strings	strIGz
strip	strIp
stripe	strYp
striped	strYpt
stroke	strok
stroll	strol
stroller	strolR
strong	stcG
stronger	strcGR
struck	str^k
structure	str^kCR
struggle	str^gxl
struggled	str^gxld
strum	str^m
stubborn	st^bRn
stuck	st^k
studies	st^diz
studio	studio
study	st^di
studying	st^diIG
stuff	st^f
stuffed	st^ft
stuffy	st^fi
stung	st^G
stupid	stupId
sturdy	stRdi
stutter	st^tR
style	stYl
styling	stYlIG
stylish	stYlIS
styrofoam	stYrxfom
sub	s^b
subject	s^bJIkt
substitute	s^bstItut
substituted	s^bstItutId
succeed	s^ksid
successful	sxksEsfxl
successfully	s^ksEsfxli
such	s^C
suchi	suCi
suck	s^k
sucked	s^kt
sucker	s^kR
sucking	s^kIG
sucks	s^ks
suction	s^kSxn
sudden	s^dxn
suddenly	s^dxnli
suds	s^dz
sudsies	s^dsiz
sudsy	s^dsi
sue	su
sued	sud
sues	suz
sugar	SUgR
sugarpie	SUgRpY
suggest	sxJEst
suggestion	sxgJEsCxn
suing	suIG
suit	sut
suitcase	sutkes
suits	suts
sultan	s^ltxn
sultan's	s^ltxnz
sultans	s^ltxnz
sultans's	s^ltxnzxz
summer	s^mR
summer's	s^mRz
summers	s^mRz
summertime	s^mRtYm
summoned	s^mxnd
sumpin	s^mpIn
sun	s^n
sun's	s^nz
sunblock	s^nblck
sunburn	s^nbRn
sunday	s^nde
sunflower	s^nflWR
sunflowers	s^nflWRz
sunglasses	s^ngl@sIz
sunny	s^ni
sunscreen	s^nskrin
sunscreens	s^nskrInz
sunshine	s^nSYn
suntan	s^nt@n
super	supR
superman	supRm@n
supper	s^pR
supper's	s^pRz
supplement	s^plxmxnt
supplies	s^plYz
supply	sxplY
suppose	s^poz
supposed	sxpozd
sure	SR
surely	sRli
surface	sRfIs
surprise	sRprYz
surprised	sRprYzd
surprising	sRprYzIG
surrounded	sRWndxd
survey	sRve
survive	sRvYv
survivor	sRvYvR
susan	suzxn
susie	suzi
suspender	s^spEndR
suspenders	sxspEndR
suspicious	s^spISxs
susy	suzi
suzie	suzi
suzy	suzi
swallow	swalo
swallowed	swalod
swallowing	swalowIG
swallows	swaloz
swam	sw@m
swan	swan
swans	swanz
swear	swEr
swearie	swEri
sweat	swEt
sweater	swEtR
sweaters	swEtRz
sweatpants	swEtp@nts
sweatshirt	swEtSRt
sweatshirts	swEtSRts
sweatsuit	swEtsut
sweaty	swEti
sweep	swip
sweeped	swipt
sweepie	swipi
sweeping	swipIG
sweeps	swips
sweet	swit
sweeta	switx
sweeterpeters	switRpitRz
sweeters	switRz
sweeterspeters	switRzpitRz
sweetest	switxst
sweetheart	swithart
sweetie	switi
sweetiepie	switipY
sweetiepies	switipYz
sweeties	switiz
sweetiest	switiEst
sweetpea	switpi
sweets	swits
sweetsies	switsiz
sweetum	swit^m
sweetums	swit^mz
swell	swEl
swell	swEl
swelling	swElIG
swelling	swElIG
swept	swEpt
swim	swIm
swimmer	swImR
swimming	swImIG
swimmingpool	swImIGpul
swims	swImz
swimsuit	swImsUt
swing	swIG
swingie	swIGgi
swinging	swIGIG
swings	swIGz
swish	swIS
switch	swIC
switched	swICt
swollen	swolxn
swoosh	swUS
sydney's	sIdniz
sylvester	sIlvEstR
symbiotic	sImbiatIk
symphony	sImfxni
syndrome	sIndrcm
synthesized	sInTxsYzd
syrup	sIr^p
system	sIstxm
t	ti
t@l	ti
ta	ta
tab	t@b
tabitha	t@bITx
tabitha's	t@bITxz
table	tebxl
tablecloth	tebxlklaT
tablespoon	tebxlspun
tabs	t@bz
tad	t@d
tadah	txda
tag	t@g
tags	t@gz
tail	tel
tail's	tela
tails	telz
take	tek
taken	tekxn
takes	teks
taking	tekIG
talk	tck
talkative	tckxtIv
talked	tckt
talker	tckR
talking	tckIG
talks	tcks
tall	tcl
taller	tcxlR
tallest	tclEst
tambourine	t@mbRin
tan	t@n
tangerine	t@nJRin
tangerines	t@nJRinz
tangled	t@Ggxld
tangling	t@GglIG
tanish	t@nIS
tank	t@Gk
tantrum	t@ntr^m
tantrums	t@ntr^mz
tap	t@p
tape	tep
taped	tept
tapemeasure	tepmEsUr
taperecorded	teprECcrdEd
taperecording	teprECcrdIG
tapes	teps
taping	tepIG
tapioca	t@piokx
tapped	t@pt
tapping	t@pIG
taps	t@ps
tar	tar
target	targxt
tart	t@t
tarts	tcrts
tarzan	tarzxn
tasmanian	t@zmenixn
taste	test
tasted	testxd
tastes	tests
tasting	testIn
tasty	testi
tata	t@t@
tata's	t@t@z
tata@q	tctc
taters	tetRz
tattoos	t@tuz
taught	tct
taxi	t@ksi
taxis	t@ksiz
taz	t@z
tea	ti
teach	tiC
teacher	tiCR
teacher's	tICRz
teaching	tiCIG
team	tim
teapot	tipat
tear	tIr
tearing	tErIG
tears	tIrz
teas	tiz
teasing	tizIG
teaspoon	tispun
teaspoonfuls	tispunfxlz
technical	tEknIkxl
technically	tEknIkli
teddies	tEdiz
teddy	tEdi
tee	ti
teefers	tifRz
teenager	tineJR
teenie	tini
teensie	tinsi
teeny	tini
teenyweeny	tiniwini
teepy	tipi
teeth	tiT
teether	tiTR
teethers	tiTRz
teethie	tiTi
teethies	tiTiz
teething	tiTIG
telemarketing	tElxmarkEtIG
telephone	tElxfon
telephone's	tElxfonz
telephones	tElxfonz
teletubbies	tElxt^biz
teletubby	tElxt^bi
television	tElxvIZxn
televisions	tElxvIZxnz
tell	tEl
telling	tElIG
tells	tElz
telly	tEli
temper	tEmpR
temperature	tEmprxCUr
tempt	tEmpt
ten	tEn
tend	tEnd
tender	tEndR
tenderness	tEndRnxs
tending	tEndIG
tennis	tEnIs
tense	tEnts
tent	tEnt
tenth	tEnT
tents	tEnts
term	tRm
terms	tRmz
terri	tEri
terri's	tEriz
terrible	tErxbxl
terribly	tErxbli
terrific	txrIfIk
terrorizing	tErRYzIG
terry	tEri
terry's	tEriz
test	tEst
tested	tEstId
testing	tEstIG
than	D@n
thank	T@Gk
thanked	T@Gkt
thanking	T@GkIG
thanks	T@Gks
thankyou	T@Gkyu
that	D@t
that'd	D@txd
that'll	D@txl
that's	D@ts
thaw	Tc
the	Dx
thee	Di
theif	TIf
their	DEr
theirs	DErz
them	DEm
them's	DEmz
themselves	DEmsElvz
then	DEn
theodore	Tixdcr
there	DEr
there'll	DErxl
there's	DErz
therefore	DErfcr
theresa	txrisx
thermometer	TRmamxtR
these	Diz
they	De
they'd	Ded
they'll	Del
they're	DEr
they've	Dev
thick	TIk
thicker	TIkR
thigh	TY
thighs	TYz
thin	TIn
thing	TIG
thing's	TIGz
thingamajigger	TIGxmxJIgR
thingie	TIGi
thingies	TIGiz
things	TIGz
think	TIGk
thinking	TIGkIG
thinks	TIGks
third	TRd
thirst	TRst
thirsty	TRsti
thirteen	TRtin
thirty	TRrti
this	DIs
thistle	TIsxl
thorn	Tcrn
thornbushes	TcrnbUSxz
thorns	Tcrnz
thorny	Tcrni
those	Doz
though	Do
thought	Tct
thoughtful	Tctfxl
thousand	TWzxnd
thrash	Tr@S
thrasher	Tr@SR
thread	TrEd
three	Tri
threes	Triz
threw	Tru
throat	Trot
throats	Trots
through	Tru
throughout	TruWt
throw	Tro
throwing	TroIG
thrown	Tron
throws	Troz
thumb	T^m
thumbprints	T^mprInts
thumbs	T^mz
thumbtacks	T^mt@ks
thumper	T^mpR
thunder	T^ndR
thundered	T^ndRd
thursday	TRzde
thy	DY
ti@si	ti
tic	tIk
tick	tIk
ticket	tIkIt
tickets	tIkIts
tickie	tIki
tickle	tIkxl
tickled	tIkxld
tickler	tIkxlR
tickles	tIkxlz
tickletickle	tIkxltIkxl
ticklie	tIkli
tickling	tIkxlIG
ticklish	tIklIS
tickly	tIkli
ticks	tIks
tictactoe	tIkt@kto
tiddywinkle	tIdiwIGkxl
tide	tYd
tie	tY
tied	tYd
ties	tYz
tiger	tYgR
tigers	tYgRz
tigger	tIgR
tiggers	tIgRz
tiggywinkle	tIgiwIGkxl
tight	tYt
tighter	tYtR
tightly	tYtli
tights	tYts
tile	tYxl
tilt	tIlt
tilted	tIltxd
tim	tIm
timber	tImbR
timberland	tImbRl@nd
timbers	tImbRz
time	tYm
timer	tYmR
times	tYmz
timing	tYmIG
timmer	tImR
timmonium	tImoni^m
timmy	tImi
timmy's	tImiz
timone	tImon
timothy	tImxTi
tims	tImz
tin	tIn
tiniest	tYniEst
tinkerbell	tIGkRbEl
tinkle	tIGKxl
tinky	tIGki
tinkywink	tIGkiwIGk
tinkywinky	tIGkiwIGki
tiny	tYni
tip	tIp
tipietoe	tIpito
tipietoes	tIpitoz
tipped	tIpt
tippietoe	tIpito
tippietoes	tIpitoz
tipping	tIpIG
tippy	tipi
tippy's	tipiz
tips	tIps
tiptoe	tIpto
tiptoed	tIptod
tiptoes	tIptoz
tire	tYR
tired	tYRd
tires	tYRz
tiring	tYRIG
tissue	tISu
tissues	tISuz
to	tu
toandfro	tu@ndfro
toast	tost
toasted	tostxd
toaster	tostR
toastest	tostEst
toasty	tosti
tock	tck
today	txde
today's	txdez
toddler	tcdlR
toe	to
toe's	toz
toenail	tonel
toenails	tonelz
toes	toz
toesie	tozi
toesies	toziz
tofu	tofu
together	txgEDR
toilet	tOlxt
tokyo	tokio
told	told
tom	tam
tom's	tamz
tomato	txmeto
tomatos	txmetoz
tomboy	tcmbO
tomcat	tcmk@t
tommy	tami
tomorrow	txmaro
tomorrow's	txmaro
ton	t^n
tonga	taGgx
tongue	t^G
tongue's	t^Gz
tonight	txnYt
tonka	taGkx
tonka's	taGkxz
tons	t^nz
tonya	tanyx
too	tu
took	tUk
tool	tul
toolbox	tulbaks
tools	tulz
toolshed	tulshEd
toot	tut
tootaloo	tutxlu
tooth	tuT
toothbrush	tuTbr^S
toothbrushes	tuTbr^Sxz
toothie	tuTi
toothies	tuTiz
toothless	tuTlxs
tooting	tutIG
tootleloo	tutxlu
toots	tuts
tootsie	tUtsi
tootsies	tUtsiz
top	tap
topic	tapIk
toppings	tapIGz
tops	taps
tore	tcr
torn	tcrn
tortoise	tcrtxs
torturing	tcrCUrIG
toss	tas
tossed	tast
tosses	tasxz
totally	totxli
totem	totxm
toucan	tuk@n
touch	t^C
touchdowns	t^CdWnz
touched	t^Ct
touches	t^Cxz
touchie	t^Ci
touching	t^CIG
touchy	t^Ci
tough	t^f
toughie	t^fi
tow	to
toward	txward
towards	tcrdz
towel	tWl
towels	tWlz
tower	tWR
towers	tWRz
town	tWn
toy	tO
toy'll	tOxl
toybox	tObaks
toys	tOz
track	tr@k
tracks	tr@ks
tractor	tr@ktR
trade	tred
traditional	trxdISxnxl
traffic	tr@fIk
trailed	trexld
trails	trexlz
train	tren
trained	trend
training	trenIG
trains	trenz
translate	tr@nslet
trapeze	trxpiz
trapped	tr@pt
trash	tr^S
trashed	tr^St
trashes	tr^Sxz
trashing	tr^SIG
traumatizing	trcmxtYzIG
traveler	tr@vxlR
traveling	tr@vxlIG
travels	tr@vxlz
tray	tre
treat	trit
treatment	tritmxnt
treats	trits
tree	tri
trees	triz
treetop	tritap
triangle	trYeGgxl
triangles	trY@Ggxlz
triangular	trY@ngyxlR
trick	trIk
tricked	trIkt
tricks	trIks
tricky	trIki
tricycle	trYsIkxl
tried	trYd
tries	trYz
trike	trYk
trim	trIm
trip	trIp
triple	trIpxl
tripled	trIpxld
tripod	trYpad
tripped	trIpt
tripping	trIpIG
trombone	trambon
troop	trup
trouble	tr^bxl
trough	trcf
trousers	trWsRz
trout	trWt
truck	tr^k
truckie	tr^ki
trucks	tr^ks
true	tru
truly	truli
trunk	tr^Gk
trunks	tr^Gks
trust	tr^st
truth	truT
truthfully	truTfxli
try	trY
trying	trYIG
trys	trYz
tub	t^b
tubbie	t^bi
tube	tub
tubes	tubz
tubing	tubIG
tuck	t^k
tucked	t^kt
tucker	t^kR
tuesday	tuzde
tuffet	t^fxt
tug	t^g
tugged	t^gd
tugging	t^gIG
tulip	tulIp
tulips	tulIps
tumble	t^mbxl
tumbled	t^mbxld
tumbles	t^mbxlz
tumbling	t^mbxlIG
tummies	t^miz
tummy	t^mi
tumtum	t^mt^m
tuna	tunx
tune	tun
tunes	tunz
tunnel	t^nxl
tupperware	t^pRwEr
turkey	tRki
turkey's	tRkiz
turkeys	tRkiz
turkies	tRkiz
turn	tRn
turnaround	tRnxrWnd
turned	tRnd
turning	tRnIG
turns	tRnz
turtle	tRtxl
turtle's	tRtxlz
turtleneck	tRtxlnEk
turtles	tRtxlz
tush	tUS
tutti	tuti
tuttletuttle	t^txlt^txl
tutu	tutu
tuv@k	tiyuvi
tv	tivi
tweaks	twiks
tweedle	twidxl
tweedlebug	twidxlb^g
tweedledee	twidxldi
tweedledum	twidxld^m
tweet	twit
tweetie	twiti
tweetie's	twitiz
tweety	twiti
twelfth	twElf
twelve	twElv
twenty	twEnti
twice	twYs
twiddle	twIdxl
twiddlebug	twIdxlb^g
twinkle	twIGkxl
twirl	twRl
twirly	twRli
twist	twIst
twister	twIstR
twisting	twIstIG
twisty	twIsti
two	tu
twos	tuz
twy	twY
twying	twYIG
ty	tY
tyco	tYko
tying	tYIG
tylenol	tYlEnal
type	tYp
typing	tYpIG
tyrese	tYris
u	yu
u@l	yu
ubb's	^bz
ugh	^g
uglier	^gliR
ugliest	^gliEst
ugly	^gli
uh	^
uhhuh	^h^
uhhum	xmhxm
uhoh	^o
uhuh	^^
ukelele	yukxleli
ulterior	^ltIriR
um	^m
umbrella	^mbrElx
unbearable	^nbErxbxl
unbreakable	^nbrekxbxl
unbuckle	^nb^kxl
unbuckled	^nb^kxld
unbutton	^nb^txn
uncheerful	^nCIrfxl
uncle	^Gkxl
uncles	^nkxlz
uncomfortable	^nk^mftRbxl
unconsciously	^nkanSxsli
uncover	^nk^vR
uncovering	^nk^vRIG
uncurl	^nkRl
under	^ndR
underarm	^ndRarm
underarms	^ndRarmz
underneath	^ndRniT
underpants	^ndRp@nts
undershirt	^ndRSRt
understand	^ndRst@nd
understandable	^ndRst@ndEbxl
understanding	^ndRst@ndIG
understands	^ndRst@ndz
understood	^ndRstUd
underwear	^ndRwEr
underwears	^ndRwErz
undies	^ndiz
undo	^ndu
undone	^nd^n
undress	^ndrEs
undressed	^ndrEst
undressing	^ndrEsIG
unfair	^nfEr
unfold	^nfold
unfortunate	^nfcrtxnxt
unfortunately	^nfcrtxnxtli
unfree	^nfri
unhappy	^nh@pi
unhook	^nhUk
unicorn	yunIkcrn
unicycle	yunICYkxl
unidentifiable	^nYdEntxfYxbxl
uniform	yunxfcrm
uniforms	yunxfcrmz
unique	yunik
unit	yunIt
universal	yunIvRsxl
universe	yunIvRs
unless	^nlEs
unlimited	^nlImItxd
unload	^nlod
unlock	^nlak
unlocked	^nlakt
unorganized	^ncrgxnYzd
unpacking	^np@kIG
unpause	^npcz
unpleasant	^nplEsxnt
unplug	^npl^g
unplugged	^npl^gd
unplugging	^npl^gIG
unplugs	^npl^gz
unravels	^nr@vxlz
unruly	^nruli
unscrew	^nskru
unsnap	^nsn@p
unsnapped	^nsn@pt
unstrap	^nstr@p
untape	^ntep
untie	^ntY
untied	^ntYd
unties	^ntYz
until	^ntIl
untying	^ntYIG
unused	^nyuzd
unusual	^nyuZuxl
unzip	^nzIp
unzipped	^nzIpt
unzipperoni	^nzIpRoni
unzipping	^nzipIG
up	^p
uphill	^phIl
upieday	^pide
upon	^pxn
upper	^pR
uppie	^pi
ups	^ps
ups@c	^ps
upsa	^psx
upsadaisy	^psxdezi
upset	^psEt
upside	^psYd
upsidedown	^psYdWn
upsie	^psi
upstairs	^pstErz
upstream	^pstrim
uptown	^ptWn
urchins	RCInz
urge	RJ
us	^s
use	yuz
used	yuzd
useful	yusfxl
useless	yuslxs
uses	yuzIz
using	yuzIG
usual	yuZuxl
usually	yuZwxli
utensil	yutEnsxl
utensils	yutEnsIlz
utmost	^tmost
v	vi
v's	vIz
v@l	vi
vacation	vekeSxn
vacuum	v@kyum
vacuumed	v@kyumd
vacuums	v@kyumz
valentine	v@lxntYn
valentine's	v@lEntYnz
valentines	v@lEntYnz
vampire	v@mpYR
van	v@n
van's	v@nz
vandross	v@ndrcs
vane	ven
vanilla	vxnIlx
vans	v@nz
variable	vErixbxl
variety	vxrYxti
vas	v^z
vaseline	v@sxlin
vasie	vezi
vat	v@t
vegetable	vEJtxbxl
vegetables	vEJtxbxlz
veggie	vEJi
vehicle	viIkxl
veils	velz
velcro	vElkro
velcroed	velkrod
velveteen	velvxtin
vent	vEnt
vera	vErx
verbalize	vRbxlYz
vern	vRn
versatile	vRsxtYl
verse	vRs
version	vRZxn
versus	vRsxs
very	vEri
vests	vEsts
victoria	viktcrix
video	vIdio
videos	vIdioz
view	vyu
viewpoint	vyupOnt
vigorously	vIgRxs
vin	vIn
vine	vYn
vinegar	vInxgR
vines	vYnz
vinnie	vIni
vintage	vIntIJ
violence	vYxlxnts
violent	vYxlxnt
violet	vYxlxt
violin	vYxlIn
viper	vYpR
virginia	vRJInyx
virtually	vRCuxli
visit	vIzIt
visited	vIzItxd
visiting	vIzItIG
visits	vIzIts
visual	vIzuxl
vitamin	vYt@mIn
vitamins	vYt@mInz
vividly	vIvIdli
vocal	vokxl
voice	vOs
voices	vOsIz
volcano	valCeno
vole	vol
volleyball	valibcl
volunteer	valxntIr
vroom	vrum
w	d^bxlyu
w@l	d^bxlyu
wackwackwack@o	w@kw@kw@k
wacky	w@ki
wafer	wefR
wafers	wefRz
waffle	wcfxl
waffles	wcflz
wag	w@g
wagon	wegxn
wahwahwah	w@w@w@
wahwahwah@si	w@w@w@
wait	wet
waited	wetxd
waiting	wetIG
wake	wek
wakes	weks
waking	wekIG
waldo	waldo
walk	wck
walkandtalk	wck@ndtck
walked	wckt
walker	wckR
walkie	wcki
walkietalkie	wckitcki
walkietalkies	wckitckiz
walking	wckIG
walks	wcks
wall	wcl
wallet	walxt
wallpaper	wclpepR
walls	wclz
walt	wclt
walters	waltRz
walters's	waltRzxz
wand	wand
wandered	wandRd
wandering	wandRIG
wanna	wanx
want	want
want's	wants
wanted	wantId
wanting	wantIG
wants	wants
war	wcr
warm	wcrm
warmed	wcrmd
warmer	wcrmR
warming	wcrmIG
warn	wcrn
warning	wcrnIG
warren	wcrxn
warrior	wcriR
was	w^z
wash	waS
washcloth	waSklcT
washcloths	waSklcTs
washed	waSt
washer	waSR
washes	waSIz
washie	waSi
washing	waSIG
washrag	waSr@g
wasn't	w^zxnt
wasp	wasp
wasps	wasps
waste	west
wasted	westxd
wasting	westIG
watch	waC
watched	waCt
watches	waCIz
watching	waCIG
water	wctR
water's	watRz
waterfall	watRfal
watering	watRIG
waterloo	watRlu
watermelon	watRmElxn
watermelons	watRmElxnz
watery	watRi
wave	wev
waved	wevd
waves	wevz
waving	wevIG
wawa	wawa
wax	w@ks
way	we
way's	wez
ways	wez
we	wi
we'd	wid
we'll	wil
we're	wIr
we've	wiv
weak	wik
wear	wEr
wearable	wErxbxl
wearing	wErIG
wears	wErz
weasel	wizxl
weasels	wizxlz
weather	wEDR
weaving	wivIG
web	wEb
webs	wEbz
wednesday	wEnzde
wee	wi
weebles	wibxlz
weed	wid
weeds	widz
week	wik
weekend	wikEnd
weeks	wiks
weens	winz
weensie	winsi
weepee	wipi
weepie	wipi
weepy	wipi
weeta	witx
weewee	wiwi
weewees	wiwiz
weeweeweeweewee	wiwiwiwi
weigh	we
weight	wet
weird	wIrd
weirdest	wRdEst
weirdo	wRdo
welcome	wElkxm
well	wEl
went	wEnt
were	wR
weren't	wRnt
wet	wEt
wetter	wEtR
wh	W
whack	W@k
whaddya	w^dyx
whale	Wel
whales	wExlz
wham	w@m
what	W^t
what'd	W^txd
what's	W^ts
whatcha	W^tCx
whatchamacallit	w^tCxmxkclIt
whatever	W^tEvR
wheat	Wit
wheaties	witiz
whee	wi
wheel	wixl
wheelbarrow	WilbEro
wheeling	wixlIG
wheels	Wilz
when	WEn
when's	wEnz
whence	WEns
whenever	WEnEvR
where	wEr
where	WEr
where'd	WErd
where're	WErR
where's	WErz
whereas	WEr@z
whereupon	WErxpan
wherever	WErEvR
whether	WEDR
whew	Wu
whey	we
which	WIC
while	WYl
whine	WYn
whined	WYnd
whines	WYnz
whiney	wYni
whineyness	wYninEs
whining	WYnIG
whip	WIp
whipped	WIpt
whipping	WIpIG
whips	WIps
whirled	wRld
whirlwind	wRlwInd
whisker	wIskR
whiskers	WIskRz
whisper	wIspR
whispered	wIspRd
whispering	wIspRIG
whistle	wIsxl
white	WYt
whitney	wItni
who	hu
who's	huz
whoa	wox
whoever	huEvR
whole	hol
whom	hum
whoop	wup
whoopee	wUpi
whoopie	wUpi
whoops	wUps
whoopsadaisy	wUpsxdezi
whoopsie	wUpsi
whoopsiedoozies	wUpsiduziz
whoopsiedoozy	wUpsiduzi
whoosh	wUS
whose	huz
whoville	huvIl
why	WY
why's	wYz
whys	wYz
wick	wIk
wicked	wIkId
wide	wYd
wider	wYdR
width	wIdT
wife	wYf
wig	wIg
wiggins	wIgInz
wiggle	wIgxl
wiggles	wIgxlz
wiggly	wIgli
wild	wYld
wildly	wYldli
wiled	wIld
will	wIl
william	wIly^m
willie	wIli
willing	wIlIG
willow	wIlo
willy	wIli
wilted	wIltxd
wily	wYli
win	wIn
wind	wInd
wind's	wIndz
windbreaker	wIndbrekR
winder	wIndR
window	wIndo
window's	wIndoz
windows	wIndoz
windowsill	wIndosil
winds	wIndz
windshield	wInSild
windshield's	wInSildz
windshields	wInSildz
windy	wIndi
wing	wIG
wings	wIGz
wink	wIGk
winkie	wIGki
winkle	wIGkxl
winky	wIGki
winnie	wIni
winter	wIntR
wipe	wYp
wiped	wYpt
wipeout	wYpWt
wiper	wYpR
wipers	wYpRz
wipes	wYps
wipie	wYpi
wipies	wYpiz
wiping	wYpIG
wire	wYr
wires	wYrz
wish	wIS
wishbone	wISbon
wished	wISt
wishes	wISxz
witch	WIC
with	wIT
within	wITIn
without	wITWt
wittle	wItxl
wittles	wItxlz
wobbly	wabli
wocket@n	wakxt
woe	wo
woke	wok
wolf	wUlf
wolfie	wUlfi
woman	wUmxn
womb	wum
women	wImxn
won	w^n
won't	wont
wonder	w^ndR
wondered	w^ndRd
wonderful	w^ndRfxl
wonderfully	w^ndRfli
wondering	w^ndRIG
wonders	w^ndRz
woo	wu
wood	wUd
wooden	wUdxn
woods	wUdz
woody	wUdi
woof	wUd
woofwoof	wUfwUf
wool	wUl
woolly	wUli
wooly	wUli
woowoo	wuwu
word	wRd
words	wRdz
wore	wcr
work	wRk
worked	wRkt
workie	wRki
working	wRkIG
workout	wRkWt
workplace	wRkples
workroom	wRkrum
works	wRks
world	wRld
world's	wRldz
worm	wRm
worms	wRmz
worn	wcrn
worried	wRid
worries	wRiz
worry	wRi
worse	wRs
worship	wRSIp
worst	wRst
worth	wRT
wosuits	wosut
would	wUd
would've	wUdxv
wouldn't	wUdxnt
wound	wund
wow	wW
wrap	r@p
wrapped	r@pt
wrapper	r@pR
wrapping	r@pIG
wrappings	r@pIGz
wreath	rIT
wreck	rEk
wrecker	rEkR
wrecking	rEkIG
wrestle	rEsxl
wrestled	rEsxld
wrestles	rEsxlz
wrestling	rEsxlIG
wriggly	rIgxli
wrinkled	rIGkxld
wrinkles	rIGkxlz
wrinkly	rIGkli
wrist	rIst
write	rYt
writes	rYts
writing	rYtIG
writings	rYtIGz
written	rItxn
wrong	rcG
wrote	rot
wuss	wUs
wuzzy	w^zi
x	Eks
x@l	Eks
x@l-s	Eks
xavier	EkseviR
xavier's	EkseviRz
xylophone	zYlxfon
y	wY
y@l	wY
ya	yx
yahtzee	yatzi
yak	y@k
yaks	y@ks
yall	ycl
yam	y@m
yams	y@mz
yank	y@Gk
yanked	y@Gkt
yankee	y@Gki
yanking	y@GkIG
yanks	y@Gks
yard	yard
yarn	yarn
yawn	ycn
yawned	ycnd
yawning	ycnIG
yay	yey
yaya	yaya
yaya's	yayaz
yayayaya	yayaya
ye	yx
yea	y@
yeah	y@
year	yIr
yearling	yIrlIG
years	yIrz
yeast	yist
yeh	yE
yell	yEl
yelled	yEld
yelling	yElIG
yellow	yElo
yells	yElz
yep	yEp
yeps	yeps
yes	yEs
yessiriebobs	yEsRibabz
yesterday	yEstRde
yet	yEt
yicky	yIki
yikes	yYks
yipped	yIpt
yoda	yodx
yogurt	yogRt
yogurt's	yogRts
yolanda	yolandx
yolk	yok
yomiko	yomiko
yonder	yandR
yorgensen	ycrgxnsxn
york	ycrk
you	yu
you'd	yud
you'll	yul
you're	yUr
you've	yuv
young	y^G
younger	y^GgR
your	ycr
your	yUr
yours	yUrz
yourself	yUrsElf
yous	yuz
youth	yuT
yoyo	yoyo
yuck	y^k
yucka	y^kx
yucketyyuck	y^kEtiy^k
yuckies	y^kiz
yucks	y^ks
yucky	y^ki
yukon	yukan
yuli	yuli
yuli's	yuliz
yulibaba	yulibabx
yulibabaf	yulibabxf
yulibob	yulibab
yulibobs	yulibabz
yum	y^m
yumbum	y^mb^m
yummies	y^miz
yummy	y^mi
yumsie	y^mzi
yumyum	y^my^m
yumyums	y^my^mz
yup	y^p
z@l	zi
zach	z@k
zachary	z@kRi
zaps	z@ps
zealand	zilxnd
zebra	zibrx
zebras	zibrxz
zenga	zEGgx
zero	zIro
zeus	zus
ziggy's	zIgiz
zigzag	zIgz@g
zigzagging	zIgz@gIG
zinnias	zInixz
zip	zIp
ziploc	zIplak
zipped	zIpt
zipper	zIpR
zipper's	zIpRz
zippered	zIpRd
zippers	zIpRz
zipping	zIpIG
zips	zIps
zipzapzuds	zIpz^dz
zizzerzazzerzoo	zIzRz@zRzu
zizzerzazzerzuzz	zIzRz@zRz^z
zone	zon
zoo	zu
zookeeper	zukipR
zookeeper's	zukipRz
zoological	zoxlaJIkxl
zoom	zum
zooming	zumIG
zoomzoom	zumzum
zoos	zuz
zum@o	zum
