a	e
a@l	e
aah	a
abc	e/bi/si
abc@l	e/bi/si
abcd@l	e/bi/si/di
abcdefg@k	e/bi/si/di/i/Ef/Ji
abcs	e/bi/siz
abigail	@/bI/gel
able	e/bxl
about	x/bWt
above	x/b^v
absolute	@b/sx/lut
absolutely	@b/sx/lut/li
absorbent	xb/zcr/bInt
abu	a/bu
abuse	x/byus
abuses	x/byu/sIz
accept	Ek/sEpt
acceptable	Ek/sEp/tx/bxl
accepted	Ek/sEp/tId
accident	@k/sI/dInt
accidentally	@k/sI/dEn/tx/li
accidently	@k/sI/dEnt/li
accidents	@k/sx/dEnts
accordion	x/kcr/di/In
account	x/kWnt
accused	x/kyuzd
accustomed	x/k^/stxmd
achieve	x/Civ
achieved	x/Civd
achieves	x/Civz
achieving	x/Ci/vIG
achoo	x/Cu
acknowledge	@k/na/lIJ
acknowledged	@k/na/lIJd
acquiesced	@/kwI/Est
acre	e/kR
across	x/krcs
act	@kt
acting	@k/tIG
action	@k/SIn
activator	@k/tI/ve/tR
active	@k/tIv
activities	@k/tI/vI/tiz
activity	@k/tI/vI/ti
actor	@k/tR
actorfactormactor	@k/tR/f@k/tR/m@k/tR
acts	@kts
actual	@k/Cu/xl
actually	@k/Cu/x/li
ad	@d
adam	@/dxm
adam's	@/dxmz
add	@d
added	@/dId
addicted	x/dIk/tId
adding	@/dIG
adds	@dz
adjustable	x/J^/stx/bxl
adjustment	x/J^s/tmInt
adjustments	x/J^st/mxnts
adorable	x/do/rx/bxl
adore	x/dor
adult	x/d^lt
adults	x/d^lts
advanced	@d/v@nst
adventure	@d/vEn/CR
advice	@d/vYs
advises	@d/vY/zIz
afford	x/ford
afraid	x/fred
africa	@/frI/kx
african	@/frI/kxn
after	@f/tR
afternoon	@f/tR/nun
afterwards	@f/tR/wRdz
again	x/gEn
against	x/gEnst
age	eJ
aggie	@/gi
aggravated	@/grx/ve/tId
aggravating	@/grx/ve/tIG
aggressive	x/grE/sIv
agnes	@g/nIs
ago	x/go
agree	x/gri
agreed	x/grid
ah	a
ahab	e/h@b
ahead	x/hEd
ahhah	a/ha
ahoy	@/hoI
aid	ed
aids	edz
aim	em
aimed	emd
ain't	ent
air	er
airing	e/rIG
airline	er/lYn
airplane	er/plen
airplane's	Er/plenz
aisle	Yl
aisles	Ylz
al	@l
aladin	l@//dIn
aladin's	x/l@/dinz
alarm	x/larm
alcohol	@l/kx/hcl
alex	@/lIks
alex's	@/lek/sxz
alexander	@/lIg/z@n/dR
alexander's	@/lIg/z@n/dRz
alfredo	@l/fre/do
algae	@l/Ji
ali	a/li
alibi	@/lx/bY
alice	@/lIs
alice's	@/li/sIz
alicia's	x/li/Sxz
alike	x/lYk
alive	x/lYv
all	cl
alldone	cl/d^n
allen	@/lIn
alligator	@/lI/ge/tR
alligator's	@/lI/ge/tRz
allow	x/lW
allowed	x/lWd
ally	@/lY
almost	cl/most
alone	x/lon
along	x/lcG
aloud	x/lWd
alpha	@l/fx
alphabet	@l/fx/bEt
alphabets	@l/fx/bEts
already	cl/rE/di
alright	cl/rYt
alrightie	cl/rY/ti
also	cl/so
although	cl/Do
altogether	cl/tx/gE/DR
always	c/lwez
am	@m
amazed	x/mezd
amazement	x/mez/mInt
amazing	x/me/zIG
amazingly	x/me/zIG/li
ambitious	@m/bI/SIs
ambivalence	@m/bI/vx/lxns
amelia	x/mi/li/x
amen	e/mEn
america	x/mE/rI/kx
among	x/m^G
amount	x/mWnt
amused	x/myuzd
amusing	x/myu/zIG
an	@n
ancient	en/CInt
and	@nd
andrea's	@n/dri/^z
andrew's	@n/druz
andy	@n/di
andy's	@n/diz
angel	en/Jxl
angelica	@n/JE/lI/kx
angels	en/Jxlz
angle	@G/gxl
angry	@G/gri
animal	@/nI/mxl
animals	@/nI/mxlz
animosity	@/nI/ma/sI/ti
ankle	@G/kxl
ankles	@G/kxlz
ann	@n
anne	@n
annie	@/ni
annie's	@/niz
anniversary	@/nI/vR/sx/ri
annoying	x/nO/IG
anorexic	@/nx/rEk/sIk
another	x/n^/DR
anotherthe	x/n^/DR/Dx
answer	@n/sR
answered	@n/sRd
answering	@n/sx/rIG
answers	@n/sRz
ant	@nt
anteater	@n/ti/tR
antenna	@n/tE/nx
antennaes	@n/tE/nxz
antibiotic	@n/tI/bY/a/tIk
antibiotics	@n/tI/bY/a/tIks
antisocial	@n/ti/so/Sxl
ants	@nts
any	E/ni
anybody	E/ni/b^/di
anyhow	E/ni/hW
anymore	E/ni/mor
anyone	E/ni/w^n
anything	E/ni/TIG
anytime	E/ni/tYm
anyway	E/ni/we
anyways	E/ni/wez
anywhere	E/ni/wer
apart	x/part
apartment	x/par/tmInt
aplenty	x/plEn/ti
apology	x/pa/lx/Ji
apparent	x/pe/rInt
apparently	x/pe/rInt/li
appeals	x/pilz
appearance	x/pi/rIns
appeared	x/pird
appetite	@/pI/tYt
appiesauce	@/pi/scs
apple	@/pxl
apples	@/pxlz
applesauce	@/pxl/scs
appleses	@/pxl/zxz
applied	x/plYd
applies	x/plYz
apply	x/plY
applying	x/plY/yIG
appointment	x/pOnt/mInt
appreciate	x/pri/Si/et
appreciates	x/pri/Si/ets
approached	x/proCt
appropriate	x/prop/ri/et
apricot	@/prI/kat
apricots	@/prI/kats
apron	e/prxn
apronstring	e/prxn/strIG
aquarium	x/kwE/ri/xm
arc	ark
arches	ar/CIz
are	ar
area	e/ri/x
areas	E/ri/xz
areil	E/re/xl
aren't	arnt
arfarf	ar/farf
argue	ar/gyu
arguing	arg/yu/IG
argument	ar/gyx/mInt
arise	x/rYz
ark	ark
arm	arm
armadillo	ar/mx/dI/lo
armhole	^m/h@Ul
arms	armz
army	ar/mi
aroonie	x/ru/ni
around	x/rWnd
arrange	x/renJ
arranged	x/renJd
arrangements	x/renJ/mxnts
arranging	x/ren/JIG
array	x/re
arrived	x/rYvd
arriving	x/rY/vIG
art	art
arthur	ar/TR
article	ar/tI/kxl
articles	ar/tI/kxlz
artillery	ar/tI/lx/ri
arts	arts
as	@z
ashamed	x/Semd
ashes	@/SIz
ashley	@S/li
ashley's	@S/liz
ashy	@/Si
ask	@sk
asked	@skt
asking	@/skIG
asks	@sks
asleep	x/slip
asparagus	xs/p@/rx/gxs
aspirate	@/spx/ret
aspirated	@/spI/re/tId
aspirates	@/spx/rets
aspirating	@/spx/re/tIG
assemble	x/sEm/bxl
asserting	x/sR/tIG
assistance	x/sIs/tIns
associate	x/so/si/et
associated	x/so/si/e/tId
associates	x/so/si/ets
association	x/so/si/e/Sxn
assortment	x/scrt/mInt
assume	x/sum
assumed	x/sumd
at	@t
ate	et
athe	eD
attach	x/t@C
attached	x/t@Ct
attaches	@/tx/Sez
attack	x/t@k
attacked	x/t@kt
attacking	x/t@/kIG
attention	x/tEn/SIn
attic	@/tIk
attitude	@/tI/tud
attitude	@/tI/tud
attractive	x/tr@k/tIv
augmentin	cg/mEn/tIn
august	c/gxst
aunt	@nt
auntie	@n/ti
aunts	@nts
autograph	c/tx/gr@f
automatic	c/tx/m@/tIk
automatically	c/tx/m@/tI/kli
automobile	c/tx/mx/bil
avenue	@/vx/nu
averaging	@v/rI/JIG
avocado	@/vx/ka/do
avocados	@/vx/ka/doz
aw	c
awake	x/wek
awakening	x/we/kx/nIG
aware	x/wEr
away	x/we
awesome	c/sxm
awful	c/fxl
awfully	c/fx/li
awfuls	c/fxlz
awkward	c/kwRd
ax	@ks
aye	Y
b	bi
b@l	bi
baa	ba
baa@o	ba
baba	ba/bx
babac	ba/bak
babar	ba/bar
babars	ba/barz
babas	ba/baz
babble	b@/bxl
babbling	b@/blIG
babe	beb
babes	bebz
babies	be/biz
baboo	bx/bu
baboon	b@/bun
baby	be/bi
baby's	be/biz
babycake	be/bi/kek
babycakes	be/bi/keks
babydoll	be/bi/dcl
babydolls	be/bi/dclz
babysat	be/bi/sIt
babysitter	be/bi/sI/tR
babysitters	be/bi/sI/tRz
back	b@k
backdoor	b@k/dcr
backed	b@kt
backflips	b@k/flIps
background	b@k/grWnd
backie	b@/ki
backing	b@/kIG
backordered	b@/kcr/dRd
backs	b@ks
backtwist	b@k/twIst
backward	b@/kwRd
backwards	b@/kwRdz
backwash	b@/kwaS
backyard	b@/kyard
bacon	be/kxn
bacteria	b@k/tI/ri/x
bad	b@d
badido	bx/di/do
badly	b@d/li
baebae	be/be
bag	b@g
baggie	b@/gi
baggies	b@/giz
baggy	b@/gi
bags	b@gz
bah	ba
bailey	be/li
bake	bek
baked	bekt
baker	be/kR
baker's	be/kRz
bakers	be/kRz
bakes	beks
baking	be/kIG
balance	b@/lxns
balcony	b@l/kx/ni
bald	bcld
ball	bcl
ball's	bclz
ballerina	b@/lx/ri/nx
ballerinas	b@/lx/ri/nxz
ballet	b@/le
ballgame	bcl/gem
ballie	bc/li
balling	bc/lIG
balloon	bx/lun
balloons	bx/lunz
balls	bclz
balmex	bcl/mEks
balogna	bx/lo/ni
baloney	bx/lo/ni
balooga	bx/lu/gx
baltimore	bcl/tI/mcr
bam	b@m
bambi	b@m/bi
bambi's	b@m/biz
bambis	b@m/biz
bamboo	b@m/bu
banana	bx/n@/nx
bananas	bx/n@/nxz
band	b@nd
bandana	d^//nR
bands	b@ndz
bang	b@G
banged	b@Gd
banging	b@G/IG
banillon	bx/nI/lxn
banjo	b@n/Jo
bank	b@Gk
banner	b@/nR
bantam	b@n/txm
baps	b@ps
bar	bar
barbecue	bar/bx/kyu
barbells	bar/bElz
barber	bar/bR
barbie	bar/bi
barbies	bar/biz
barbwire	barb/wYr
barefoot	ber/fUt
barefooted	ber/fU/tId
barely	ber/li
baring	be/rIG
bark	bark
barked	barkt
barking	bar/kIG
barkley	bar/kli
barks	barks
barley	bar/li
barn	barn
barney	bar/ni
barney's	bar/niz
barrel	b@/rxl
barrels	b@/rxlz
barrette	bx/rEt
barrettes	bx/rEts
barron	bE/rxn
barroon	bx/run
barroons	bx/runz
bars	barz
bart	bart
base	bes
baseball	bes/bcl
baseballs	bes/bclz
basement	bes/mInt
bashful	b@S/fxl
basic	be/sIk
basically	be/sI/kli
basics	be/sIks
basil	b@/zxl
basil's	be/zIlz
basket	b@s/kIt
basket's	b@/skIts
basketball	b@/skIt/bcl
basketballs	b@/skIt/bclz
basketful	b@/skIt/fxl
baskets	b@/skIts
baster	be/stR
basty	be/sti
bat	b@t
bath	b@T
bathie	b@/Ti
bathing	be/DIG
bathingsuit	be/DIG/sut
bathingsuits	be/DIG/suts
bathroom	b@/Trum
bathrooms	b@/Trumz
baths	b@Ts
bathtime	b@T/tYm
bathtub	b@T/t^b
batman	b@t/m@n
bats	b@ts
batter	b@/tR
batteries	b@/tx/riz
battery	b@/tx/ri
battery's	b@/tR/iz
battle	b@/txl
batty	b@/ti
bay	be
be	bi
beach	biC
bead	bid
beads	bidz
beady	bi/di
beak	bik
bean	bin
beanbag	bin/b@g
beanie	bi/ni
beans	binz
beanstalk	bin/stak
bear	ber
bear's	bErz
bearbrown	bErr/brWn
beard	bird
bears	berz
beast	bist
beastly	bis/tli
beat	bit
beaten	bi/txn
beaters	bi/tRz
beating	bi/tIG
beatrix	bi/trIks
beautician	byu/tI/SIn
beautiful	byu/tI/fxl
beautifully	byu/tI/fx/li
beauty	byu/ti
beavers	bi/vRz
bebe	be/be
became	bx/kem
because	bx/kcz
become	bI/k^m
becomes	bI/k^mz
becoming	bI/k^/mIG
bed	bEd
bed's	bEdz
beddybye	bE/di/bY
bedroom	bE/drum
beds	bEdz
bedspread	bEd/sprEd
bedtime	bEd/tYm
bee	bi
bee's	biz
beef	bif
been	bIn
beep	bip
beeper	bi/pR
beeps	bips
beer	bir
bees	biz
beet	bit
beetie	bi/ti
beetle	bi/txl
beetles	bi/txlz
beets	bits
before	bx/for
beg	bEg
began	bx/g@n
beggar	bE/gR
begging	bE/gIG
begin	bx/gIn
beginner	bI/gI/nR
beginning	bx/gI/nIG
begins	bx/gInz
begun	bx/g^n
behaved	bx/hevd
behavior	bI/he/vyR
behind	bx/hYnd
being	bi/IG
beings	bi/IGz
belch	bElC
belches	bEl/CIz
belief	bI/lif
believe	bx/liv
believed	bx/livd
believes	bI/livz
bell	bEl
bellies	bE/liz
belligerent	bx/lI/JI/rInt
bellowed	bE/lod
bells	bElz
belly	bE/li
bellybutton	bE/li/b^/txn
belong	bx/lcG
belongs	bx/lcGz
below	bx/lo
belt	bElt
belts	bElts
ben	bEn
ben's	bEnz
bench	bEnC
bend	bEnd
bended	bEn/dId
bending	bEn/dIG
beneath	bx/niT
benjamin	bEn/Jx/mIn
bent	bEnt
berries	bE/riz
berry	bE/ri
bert	bRt
bert's	bRts
bertha's	bR/Txz
beside	bx/sYd
besides	bx/sYdz
best	bEst
bestest	bE/stEst
bet	bEt
beth	bET
better	bE/tR
betty	bE/ti
between	bx/twin
beverage	bE/vx/rIJ
beyond	bi/and
bib	bIb
bibbie	bI/bi
bible	bY/bxl
bibs	bIbz
bicycle	bY/sI/kxl
bid	bId
big	bIg
bigger	bI/gR
biggest	bI/gxst
bike	bYk
bike's	bYks
bikes	bYks
bill	bIl
bills	bIlz
billy	bI/li
bin	bIn
bing@o	bIG
bingo	bIG/go
binkie	bIG/ki
binkies	bIG/kiz
binoculars	bY/na/kyx/lRz
binya	bIn/yx
bird	bRd
bird's	bRdz
birdfeeder	bRd/fi/dR
birdie	bR/di
birdie's	bR/diz
birdies	bR/diz
birds	bRdz
birth	bRT
birthday	bRT/de
biscuits	bI/skIts
bit	bIt
bite	bYt
bites	bYts
biting	bY/tIG
bits	bIts
bitsy	bIt/si
bitter	bI/tR
bitty	bI/ti
black	bl@k
blackberries	bl@k/bE/riz
blackberry	bl@k/bE/ri
blackbird	bl@k/bRd
blackbirds	bl@k/bRdz
blade	bled
blades	bledz
blah	bla
blame	blem
blank	bl@Gk
blanket	bl@G/kIt
blanketie	bl@G/kI/ti
blankets	bl@G/kIts
blankie	bl@G/ki
blankies	bl@G/kiz
blast	bl@st
bleach	bliC
bleached	bliCt
bleaching	bli/CIG
bleed	blid
blend	blEnd
blends	blEndz
bless	blEs
blessed	blE/sId
blessing	blE/sIG
blessings	blE/sIGz
blew	blu
blind	blYnd
blinds	blYndz
blink	blIGk
blinking	blIG/kIG
block	blak
block's	blaks
blockbuster	blak/b^/stR
blocked	blakt
blockhead	blak/hEd
blockie	bla/ki
blockies	bla/kiz
blocking	bla/kIG
blocks	blaks
blond	bland
blonde	bland
blood	bl^d
bloom	blum
blooming	blu/mIG
blossomed	bla/sxmd
blouse	blWs
blow	blo
blowing	blo/IG
blows	bloz
blowup	blo/^p
blue	blu
blue's	bluz
blueberries	blu/bE/riz
blueberry	blu/bE/ri
blush	bl^S
blustery	bl^/stx/ri
bo	bo
board	bord
boarded	bor/dId
boat	bot
boats	bots
bob	bab
bobbing	ba/bIG
bobbling	ba/bx/lIG
bobby	ba/bi
bobo	bo/bo
boboneen	bo/bo/nin
boboni	bo/bo/ni
boboon	bo/bun
boboonie	bo/bu/ni
body	ba/di
bog	bcg
bogus	bo/gxs
boil	bOl
boiled	bOld
boiling	bO/lIG
boing	bOG
bologna	bx/lo/ni
bond	band
bone	bon
boneen	bo/nin
boneen's	bo/ninz
boneene	bo/nin
boneeno	bo/ni/no
bones	bonz
bong	baG
bongo	baG/go
bongos	baG/goz
bonk	baGk
bonked	baGkt
bonkie	baG/ki
bonking	baG/kIG
bonnet	ba/nIt
bonny	ba/ni
bony	bo/ni
boo	bu
boobie	bu/bi
booboo	bu/bu
boobooing@n	bu/bu/IG
booboon	bu/bun
booboon's	bu/bunz
booboonee	bu/bu/ni
boobooneen	bu/bu/nin
boobooneen's	bu/bu/ninz
boobooneeno	bu/bu/ni/no
booboonino	bu/bu/ni/no
booboos	bu/buz
boobooshas	bu/bu/Sxz
booger	bU/gR
boogers	bU/gRz
boogie	bU/gi
boogies	bU/giz
boogyman	bU/gi/m@n
book	bUk
bookbag	bUk/b@g
bookcase	bUk/kes
bookie	bU/ki
bookies	bU/kiz
books	bUks
boom	bum
boom@o	bum
boomdie	bum/di
boomerang	bu/mx/r@G
booms	bumz
boomsie	bum/zi
booneenie	bu/ni/ni
boonie	bu/ni
boop	bup
boops@o	bups
boopsieboo	bup/si/bu
boosh	buS
booshaboosh	bu/Sx/buS
boost	bust
booster	bus/tR
boot	but
bootiebooshas	bu/ti/bu/Sxz
booties	bu/tiz
boots	buts
booty	bu/ti
bop	bap
bop's	baps
boppety	ba/px/ti
bored	bord
boring	bo/rIG
born	bcrn
borrowed	ba/rod
borrowing	ba/ro/IG
bossing	bc/sIG
boston	bc/stIn
both	boT
bother	ba/DR
bothered	ba/DRd
bothering	ba/Dx/rIG
bothers	ba/DRz
bottle	ba/txl
bottles	ba/txlz
bottom	ba/txm
bottoms	ba/txmz
bough	bW
bought	bct
bounce	bWns
bounced	bWnst
bouncer	bWn/sR
bounces	bWn/sIz
bouncie	bWnt/si
bouncing	bWn/sIG
bouncy	bWn/si
bounder	bWn/dR
bounds	bWndz
bout	bWt
bow	bW
bowed	bWd
bowel	bWl
bowels	bWlz
bowing	bW/IG
bowl	bol
bowls	bolz
bows	boz
bowwow	bW/wW
bowwow@o	bW/wW
box	baks
boxes	bak/sIz
boy	bO
boy's	bOz
boys	bOz
boyser	bO/zR
boyz	bOz
bra	bra
bracelet	bres/lIt
braid	bred
braiding	bre/dIG
brain	bren
bran	br@n
branch	br@nC
branches	br@n/CIz
brand	br@nd
brandnew	br@nd/nu
brass	br@s
brat	br@t
brave	brev
bray	bre
bread	brEd
break	brek
breakable	bre/kx/bxl
breakfast	brEk/fxst
breaking	bre/kIG
breaks	breks
breast	brEst
breath	brET
breathe	briD
breather	bri/DR
breathing	bri/DIG
breeze	briz
brenda	brEn/dx
brenda's	brEn/dxz
brendan	brEn/dIn
brian	brY/In
brick	brIk
bricks	brIks
bridge	brIJ
bridges	brI/JIz
briefcase	brif/kes
bright	brYt
brighter	brY/tR
brightness	brYt/nIs
brigitte	brI/JIt
brigitte's	brI/Jits
brilliant	brI/lyInt
bring	brIG
bringing	brIG/IG
brings	brIGz
brisco	brI/sko
brisco's	brI/skoz
bristle	brI/sxl
bristles	brI/sxlz
britches	brI/CIz
brittany	brI/tI/ni
brittney	brIt/ni
brittney's	brIt/niz
broad	brcd
broader	brc/dR
broccoli	bra/kx/li
brocovich	bra/kx/vIC
broke	brok
broken	bro/kxn
brokenhearted	bro/kxn/har/txd
brook	brUk
brooklyn	brU/klIn
broom	brum
brooms	brumz
broth	brcT
brother	br^/DR
brothers	br^/DRz
brought	brct
brown	brWn
brownies	brW/niz
browns	brWnz
brows	brWz
brr	bR
bruce	brus
bruise	bruz
bruised	bruzd
brunch	br^nC
brush	br^S
brusha	br^/Sx
brushed	br^St
brushes	br^/SIz
brushing	br^/SIG
bub	b^b
bubbilicious	b^/bI/lI/Sxs
bubble	b^/bxl
bubbler	b^/bx/lR
bubbles	b^/bxlz
bubblicious	b^/blI/Sxs
bubbly	b^/bli
buckaroo	b^/kx/ru
bucket	b^/kIt
buckets	b^/kIts
buckle	b^/kxl
buckled	b^/kxld
buckles	b^/kxlz
buckling	b^/klIG
bucks	b^ks
bucky	b^/ki
bud	b^d
buddies	b^/diz
buddy	b^/di
buds	b^dz
bug	b^g
bug's	b^gz
bugged	b^gd
buggie	b^/gi
bugging	b^/gIG
bugs	b^gz
build	bIld
builded	bIl/dxd
building	bIl/dIG
buildings	bIl/dIGz
builds	bIldz
built	bIlt
bull	bUl
bullfrog	bUl/frag
bully	bU/li
bullying	bU/li/IG
bullys	bU/liz
bum	b^m
bumblebee	b^m/bxl/bi
bumblebees	b^m/bxl/biz
bumbling	b^m/blIG
bummed	b^md
bummer	b^/mR
bummie	b^/mi
bummie's	b^/miz
bumming	b^/mIG
bump	b^mp
bumped	b^mpt
bumper	b^m/pR
bumping	b^m/pIG
bumpity	b^m/pI/ti
bumps	b^mps
bumpy	b^m/pi
bums	b^mz
bun	b^n
bunch	b^nC
bundle	b^n/dxl
bungalow	b^G/gx/lo
bunnies	b^/niz
bunnies's	b^/ni/zxz
bunny	b^/ni
bunny's	b^/niz
bunnyegg	b^/ni/Eg
bunnyrabbit	b^/ni/r@/bIt
bunnyrabbits	b^/ni/r@/bIts
bunnys	b^/niz
buns	b^nz
bunting	b^n/tIG
buried	bE/rid
burke	bRk
burn	bRn
burned	bRnd
burning	bR/nIG
burnt	bRnt
burp	bRp
burped	bRpt
burper	bR/pR
burpie	bR/pi
burping	bR/pIG
burps	bRps
burrow	bR/ro
burt	bRt
bury	bE/ri
bus	b^s
buses	b^/sIz
bush	bUS
bushed	bUSt
bushel	bU/Sxl
bushes	bU/SIz
business	bIz/nIs
businesses	bIz/nx/sxz
bust	b^st
busted	b^/stId
buster	b^s/tR
busting	b^/stIG
busts	b^sts
busy	bI/zi
but	b^t
but's	b^ts
buts	b^ts
butt	b^t
butter	b^/tR
butterball	b^/tR/bcl
butterflies	b^/tR/flYz
butterfly	b^/tRf/lY
butternut	b^/t@/n^t
butternutie@n	b^/tR/n^/ti
button	b^/txn
buttoned	b^/txnd
buttonhole	b^/txn/hol
buttoning	b^/tI/nIG
buttons	b^/txnz
butts	b^ts
buttsie	b^t/si
buy	bY
buying	bY/IG
buys	bYz
buzz	b^z
buzzing	b^/zIG
by	bY
bye	bY
byebye	bY/bY
byebyes	bY/bYz
c	si
c@l	si
cabbage	k@/bIJ
cabinet	k@/bI/nIt
cabinets	k@/bI/nIts
cable	ke/bxl
caboose	kx/bus
cactus	k@k/tIs
cage	keJ
cages	ke/JIz
cake	kek
cake's	keks
cakes	keks
cakie	ke/ki
caking@n	ke/kIG
calcium	k@l/sixm
calculator	k@l/kyx/le/tR
calendar	k@/lIn/dR
calf	k@f
california	k@/lx/fcrn/yx
call	kcl
called	kcld
calling	kc/lIG
calls	kclz
calm	kclm
calories	k@/lx/riz
calvary	k@l/vx/ri
came	kem
camel	k@/mxl
camels	k@/mxlz
camera	k@/mx/rx
cameras	k@/mx/rxz
camp	k@mp
campbell	k@m/bxl
camped	k@mpt
camping	k@m/pIG
camps	k@mps
can	k@n
can't	k@nt
cancel	k@n/sxl
candies	k@n/diz
candle	k@n/dxl
candles	k@n/dxlz
candy	k@n/di
cane	ken
cannot	k@/nat
cans	k@nz
cantaloupe	k@n/tx/lop
canton	k@n/txn
cap	k@p
capable	ke/px/bxl
capris	kx/priz
captain	k@p/tIn
car	kar
car's	karz
carbonation	kar/bx/ne/Sxn
card	kard
cardboard	kard/bord
cardinal	kar/dI/nxl
cardinals	kar/dI/nxlz
cards	kardz
care	ker
careening	kx/ri/nIG
careful	ker/fxl
carefully	ker/fx/li
cares	kerz
carl	karl
carmen	kar/mxn
carol	k@/rxl
carpet	kar/pIt
carriage	k@/rIJ
carrie	k@/ri
carried	k@/rid
carries	kE/riz
carrot	k@/rIt
carrots	k@/rIts
carry	k@/ri
carrying	k@/ri/IG
cars	karz
carseat	kar/sit
cart	kart
carton	kar/txn
cartoon	kar/tun
cartoons	kar/tunz
carts	karts
case	kes
cases	ke/sIz
cassy	k@/si
castle	k@/sxl
castles	k@/sxlz
casts	k@sts
cat	k@t
cat's	k@ts
catalogs	k@/tx/lcgz
catalogue	k@/tx/lcg
catastrophe	kx/t@s/trx/fi
catch	k@C
catcher	k@/CR
catches	k@/CIz
catching	k@/CIG
catdoor	k@t/dcr
categorical	k@/tI/gc/rI/kxl
categories	k@/tI/gc/riz
caterpillar	k@/tR/pI/lR
caterpillars	k@/tR/pI/lRz
catnaping	k@t/n@/pIG
cats	k@ts
caught	kct
cauliflower	kc/lI/flW/R
cause	kcz
causing	kc/zIG
cavalry	k@/vx/lri
cave	kev
caves	kevz
caw	kc
cdefg@k	si/di/i/Ef/Ji
ceiling	si/lIG
ceilings	si/lIGz
celebrate	sE/lx/bret
celebrated	sE/lx/bre/txd
celebrates	sE/lx/brets
celebrating	sE/lx/bre/tIG
celebration	sE/lx/bre/Sxn
celery	sE/lx/ri
cell	sEl
cells	sElz
cement	sx/mEnt
cent	sEnt
center	sEn/tR
centered	sEn/tRd
centering	sEn/tR/IG
centers	sEn/tRz
centipede	sEn/tI/pid
cents	sEnts
century	sEn/Cx/ri
cereal	sI/ri/xl
cereal's	sI/ri/xlz
cereals	sI/ri/xlz
certain	sR/txn
certainly	sR/txn/li
certificate	sR/tI/fI/kIt
chafing	Ce/fIG
chain	Cen
chains	Cenz
chair	Cer
chairs	Cerz
chalk	Cck
chalkboard	Cak/bcrd
challenge	C@/lInJ
challenging	C@/lIn/JIG
chance	C@ns
chances	C@nt/sxz
change	CenJ
changed	CenJd
changes	Cen/JIz
changing	Cen/JIG
channel	C@/nxl
channels	C@/nxlz
chap	C@p
character	k@/rxk/tR
characteristic	kE/rIk/tx/rI/stIk
characters	k@/rxk/tRz
charge	CarJ
charged	CarJd
charges	Car/Jxz
charging	Car/JIG
charlie	Car/li
charm	Carm
charming	Car/mIG
chart	Cart
chase	Ces
chased	Cest
chases	Ce/sIz
chasing	Ce/sIG
chat	C@t
check	CEk
checkbook	CEk/bUk
checkbook's	CEk/bUks
checkbooks	CEk/bUks
checking	CE/kIG
checkout	CE/kWt
checks	CEks
chee	Ci
cheek	Cik
cheekie	Ci/ki
cheekies	Ci/kiz
cheeks	Ciks
cheep	Cip
cheer	Cir
cheerful	Cir/fxl
cheerio	tSI@/rI/@U
cheerio's	CI/ri/oz
cheerios	Ci/ri/oz
cheers	Cirz
cheery	Ci/ri
cheese	Ciz
cheeseburger	Ciz/bR/gR
cheeto	Ci/to
chef	SEf
cherries	CE/riz
cherrio	CE/ri/o
chest	CEst
chester	CE/stR
chew	Cu
chewed	Cud
chewing	Cu/IG
chews	Cuz
chewy	Cu/i
chi	kY
chichi	Ci/Ci
chichi's	Ci/Ciz
chick	CIk
chick's	CIks
chickadee	CI/kx/di
chicken	CI/kIn
chickennoodle	CI/kxn/nu/dxl
chickens	CI/kInz
chickie	CI/ki
chickie's	CI/kiz
chickies	CI/kiz
chicks	CIks
chico	Ci/ko
chihuahua	CI/wa/wa
child	CYld
children	CIl/drIn
chili	CI/li
chill	CIl
chillier	CI/li/R
chilling	CI/lIG
chillon	CI/lxn
chilly	CI/li
chime	CYm
chimes	CYmz
chimney	CIm/ni
chimp	CImp
chimpanzee	CIm/p@n/zi
chin	CIn
china	CY/nx
chinese	CY/niz
chinie	CI/ni
chinnie	CI/ni
chip	CIp
chipmunks	CIp/m^Gks
chips	CIps
chirp	CRp
chirping	CR/pIG
chitlins	CI/tx/lxnz
chocolate	Cc/kx/lIt
choice	COs
choices	CO/sIz
choke	Cok
choking	Co/kIG
cholesterol	kx/lEs/tx/rcl
chomp	Camp
choo	Cu
choo@o	Cu
chooc@o	Cuk
choochoo	Cu/Cu
choochoo@o	Cu/Cu
choose	Cuz
chop	Cap
chopped	Capt
chore	Cor
chores	Ccrz
chose	Coz
chris	krIs
christ	krYst
christened	krI/sInd
christening	krI/sI/nIG
christmas	krI/smxs
christopher	krI/stx/fR
chubby	C^/bi
chuckie	C^/ki
chugga@o	C^/gx
chunky	C^G/ki
church	CRC
churches	CR/Cxz
chute	Sut
cigarette	sI/gx/rEt
cinderella	sIn/dx/rE/lx
cinderella's	sin/dx/rE/lxz
cindy	sIn/di
cindy's	sIn/diz
cinnamon	sI/nx/mxn
circle	sR/kxl
circled	sR/kxld
circles	sR/kxlz
circular	sR/kyx/lR
circulation	sR/kyx/le/SIn
circumstances	sR/kxm/st@n/sIz
circus	sR/kxs
citrus	sI/trIs
city	sI/ti
civilization	sI/vx/lx/ze/Sxn
civilized	sI/vI/lYzd
clamp	kl@mp
clap	kl@p
clappie	kl@/pi
clapping	kl@/pIG
class	kl@s
clattering	kl@/tx/rIG
claus	klWs
clay	kle
clean	klin
cleaned	klind
cleaner	kli/nR
cleaner's	kli/nRz
cleanest	kli/nIst
cleaning	kli/nIG
cleans	klinz
cleanup	kli/n^p
clear	klir
clearance	kli/rIns
cleared	klird
clearer	kli/rR
clearly	klIr/li
clever	klE/vR
click	klIk
clicker	klI/kR
clicking	klI/kIG
clifford	klI/fRd
clifford's	klI/fRdz
climb	klYm
climbed	klYmd
climber	klY/mR
climbing	klY/mIG
climbs	klYmz
clings	klIG
clinic	klI/nIk
clinics	klI/nIks
clink	klIGk
clinking	klIG/kIG
clip	klIp
clipped	klIpt
clippers	klI/pRz
clipping	klI/pIG
clips	klIps
cloaks	kloks
clobber	klc/bR
clock	klak
clop	klap
close	klos
closed	klozd
closely	klo/sli
closer	klo/sR
closes	klo/zIz
closet	klc/zIt
closing	klo/zIG
cloth	klcT
clothes	kloDz
clothing	klo/DIG
cloud	klWd
clouding	klW/dIG
clouds	klWdz
cloudy	klW/di
clover	klo/vR
clown	klWn
clowns	klWnz
club	kl^b
cluck	kl^k
clue	klu
clues	kluz
clumps	kl^mps
clumpy	kl^m/pi
clumsily	kl^m/zI/li
clunk	kl^Gk
clunky	kl^G/ki
clutter	kl^/tR
cluttering	kl^/tR/IG
coaster	kos/tR
coasters	ko/stRz
coat	kot
coats	kots
cob	kab
cobweb	ka/bwEb
cobwebs	kab/wEbz
coca	ko/kx
cock	kak
cockadoodledoo	ka/kx/du/dxl/du
cockle	ka/kxl
cocoa	ko/ko
cocoon	kx/kun
code	kod
coffee	kc/fi
coins	kOnz
coke	kok
cola	ko/lx
colada	ko/la/dx
cold	kold
cold's	koldz
colder	kol/dR
coleman	kol/mxn
collapse	kx/l@ps
collar	ka/lR
collect	kx/lEkt
collection	kx/lEk/SIn
college	ka/lIJ
color	k^/lR
color's	k^/lRz
colored	k^/lRd
colorful	k^/lR/fxl
coloring	k^/lx/rIG
colors	k^/lRz
colts	kolts
column	ka/lxm
columns	ka/l^mz
comb	kom
combed	komd
combie	kom/bi
combination	kam/bI/ne/SIn
combine	kam/bYn
combing	ko/mIG
combs	komz
come	k^m
comedy	ka/mI/di
comes	k^mz
comfort	k^m/fRt
comfortable	k^m/fR/tx/bxl
comfortably	k^m/fR/tx/bli
comforter	k^m/fR/tR
comforting	k^m/fR/tIG
comfy	k^m/fi
coming	k^/mIG
commanded	kx/m@n/dId
commander	kx/m@n/dR
comment	ka/mEnt
commercial	kx/mR/Sxl
commercials	kx/mR/Sxlz
common	ka/mxn
communicate	kx/myu/nI/ket
communication	kx/myu/nI/ke/SIn
company	k^m/px/ni
compared	kxm/pErd
complain	kxm/plen
complaining	kxm/ple/nIG
complains	kxm/plenz
complete	kxm/plit
completed	kxm/pli/tId
completely	kxm/plit/li
complicated	kam/plI/ke/tId
complication	kam/plI/ke/SIn
computer	kxm/pyu/tR
concentrate	kan/sIn/tret
concentrating	kan/sIn/tre/tIG
concentric	kxn/sEn/trIk
concept	kan/sEpt
concerned	kxn/sRnd
concerns	kxn/sRnz
concert	kan/sRt
concerts	kan/sRts
condensation	kan/dIn/se/SIn
conditioner	kxn/dI/SI/nR
conditioning	kxn/dI/SI/nIG
condo	kan/do
condos	kan/doz
cone	kon
confident	kan/fI/dInt
confuse	kxn/fyuz
confused	kxn/fyuzd
confusing	kxn/fyu/zIG
congestion	kxn/JEs/CIn
congratulate	kxn/gr@/Cx/let
connect	kx/nEkt
connecting	kx/nEk/tIG
connection	kx/nEk/Sxn
connections	kx/nEk/Sxnz
connie	ka/ni
connotes	kx/nots
conscious	kan/Sxs
consider	kxn/sI/dR
considerate	kxn/sI/dx/rIt
considered	kxn/sI/dRd
considering	kxn/sI/dx/rIG
considers	kxn/sI/dRz
consistent	kxn/sI/stxnt
consistently	kxn/sI/stxnt/li
conspiracy	kxn/spI/rI/si
constant	kan/stInt
constantly	kan/stInt/li
constellation	kan/stx/le/Sxn
construct	kxn/str^kt
contact	kan/t@kt
contain	kxn/ten
containable	kxn/te/nx/bxl
contained	kxn/tend
container	kxn/te/nR
containers	kxn/te/nRz
containing	kxn/te/nIG
contains	kxn/tenz
content	kxn/tEnt
contents	kxn/tEnts
context	kan/tEkst
continually	kxn/tIn/yu/x/li
continue	kxn/tI/nyu
continued	kxn/tIn/yud
contrary	kxn/trE/ri
control	kxn/trol
controlled	kxn/trold
controller	kxn/tro/lR
controls	kxn/trolz
convenience	kxn/vi/nyIns
conversation	kan/vR/se/SIn
conversations	kan/vR/se/Sxnz
cook	kUk
cooked	kUkt
cookie	kU/ki
cookies	kU/kiz
cooking	kU/kIG
cooks	kUks
cool	kul
cooled	kuld
cooler	ku/lR
cooling	ku/lIG
coop	kup
cooperate	ko/a/px/ret
cooperating	ko/a/px/re/tIG
cooperative	ko/a/px/rI/tIv
coordinate	ko/cr/dI/net
coordination	ko/cr/dI/ne/SIn
copied	ka/pid
coppertone	ka/pR/ton
cops	kaps
copyright	ka/pi/rYt
coral	kc/rxl
cord	kcrd
cords	kcrdz
corduroy	kcr/dx/rO
corduroy's	kcr/dx/rOz
cork	kcrk
corked	kcrkt
corn	kcrn
corner	kcr/nR
cornfield	kcrn/fild
cornish	kcr/nIS
corny	kcr/ni
corral	kx/r@l
correct	kx/rEkt
correctly	kx/rEkt/li
correspondence	kc/rx/span/dxns
cosby	kcz/bi
cost	kcst
costs	kcsts
cotton	ka/txn
cottontail	ka/txn/tel
couch	kWC
couches	kW/CIz
cough	kcf
coughing	kc/fIG
could	kUd
couldn't	kU/dxnt
counselor	kWn/sx/lR
count	kWnt
counted	kWn/tId
counter	kWn/tR
countertop	kWn/tR/tap
counting	kWn/tIG
countries	k^n/triz
country	k^n/tri
counts	kWnts
county	kWn/ti
couple	k^/pxl
coupon	ku/pan
coupons	ku/panz
course	kors
courting	kor/tIG
cousin	k^/zIn
cousins	k^/zInz
cover	k^/vR
covered	k^/vRd
covering	k^/vx/rIG
covers	k^/vRz
cow	kW
cow's	kWz
cowabunga	k/Wx/b^n/gx
cowboy	kW/bO
cowpokie	kW/po/ki
cows	kWz
cozy	ko/zi
crab	kr@b
crabbie	kr@/bi
crabbing	kr@/bIG
crabby	kr@/bi
crack	kr@k
cracked	kr@kt
cracker	kr@/kR
crackers	kr@/kRz
crackery	kr@/kR/i
cracky	kr@/ki
cradle	kre/dxl
cradles	kre/dxlz
cramped	kr@mpt
cranberries	kr@n/bE/riz
cranberry	kr@n/bE/ri
crane	kren
cranium	kre/ni/xm
crank	kr@Gk
crankiness	kr@G/ki/nEs
cranky	kr@G/ki
crap	kr@p
crash	kr@S
crashed	kr@St
crashes	kr@/Sxz
crashing	kr@/SIG
crawl	krcl
crawled	krcld
crawler	krc/lR
crawling	krc/lIG
crawls	krclz
crayon	kre/an
crayons	kre/anz
crazed	krezd
crazy	kre/zi
cream	krim
creamy	kri/mi
creates	kri/ets
creative	kri/e/tIv
creatively	kri/e/tIv/li
creature	kri/CR
creatures	kri/CRz
credit	krE/dIt
credited	krE/dI/txd
crediting	krE/dI/tIG
credits	krE/dIts
creek	krik
creep	krip
creepy	kri/pi
crew	kru
crib	krIb
cribbie	krI/bi
crickets	krI/kIts
cried	krYd
crinkles	krIG/kxlz
crinkling	krIG/klIG
crinkly	krIG/kli
crispier	krI/spi/R
crispiest	krI/spi/Est
crispy	krI/spi
crisscross	krI/skrcs
critter	krI/tR
croakity	kro/kx/ti
crock	krak
crocodile	kra/kx/dYl
crocodiles	kra/kx/dYlz
crocodiles'	kra/kx/dYlz
crocuses	kro/kx/sIz
crooked	krU/kxd
crooks	krUks
cross	krcs
crossed	krcst
crossing	krc/sIG
crosss	kras
crow	kro
crowd	krWd
crowded	krW/dId
crowed	krod
crown	krWn
crud	kr^d
cruise	kruz
crumb	kr^m
crumble	kr^m/bxl
crumbs	kr^mz
crunch	kr^nC
crunchies	kr^n/Ciz
crunchy	kr^n/Ci
crush	kr^S
crust	kr^st
crusted	kr^s/tId
crusty	kr^s/ti
cry	krY
crybaby	krY/be/bi
crying	krY/IG
crystals	krI/stxlz
cub	k^b
cubby	k^/bI
cube	kyub
cubes	kyubz
cucumber	kyu/k^m/bR
cucumbers	kyu/k^m/bRz
cuddly	k^d/li
cuetip	kyu/tIp
cup	k^p
cupboard	k^/bRd
cupboard's	k^/bRdz
cupcake	k^p/kek
cupcake's	k^p/keks
cupcakes	k^p/keks
cupfuls	k^p/fUlz
cups	k^ps
cups	k^ps
curb	kRb
curds	kRdz
curious	kyU/ri/xs
curl	kRl
curled	kRld
curly	kR/li
current	kR/rInt
curse	kRs
curtain	kR/txn
curtains	kR/txnz
curvy	kR/vi
cushion	kU/SIn
cushioned	kU/SInd
cushions	kU/SInz
cut	k^t
cute	kyut
cutest	kyu/tIst
cutesy	kut/si
cutey	kyu/ti
cutie	kyu/ti
cutiepie	kyu/ti/pY
cutting	k^/tIG
cymbals	sIm/bxlz
czech	CEk
czechoslovakia's	CE/kx/slx/va/ki/xz
d	di
d@l	di
da	da
dab	d@b
dab@c	d@b
dabby@c	d@b
dad	d@d
dad'll	d@/dxl
dad's	d@dz
dada	d@/d@
dada's	d@/d@z
dadada	d@/d@/d@
dadada's	d@/d@/d@z
dadada@o	d@/d@/d@
dadadada@o	d@/d@/d@/d@
daddy	d@/di
daddy'd	d@/did
daddy's	d@/diz
daffodil	d@/fx/dIl
daffodils	d@/fx/dIlz
daffy	d@/fi
daily	de/li
dainty	den/ti
dairy	de/ri
daisies	de/ziz
daisy	de/zi
dakota	dx/ko/tx
dakota's	dx/ko/txz
dale	del
dalmatian	d@l/me/SIn
dalmatians	d@l/me/SInz
damage	d@/mIJ
damaged	d@/mxJd
damages	d@/mx/Jxz
damaging	d@/mx/JIG
dame	dem
damn	d@m
damp	d@mp
dan	d@n
dan's	d@nz
dance	d@ns
dances	d@n/sIz
dancing	d@n/sIG
dandelion	d@n/dx/lY/In
dandy	d@n/di
dang	d@G
dangerous	den/Jx/rxs
daniel	d@n/yxl
dapper	d@/pR
dare	der
daring	de/rIG
dark	dark
darling	dar/lIG
darn	darn
dat	d@t
date	det
daughter	dc/tR
david	de/vId
davis	de/vIs
dawn	dcn
dawn's	dcnz
day	de
day's	dez
daycare	de/kEr
daydreaming	de/dri/mIG
days	dez
daytime	de/tYm
daze	dez
dazey	de/zi
dead	dEd
deal	dil
dear	dir
deborah	dE/bx/rx
debra	dE/brx
december	dI/sEm/bR
decent	di/sInt
decibels	dE/sx/bxlz
decide	dI/sYd
decided	dI/sY/dId
decisions	dI/sIZ/Inz
deck	dEk
declare	dI/kler
declared	dI/klErd
declares	dI/klErz
declaring	dI/klE/rIG
decoration	dE/kx/re/SIn
decorations	dE/kx/re/SInz
deep	dip
deepest	di/pIst
deer	dir
defender	dI/fEn/dR
definitely	dE/fI/nIt/li
definition	dE/fI/nI/SIn
defrost	dI/frcst
degree	dx/gri
degrees	dI/griz
dehydrated	di/hY/dre/tId
delay	dI/le
delete	dx/lit
deleting	dx/li/tIG
delicious	dx/lI/SIs
delighted	dI/lY/tId
deliver	dx/lI/vR
delivers	dI/lI/vRz
dell	dEl
deluxe	dx/l^ks
demand	dI/m@nd
demolition	dE/mx/lI/SIn
demonstrate	dE/mxn/stret
dennis	dE/nIs
dense	dEns
dentist	dEn/tIst
dentist's	dEn/tIsts
deny	dI/nY
depend	dI/pEnd
depended	dI/pEn/dxd
depending	dI/pEn/dIG
depends	dI/pEndz
deposit	dI/pa/zIt
deprive	dI/prYv
deprived	dI/prYvd
derived	dI/rYvd
desert	dI/zRt
deserve	dI/zRv
design	dI/zYn
desire	dI/zYr
desitin	dE/zI/tIn
desk	dEsk
despise	dIs/pYz
dessert	dI/zRt
destroy	dIs/trO
destroying	dI/strO/IG
destruction	dE/str^k/Sxn
destructive	dIs/tr^k/tIv
detergent	dI/tR/JInt
detergents	dI/tR/JEnts
determine	dI/tR/mIn
determined	dI/tR/mInd
detour	di/tur
device	dI/vYs
devil	dE/vxl
devon	dE/vxn
devotion	dI/vo/SIn
devour	dI/vW/R
dew	du
dextrous	dEk/strxs
dial	dYl
dialect	dY/x/lEkt
dialing	dY/lIG
dials	dY/xlz
diamond	dY/mxnd
diamonds	dY/mxndz
diaper	dY/pR
diapers	dY/pRz
diapie	dY/pi
diarrhea	dY/x/ri/x
dickory	dI/kR/i
dictionary	dIk/SI/nE/ri
did	dId
diddle	dI/dxl
didey	dY/di
dideys	dY/diz
didi@o	di/di
dididi@o	di/di/di
didn't	dI/dxnt
die	dY
died	dYd
dieing	dY/IG
dies	dYz
diesha	dY/i/Sx
diet	dY/It
dieting	dY/x/tIG
diets	dY/xts
difference	dI/frIns
differences	dI/fx/rIn/sIz
different	dI/frInt
differentiate	dI/fx/rEn/Si/et
differently	dI/frxnt/li
difficult	dI/fI/kxlt
difficulty	dI/fI/k^l/ti
dig	dIg
digby	dIg/bi
digger	dI/gR
digging	dI/gIG
digits	dI/JIt
digs	dIgz
dillards	dI/lRdz
dillon	dI/lxn
dillon's	dI/lxnz
dimples	dIm/pxlz
ding	dIG
dining	dY/nIG
dinner	dI/nR
dinners	dI/nRz
dinnertime	dI/nR/tYm
dinosaur	dY/nI/scr
dinosaur's	dY/nx/scrz
dip	dIp
dips	dIps
dipsie	dIp/si
dipsy	dIp/si
direct	dI/rEkt
directing	dI/rEk/tIG
direction	dI/rEk/SIn
directions	dI/rEk/SInz
dirt	dRt
dirt's	dRts
dirty	dR/ti
dis	dIs
disappear	dI/sx/pir
disappeared	dI/sx/pird
disappearing	dI/sx/pI/rIG
disappointing	dI/sx/pOn/tIG
disaster	dI/z@s/tR
disc	dIsk
discontent	dIs/kxn/tEnt
discover	dIs/k^/vR
discovered	dI/sk^/vRd
discoverer	dIs/k^/vx/rR
discovery	dIs/k^/vx/ri
discs	dIsks
discuss	dIs/k^s
discussed	dI/sk^st
discussion	dIs/k^/SIn
disguised	dIs/gYzd
disgust	dIs/g^st
disgusted	dIs/g^/stId
disgusting	dIs/g^/stIG
dish	dIS
dishes	dI/SIz
dishrag	dI/Sr@g
dishwasher	dIS/wa/SR
disinfected	dI/sIn/fEk/tId
dismantle	dI/sm@n/txl
dismay	dI/sme
disney	dIz/ni
disney's	dIz/niz
disobedient	dI/sx/bi/di/Int
disobey	dI/sx/be
disposal	dIs/po/zxl
dispose	dIs/poz
disposition	dIs/px/zI/SIn
distinct	dI/stIGkt
distinction	dI/stIGk/Sxn
distinguishes	dI/stIGg/wI/SIz
distracted	dI/str@k/tId
distracting	dI/str@k/tIG
distraction	dIs/tr@k/SIn
distracts	dI/str@kts
disturb	dIs/tRb
ditty	dI/ti
dive	dYv
dived	dYvd
dives	dYvz
divine	dI/vYn
diving	dY/vIG
dizzy	dI/zi
do	du
do@si	do/si
dock	dak
doctor	dak/tR
doctor's	dak/tRz
dodge	daJ
does	d^z
doesn't	d^/zxnt
dog	dcg
dog's	dcgz
doggie	dc/gi
doggie's	dc/giz
doggies	dc/giz
doggone	dc/gcn
doggy	dc/gi
doggy's	dc/giz
doghouse	dcg/hWs
dogs	dcgz
doing	du/IG
doll	dcl
doll's	dalz
dollar	da/lR
dollars	da/lRz
dollhouse	dal/hWs
dollie	da/li
dollie's	da/liz
dollies	dc/liz
dolls	dclz
dolly	dc/li
dolly's	dc/liz
dolphin	dal/fIn
dolphins	dcl/fInz
dome	dom
domestic	dx/mEs/tIk
don	dan
don't	dont
donald	da/nxld
donald's	da/nxldz
done	d^n
dong	daG
donkey	dcG/ki
donkeys	daG/kiz
donna	da/nx
donovan	da/nx/vxn
donut	do/nxt
doo	du
doodle	du/dxl
doodoo	du/du
doopsie	dup/si
door	dor
door's	dorz
doorbell	dor/bEl
doorbells	dcr/bElz
doors	dorz
doorstop	dcr/stap
doorway	dor/we
doozy	du/zi
doremifasolatido@si	do/re/mi/fa/so/la/ti/do
dorm	dorm
dos	dcs
dot	dat
doting	do/tIG
dotty	da/ti
double	d^/bxl
doubling	d^/blIG
doubt	dWt
dough	do
doughnut	do/n^t
doughnuts	do/n^ts
dove	d^v
dover	do/vR
down	dWn
downie	dW/ni
download	dWn/lod
downloaded	dWn/lo/dxd
downstairs	dWn/sterz
downstream	dWn/strim
downtown	dWn/tWn
downy	dW/ni
doze	doz
dozen	d^/zIn
drag	dr@g
dragged	dr@gd
dragging	dr@/gIG
dragon	dr@/gxn
dragon's	dr@/gxnz
dragonfly	dr@/gxn/flY
dragons	dr@/gxnz
drags	dr@gz
drags	dr@gz
drain	dren
drainage	dre/nIJ
drama	dra/mx
dramatic	drx/m@/tIk
drank	dr@Gk
drape	drep
draw	drc
drawer	drcr
drawers	drcrz
drawing	drc/IG
draws	drcz
dreadful	drEd/fxl
dream	drim
dreamed	drimd
dreaming	dri/mIG
dreams	drimz
dreamy	dri/mi
drenched	drEnCt
dress	drEs
dressed	drEst
dresser	drE/sR
dresses	drE/sIz
dressing	drE/sIG
drew	dru
dried	drYd
drill	drIl
drink	drIGk
drink's	drIGks
drinkie	drIG/ki
drinking	drIG/kIG
drinks	drIGks
drip	drIp
dripping	drI/pIG
drippy	drI/pi
drips	drIps
drive	drYv
driver	drY/vR
drives	drYvz
driveway	drYv/we
driving	drY/vIG
drool	drul
drooling	dru/lIG
drooly	dru/li
droopy	dru/pi
drop	drap
dropped	drapt
dropping	dra/pIG
drops	draps
drove	drov
drown	drWn
drum	dr^m
drum's	dr^mz
drummer	dr^/mR
drumming	dr^/mIG
drummond	dr^/mxnd
drums	dr^mz
drunk	dr^Gk
drunken	dr^G/kxn
dry	drY
dryer	drYr
drying	drY/IG
drys	drYz
dub	d^b
duck	d^k
duckie	d^/ki
duckie's	d^/kiz
duckies	d^/kiz
ducklings	d^/klIGz
ducks	d^ks
dude	dud
due	du
dueling	du/x/lIG
dug	d^g
dukes	duks
dum	d^m
dumb	d^m
dumbo	d^m/bo
dummy	d^/mi
dump	d^mp
dumped	d^mpt
dumping	d^m/pIG
dumpling	d^m/plIG
dumpty	d^mp/ti
dumpty's	d^mp/tiz
duplo	du/plo
duress	dx/rEs
during	dU/rIG
dust	d^st
dusted	d^/stId
dusting	d^/stIG
dustpan	d^st/p@n
dusty	d^s/ti
dvd	di/vi/di
dwight	wYt
dya	dyx
dye	dY
dyed	dYd
dyeisha	dY/i/Sx
dyeisha's	dY/i/Sxz
dyes	dYz
dyiesha	dY/i/Sx
dying	dY/IG
e	i
e@l	i
e@l-s	i
each	iC
ear	ir
ear's	Irz
earache	i/rek
eardrum	ir/dr^m
earlier	R/li/R
early	R/li
earned	Rnd
earphones	ir/fonz
earring	ir/rIG
earrings	ir/rIGz
ears	irz
earth	RT
earthquake	RT/kwek
ease	iz
easier	i/zi/R
easiest	i/zi/Ist
easily	i/zx/li
easter	i/stR
easy	i/zi
eat	it
eaten	i/txn
eater	i/tR
eating	i/tIG
eats	its
ecosystem	i/ko/sI/stxm
ecta@q	Ek/tx
eddie	E/di
eden	i/dxn
edge	EJ
edges	E/JIz
edible	E/dx/bxl
educational	E/JU/ke/Sx/nxl
edward	Ed/wRd
eel	il
eensie	in/si
eeyore	i/ar
effort	E/fRt
efg@k	i/Ef/Ji
egg	Eg
eggfooyung	Eg/fu/y^G
eggs	Egz
eh	E
eight	et
eighteen	e/tin
eighth	etT
either	i/DR
el	El
elastic	I/l@/stIk
elbow	El/bo
elbows	El/boz
eleanor	E/lx/nR
electrical	x/lEk/trI/kxl
electrician	E/lxk/trI/SIn
electricity	x/lEk/trI/sI/ti
electrocute	I/lEktrp/kyut
electrocuted	x/lEk/trx/kyu/tId
electrolytes	x/lEk/trx/lYts
electronically	^/lEk/tra/nI/kli
elegant	E/lx/gxnt
elephant	E/lx/fInt
elephant's	E/lx/fInts
elephants	E/lx/fxnts
eleven	x/lE/vIn
eleventh	x/lE/vInT
elijah	x/lY/Jx
elisse	pe/lis
elizabeth	x/lI/zx/bxT
elizabeth's	I/lI/zx/bETs
ella	E/lx
ellie	E/li
elmo	El/mo
elmo's	El/moz
else	Els
else's	El/sIz
eluded	I/lu/dId
elves	Elvz
email	i/mel
embarrassed	Em/b@/rIst
emergency	I/mR/JIn/si
emily	E/mI/li
emmy	E/mi
emmy's	E/miz
emote	I/mot
emotional	I/mo/SI/nxl
emperor's	Em/px/rRz
empty	Em/pti
enamel	E/n@/mxl
encourage	En/kR/rIJ
encouraged	En/kR/IJd
encouraging	En/kR/I/JIG
end	End
ended	En/dId
endlessly	End/lI/sli
ends	Endz
enemy	E/nI/mi
energy	E/nR/Ji
engine	En/JIn
english	IG/glIS
enjoy	En/JO
enjoyed	En/JOd
enjoying	En/JO/IG
enjoys	En/JOz
enormous	I/ncr/mxs
enough	I/n^f
enter	En/tR
entered	En/tRd
entering	En/tR/IG
enters	En/tRz
entertained	E/nR/tend
entertaining	E/nR/te/nIG
entertainment	E/nR/ten/mInt
enthusiastic	En/Tu/zi/@/stIk
entice	En/tYs
entire	En/tY/R
entirely	En/tYr/li
entrance	En/trIns
entrapment	En/tr@p/mInt
entry	En/tri
envelope	En/vx/lop
envelopes	En/vx/lops
environment	En/vY/rxn/mxnt
equipment	I/kwIp/mInt
er	R
eric	E/rIk
erin	E/rIn
ernie	R/ni
ernie's	R/niz
escape	Es/kep
escaped	E/skept
especially	E/spE/Sx/li
estate	Es/tet
eternal	i/tR/nxl
etti	E/ti
european	yU/rx/pi/In
evaporate	E/v@/px/ret
evaporated	I/v@/pR/e/txd
eve	iv
even	i/vxn
evening	iv/nIG
event	I/vEnt
eventually	E/vEn/Cu/x/li
ever	E/vR
every	E/vri
everybody	E/vri/ba/di
everybody's	Ev/ri/ba/diz
everyone	E/vri/w^n
everyone's	E/vri/w^nz
everyplace	E/vri/ples
everything	E/vri/TIG
everything's	Ev/ri/TIGz
everywhere	E/vri/wer
evil	i/vxl
ew	u
ewe	yu
ewie	yu/i
exact	Eg/z@kt
exactly	Eg/z@kt/li
exalted	Eg/zcl/tId
examples	Ig/z@m/pxlz
excellent	Ek/sx/lInt
except	Ek/sEpt
excess	Ek/sEs
excited	Ek/sY/tId
excitement	Ek/sYt/mInt
exciting	Ek/sY/tIG
excuse	Eks/kyus
excuses	Iks/kyu/sIz
exercise	Ek/sR/sYz
exercises	Ek/sR/sY/zIz
exercising	Ek/sR/sY/zIG
exersaucer	Ek/sR/sc/sR
exert	Ig/zRt
exhibits	Eg/zI/bIts
exists	Eg/zIsts
exodus	Ek/sx/dxs
expect	Eks/pEkt
expectations	Ek/spEk/te/SInz
expected	Ek/spEk/tId
expecting	Ek/spEk/tIG
expects	Ik/spEkts
expedition	Ek/spx/dI/SIn
expensive	Eks/pEn/sIv
experience	Eks/pI/ri/Ins
experiment	Eks/pE/rI/mInt
explain	Ik/splen
explanation	Eks/plx/ne/SIn
exploded	Ek/splo/dId
explore	Eks/plor
exploring	Ek/splo/rIG
explosion	Eks/plo/ZIn
exposed	Ek/spozd
express	Eks/prEs
expresses	Ik/sprE/sxz
expression	Eks/prE/SIn
extent	Ik/stEnt
external	Eks/tR/nxl
extinguisher	Eks/tIG/gwI/SR
extra	Eks/trx
extract	Ek/str@kt
extracted	Ek/str@k/tId
extracting	Ek/str@k/tIG
extracts	Ek/str@kts
extraordinarily	Ik/strcr/dx/nE/rx/li
extraordinary	Ik/strcr/dx/nE/ri
extremely	Ek/strim/li
eye	Y
eyeball	Y/bcl
eyebrow	Y/brW
eyebrows	Y/brWz
eyeglass	Yg/l@s
eyeglasses	Y/gl@/sIz
eyeore	i/ar
eyes	Yz
eyesight	Y/sYt
eyore	i/ar
eyore's	i/arz
f	Ef
f@l	Ef
fa@si	fa/si
fabulous	f@/byx/lxs
face	fes
facecloth	fes/klaT
faced	fest
faces	fe/sIz
facie	fe/si
facing	fe/sIG
fact	f@kt
fade	fed
fair	fer
fairies	fE/riz
fairly	fer/li
fairy	fe/ri
faithful	feT/fxl
fake	fek
faked	fekt
faker	fe/kR
fakes	feks
faking	fe/kIG
fall	fcl
fallen	fc/lxn
falling	fc/lIG
falls	fclz
false	fcls
familiar	fx/mI/lyR
families	f@m/liz
family	f@/mx/li
famous	fe/mxs
fan	f@n
fan's	f@nz
fancy	f@n/si
fanny	f@/ni
fantabalocious	f@n/t@/bx/lo/Sxs
fantastic	f@n/t@s/tIk
far	far
faraway	fa/rx/we
farm	farm
farmer	far/mR
farmer's	far/mRz
farmyard	farm/yard
fart	fart
farted	far/tId
farther	far/DR
fartie	far/ti
fascinated	f@/sI/ne/tId
fascinating	f@/sI/ne/tIG
fascination	f@/sI/ne/SIn
fast	f@st
fasten	f@/sIn
fastens	f@/sInz
faster	f@/stR
fat	f@t
fates	fets
father	fa/DR
father's	fa/DRz
fathers	fa/DRz
fault	fclt
favor	fe/vR
favorite	fe/vx/rIt
favorites	fe/vx/rIts
favoritest	fe/vrI/txst
fawn	fcn
faye	fe
fear	fir
feast	fist
feather	fE/DR
feathers	fE/DRz
feathery	fE/Dx/ri
fed	fEd
fee	fi
feed	fid
feeder	fi/dR
feeding	fi/dIG
feeds	fidz
feel	fil
feeling	fi/lIG
feelings	fi/lIGz
feels	filz
fees	fiz
feet	fit
feet'll	fi/txl
feetie	fi/ti
feeties	fi/tiz
feets	fits
feetsies	fit/siz
feisty	fY/sti
fell	fEl
fella	fE/lx
fellow	fE/lo
felt	fElt
fence	fEns
fenced	fEnst
fennel	fE/nxl
ferocious	fx/ro/Sxs
ferris	fE/rIs
ferry	fE/ri
fetch	fEC
fettuccini	fE/tx/Ci/ni
fever	fi/vR
few	fyu
fiber	fY/bR
fickle	fI/kxl
fiddle	fI/dxl
fiddles	fI/dxlz
fido	fY/do
field	fild
fifferfefferfeff	fI/fR/fE/fR/fEf
fifteen	fIf/tin
fifteenth	fIf/tinT
fifth	fIfT
fiftieth	fIf/ti/IT
fifty	fIf/ti
fig	fIg
fight	fYt
fighter	fY/tR
fighting	fY/tIG
figs	fIgz
figure	fI/gyR
figured	fIg/yRd
figures	fIg/yRz
figuring	fIg/yR/IG
fill	fIl
filled	fIld
filling	fI/lIG
film	fIlm
filthy	fIl/Ti
fin	fIn
finally	fY/nx/li
find	fYnd
finding	fYn/dIG
findow@n	fIn/do
finds	fYndz
fine	fYn
finger	fIG/gR
fingernail	fIG/gR/nel
fingernails	fIG/gR/nelz
fingerprints	fIG/gR/prInts
fingers	fIG/gRz
finicky	fI/nI/ki
finish	fI/nIS
finished	fI/nISt
finishing	fI/nI/SIG
fins	fInz
fiona	fi/o/nx
fir	fR
fire	fYr
firefly	fYr/flY
fireplace	fYr/ples
fires	fYrz
firmly	fRm/li
first	fRst
fish	fIS
fishbowl	fIS/bol
fisher	fI/SR
fishes	fI/SIz
fishie	fI/Si
fishie's	fI/Siz
fishies	fI/Siz
fishing	fI/SIG
fist	fIst
fists	fIsts
fit	fIt
fits	fIts
fitti	fI/ti
fitting	fI/tIG
fittis	fI/tIs
fitzgerald	fIts/JE/rxld
fitzpatrick's	fIt/sp@/trIks
five	fYv
fix	fIks
fixable	fIk/sx/bxl
fixed	fIkst
fixes	fIk/sIz
fixing	fIk/sIG
fixit	fIk/sIt
flag	fl@g
flair	flEr
flairs	flErz
flakes	fleks
flamingo	flx/mIG/go
flap	fl@p
flaps	fl@ps
flash	fl@S
flashcard	fl@S/kard
flashes	fl@/SIz
flashlight	fl@S/lYt
flat	fl@t
flavor	fle/vR
flavored	fle/vRd
flavorful	fle/vR/fxl
fleas	fliz
fleet	flit
flew	flu
flicked	flIkt
flip	flIp
flipflop	flIp/flap
flipflops	flIp/flaps
flipping	flI/pIG
flips	flIps
flirting	flR/tIG
float	flot
floating	flo/tIG
floats	flots
floor	flor
floor's	florz
floors	florz
flop	flap
floppy	fla/pi
flopsy	flap/si
flouncy	flWnt/si
flour	flW/R
flow	flo
flower	flW/R
flower's	fl/WRz
flowers	flW/Rz
flowing	flo/IG
flows	floz
fluff	fl^f
fluffy	fl^/fi
fluids	flu/Idz
flush	fl^S
flutter	fl^/tR
flutters	fl^/tRz
fly	flY
flyer	flYr
flying	flY/IG
flys	flYz
flyswatter	flY/swc/tR
foam	fom
focussed	fo/k^st
fold	fold
folded	fol/dId
folding	fol/dIG
folks	foks
follow	fa/lo
followed	fa/lod
following	fa/lo/IG
follows	fa/loz
followtheleader	fa/lo/Dx/li/dR
food	fud
foods	fudz
fool	ful
fooled	fuld
fooling	fu/lIG
foot	fUt
foot's	fUts
football	fUt/bcl
footie	fU/ti
footprints	fUt/prInts
foots	fUts
footsies	fUt/siz
for	fcr
foraging	fc/rI/JIG
forbidden	fcr/bI/dxn
forced	forst
forcing	for/sIG
forehead	for/hEd
forest	fc/rIst
forever	fx/rE/vR
forget	fcr/gEt
forgets	fcr/gEts
forgetting	fcr/gE/tIG
forgive	fcr/gIv
forgot	fcr/gat
forgotten	fR/ga/txn
fork	fcrk
forks	fcrks
formal	fcr/mxl
formed	fcrmd
formula	fcr/myx/lx
formula's	fcr/myx/lxz
formulated	fcr/myx/le/tId
forsake	fcr/sek
forth	forT
fortune	fcr/CIn
forty	fcr/ti
forum	fo/rxm
forward	fcr/wRd
fossil	fc/sxl
foul	fWl
found	fWnd
foundation	fWn/de/SIn
fountain	fWn/txn
four	for
fours	forz
fourteen	for/tin
fourteen	for/tin
fourteenth	for/tinT
fourth	forT
fourths	forTs
fox	fcks
foxes	fck/sIz
frame	frem
frank	fr@Gk
frankly	fr@G/kli
freak	frik
freaking	fri/kIG
fred	frEd
freddy	frE/di
freddy's	frE/diz
free	fri
freedom	fri/dxm
freeze	friz
freezer	fri/zR
french	frEnC
fresh	frES
friction	frIk/SIn
friday	frY/de
fridge	frIJ
fried	frYd
friend	frEnd
friend's	frEndz
friendly	frEn/dli
friends	frEndz
fries	frYz
frighten	frY/txn
frightened	frY/txnd
frill	frIl
frilly	frI/li
frilly's	frI/liz
frisbee	frIz/bi
frog	frcg
frog's	frcgz
froggie	frc/gi
froggie's	frc/giz
frogs	frcgz
from	fr^m
front	fr^nt
fronts	fr^nts
frontsies	fr^nt/siz
froot	frut
frosting	frc/stIG
frosty	frcs/ti
frown	frWn
froze	froz
frozen	fro/zIn
fruit	frut
fruits	fruts
frustrated	fr^/stre/tId
frustrating	fr^/stre/tIG
frutti	fru/ti
fry	frY
frying	frY/IG
fufu@c	fu/fu
full	fUl
fumble	f^m/bxl
fun	f^n
function	f^Gk/Sxnz
functions	f^Gk/Sxnz
funniest	f^/ni/Ist
funny	f^/ni
fur	fR
furby	fR/bi
furious	fyU/ri/xs
furniture	fR/nI/CR
furry	fR/ri
further	fR/DR
fuss	f^s
fussbucket	f^s/b^/kxt
fussed	f^st
fusser	f^/sR
fussies	f^/siz
fussing	f^/sIG
fussings	f^/sIGz
fusspot	f^/spat
fussy	f^/si
futon	fu/tan
future	fyu/CR
fuzz	f^z
fuzzies	f^/ziz
fuzzy	f^/zi
g@l	Ji
gabby	g@/bi
gabby's	g@/biz
gaga	ga/ga
gail	gel
gail's	gelz
gained	gend
galleria	g@/lx/ri/x
galley	g@/li
galoshes	gx/la/SIz
game	gem
games	gemz
gap	g@p
garage	gx/raZ
garbage	gar/bIJ
garden	gar/dxn
garden's	gar/dxnz
garland	gar/lxnd
garlic	gar/lIk
garret's	gE/rEts
garrett	g@/rIt
gas	g@s
gasped	g@spt
gastroenteritis	g@/stro/En/tx/rY/tIs
gat	g@t
gate	get
gate's	gets
gates	gets
gather	g@/DR
gathered	g@/DRd
gatorade	ge/tx/red
gave	gev
gazing	ge/zIG
gear	gir
gears	girz
gee	Ji
geese	gis
gels	JElz
gene	Jin
general	JE/nR/xl
generally	JE/nR/x/li
generate	JE/nx/ret
generations	JE/nx/re/SInz
generous	JE/nR/xs
genesis	JE/nI/sIs
genie	Ji/ni
genie's	Ji/niz
genius	Ji/nyxs
gentle	JEn/txl
gentleman	JEn/txl/mxn
gently	JEnt/li
george	JcrJ
georgia	Jcr/Jx
gerber	gR/bR
gesundheit	gx/z^nd/hYt
get	gEt
getieup	gE/ti/^p
gets	gEts
getting	gE/tIG
ghetto	gE/to
ghost	gost
giant	JY/Int
gibberish	JI/bx/rIS
giddyup	gI/di/^p
gift	gIft
gifts	gIfs
gigantic	JY/g@n/tIk
giggle	gI/gxl
gigglegigglegoogaga	gI/gxl/gI/gxl/gu/ga/ga
gigglegigglegoogoo	gI/gxl/gI/gxl/gu/gu
gigglegigglegoogooga	gI/gxl/gI/gxl/gu/ga
gigglegigglegoogoogoo	gI/gxl/gI/gxl/gu/gu/gu
giggles	gI/gxlz
gigi	Zi/Zi
gigi's	Zi/Ziz
gimme	gI/mi
gimmick	gI/mIk
gimmicks	gI/mIks
ginger's	gIn/ZRz
giraffe	Jx/r@f
giraffe's	Jx/r@fs
giraffes	Jx/r@fs
girded	gR/dId
girder	gR/dR
girl	gRl
girl's	gRlz
girla	gR/lx
girlfriend	gRl/frEnd
girlie	gR/li
girls	gRlz
git	gIt
give	gIv
given	gI/vxn
giver	gI/vR
gives	gIvz
giving	gI/vIG
glad	gl@d
gladys	gl@/dIs
glass	gl@s
glasses	gl@/sIz
globe	glob
gloomy	glu/mi
glorified	glo/rI/fYd
glorify	glo/rI/fY
glorious	glo/ri/Is
glory	glo/ri
gloss	glcs
glosses	glc/sxz
glove	gl^v
gloves	gl^vz
glubglub	gl^b/gl^b
glue	glu
glued	glud
glump	gl^mp
gnat	n@t
go	go
goading	go/dIG
goal	gol
goat	got
goats	gots
gobble	ga/bxl
god	gad
god's	gadz
godmother	gad/m^/DR
gods	gadz
godzilla	gad/zI/lx
goers	go/Rz
goes	goz
goggles	ga/gxlz
going	go/IG
gold	gold
golden	gol/dIn
goldfish	gol/dfIS
goldie	gol/di
goldilocks	gol/di/laks
golf	gclf
golly	ga/li
gone	gcn
gonna	g^/nx
gonzales	gxn/za/lEs
good	gUd
goodamus	gU/dx/mxs
goodbye	gUd/bY
goodest	gU/dxst
goodness	gUd/nIs
goodnight	gUd/nYt
goody	gU/di
goof	guf
goofy	gu/fi
goofy's	gu/fiz
google	gu/gxl
googoo	gu/gu
googooeyed	gu/gu/Yd
googoogigglegaga	gu/gu/gI/gxl/ga/ga
googoogigglegagagiggle	gu/gu/gI/gxl/ga/ga/gI/gxl
googoogoggles	gu/gu/ga/gxlz
goopy	gu/pI
goose	gus
gooseberry	gus/bE/ri
goosie	gu/si
gordon	gcr/dIn
gorgeous	gcr/JIs
gorilla	gx/rI/lx
gorillas	gx/rI/lxz
gosh	gaS
got	gat
gotcha	ga/Cx
gots	gats
gotta	ga/tx
gotten	ga/txn
gown	gWn
gowns	gWnz
grab	gr@b
grabbed	gr@bd
grabbing	gr@/bIG
grabs	gr@bz
grace	gres
gracefully	gres/fx/li
gracious	gre/SIs
grade	gred
gradually	gr@/Ju/x/li
graduation	gr@/Ju/e/SIn
graham	gre/xm
grain	gren
gram	gr@m
grammatical	grx/m@/tI/kxl
grammatically	grx/m@/tI/kli
grammie	gr@/mi
grammy	gr@/mi
gramps	gr@mps
grams	gr@mz
grand	gr@nd
grandad	gr@n/d@d
grandaddy	gr@n/d@/di
granddaddy	gr@nd/d@/di
grandma	gr@/ma
grandma's	gr@nd/maz
grandmama	gr@nd/ma/mx
grandmother	gr@nd/m^/DR
grandmother's	gr@n/m^/DR
grandpa	gr@m/pa
grandpa's	gr@nd/paz
grandparents	gr@n/pE/rxnts
grandpas	gr@nd/paz
granny	gr@/ni
granny's	gr@/niz
granola	grx/no/lx
grant	gr@nt
grape	grep
grapefruit	grep/frut
grapes	greps
grasp	gr@sp
grass	gr@s
grasses	gr@/sIz
grasshopper	gr@s/ha/pR
grate	gret
grateful	gret/fxl
gratefully	gret/fx/li
grater	gre/tR
gratings	gre/tIGz
gravel	gr@/vxl
gravity	gr@/vI/ti
gravy	gre/vi
gray	gre
grayish	gre/IS
grease	gris
greasy	gri/si
great	gret
greatest	gre/tIst
greatly	gret/li
greats	grets
greece	gris
greedy	gri/di
greek	grik
green	grin
greg	grEg
gregory	grE/gx/ri
gregory's	grE/gc/riz
gretel	grE/txl
grew	gru
grey	gre
grief	grif
griffin	grI/fIn
grill	grIl
grilled	grIld
grin	grIn
grinch	grInC
grinchie	grIn/Ci
grind	grYnd
grinding	grYn/dIG
grip	grIp
grit	grIt
grits	grIts
gritty	grI/ti
groaning	gro/nIG
groceries	gro/sI/riz
grocery	gro/sI/ri
gross	gros
grouch	grWC
groucho	grW/Co
grouchy	grW/Ci
ground	grWnd
groundhog	grWnd/hcg
group	grup
groupings	gru/pIGz
grover	gro/vR
grow	gro
growing	gro/IG
growl	grWl
growled	grWld
growling	grW/lIG
grown	gron
grownups	gro/n^ps
growth	groT
grumpy	gr^m/pi
grundy	gr^n/di
grunt	gr^nt
grunted	gr^n/tId
grunting	gr^n/tIG
grunts	gr^nts
guard	gard
guards	gardz
gucci	gu/Ci
guess	gEs
guest	gEst
guests	gEsts
guide	gYd
guilty	gIl/ti
guitar	gI/tar
gum	g^m
gummies	g^/miz
gump	g^mp
gums	g^mz
gun	g^n
guns	g^nz
gus	g^s
guy	gY
guy's	gYz
guys	gYz
guzenheit@s	gE/zUn/tYt
gym	JIm
h@l	eC
ha	ha
habit	h@/bIt
habits	h@/bIts
had	h@d
hades	he/diz
hadn't	h@/dxnt
hafta	h@f/tx
hag	h@g
haha	ha/ha
hailey	he/li
hair	her
hair's	herz
hairbrush	her/br^S
haircut	her/k^t
hairdo	her/du
haired	herd
hairie	hE/ri
hairies	hEr/riz
hairs	herz
hairy	he/ri
hakunamatata@si	hx/kU/nx/mx/ta/tx
haley's	he/liz
half	h@f
halfs	h@fs
halfsister	h@f/sI/stR
halfway	h@f/we
hall	hcl
halle@si	ha/lE
hallehallehalle@si	ha/lE/ha/lE/ha/lE
hallelujah	h@/lx/lu/yx
halloween	h@/lx/win
hallway	hcl/we
halo	he/lo
ham	h@m
hamburger	h@m/bR/gR
hammer	h@/mR
hammock	h@/mxk
hand	h@nd
hand's	h@ndz
handbook	h@nd/bUk
handed	h@n/dId
handfuls	h@nd/fUlz
handicapped	h@n/di/k@pt
handing	h@n/dIG
handkerchiefs	h@G/kR/CIfs
handle	h@n/dxl
handlebars	h@n/dxl/barz
handled	h@n/dxld
handles	h@n/dxlz
handling	h@n/dx/lIG
handmedown	h@nd/mi/dWn
handmedowns	h@nd/mi/dWnz
hands	h@ndz
handsie	h@nd/zi
handsies	h@nd/ziz
handsome	h@n/sxm
handy	h@n/di
handyman	h@n/di/m@n
hang	h@G
hanger	h@/GR
hanger's	heG/gRz
hangers	h@G/Rz
hanging	h@G/IG
hangs	h@Gz
hannah	h@/nx
hannah's	h@/nxz
hansel	h@n/sxl
happen	h@/pxn
happened	h@/pxnd
happening	h@/px/nIG
happens	h@/pxnz
happiest	h@/pi/Ist
happily	h@/px/li
happiness	h@/pi/nIs
happy	h@/pi
happybirthday	h@/pi/bRT/de
hard	hard
harder	har/dR
hardest	har/dIst
hardheaded	hard/hE/dxd
hardly	hard/li
hare	her
hare's	hErz
harmful	harm/fxl
harmless	harm/lIs
harmonica	har/ma/nI/kx
harness	har/nIs
harry	h@/ri
harvard	har/vRd
harvest	har/vIst
has	h@z
hash	h@S
hasn't	h@/zInt
hassle	h@/sxl
hat	h@t
hatchling	h@CllG
hate	het
hated	he/tId
hates	hets
hats	h@ts
have	h@v
haven't	h@/vxnt
having	h@/vIG
hawk	hck
hawn	hcn
hay	he
hayley	he/li
haystack	he/st@k
haystacks	he/st@ks
hazard	h@/zRd
he	hi
he'd	hid
he'll	hil
he's	hiz
head	hEd
headache	hE/dek
headache	hE/dek
headband	hEd/b@nd
headband	hEd/b@nd
headbutt	hEd/b^t
headbutt	hEd/b^t
headbutted	hEd/b^/txd
headbutted	hEd/b^/txd
headbutting	hEd/b^/tIG
headbutting	hEd/b^/tIG
headbutts	hEd/b^ts
headbutts	hEd/b^ts
headed	hE/dId
heading	hE/dIG
headphones	hEd/fonz
headphones	hEd/fonz
heads	hEdz
heal	hil
heal	hil
heals	hilz
health	hElT
health	hElT
healthy	hEl/Ti
healthy	hEl/Ti
heap	hip
heap	hip
heaped	hipt
heaped	hipt
hear	hir
heard	hRd
hearing	hi/rIG
hearing	hi/rIG
hears	hirz
heart	hart
heart's	harts
heart's	harts
heartbeat	hart/bit
heartbeat	hart/bit
heartie	har/ti
heartie	har/ti
heat	hit
heat	hit
heated	hi/tId
heated	hi/tId
heater	hi/tR
heater	hi/tR
heater's	hi/tRz
heater's	hi/tRz
heating	hi/tIG
heating	hi/tIG
heaven	hE/vxn
heaven	hE/vxn
heavenly	hE/vxn/li
heavenly	hE/vxn/li
heavens	hE/vxnz
heavier	hE/vi/R
heavier	hE/vi/R
heavy	hE/vi
hebrews	hi/bruz
hebrews	hi/bruz
hedgehog	hEJ/hcg
hedgehog	hEJ/hcg
hedgehog's	hEJ/hagz
hedgehog's	hEJ/hagz
hee	hi
hee	hi
heel's	hilz
heel's	hilz
heels	hilz
height	hYt
height	hYt
heinie	hY/ni
heinie	hY/ni
held	hEld
helicopter	hE/lI/kap/tR
hell	hEl
hello	hE/lo
helmet	hEl/mIt
help	hElp
helped	hElpt
helper	hEl/pR
helpful	hElp/fxl
helping	hEl/pIG
helps	hElps
helter	hEl/tR
hen	hEn
henry	hEn/ri
henry's	hEn/riz
hens	hEnz
her	hR
hera	hE/rx
hercules	hR/kyx/liz
here	hir
here're	hI/rR
here's	hirz
heres	hRz
heros	hi/roz
hers	hRz
herself	hR/sElf
hey	he
heybie	he/bi
hi	hY
hicciuppies	hI/ki/^/piz
hiccihicciuppies	hI/ki/hI/ki/^/piz
hiccup	hI/kxp
hiccups	hI/kxps
hickies	hI/kiz
hickieuppies	hI/ki/^/piz
hickory	hI/kx/ri
hid	hId
hidden	hI/dxn
hide	hYd
hideandseek	hY/d@nd/sik
hiding	hY/dIG
high	hY
highchair	hY/CEr
highchairs	hY/CErz
higher	hYr
highest	hY/Ist
highfive	hY/fYv
highfives	hY/fYvz
hijklmnop@k	e/CY/Je/ke/E/lE/mE/no/pi
hike	hYk
hikers	hY/kRz
hill	hIl
hills	hIlz
him	hIm
himself	hIm/sElf
hinge	hInJ
hint	hInt
hip	hIp
hippety	hI/pE/ti
hippo	hI/po
hippopotamus	hI/px/pa/tx/mxs
hippos	hI/poz
hips	hIps
hired	hYrd
his	hIz
hisself	hIz/sElf
hit	hIt
hits	hIts
hitting	hI/tIG
hiya	hY/yx
hmm	hxm
hmmthat's	hxm/D@ts
ho	ho
hoe	ho
hog	hcg
hogging	hc/gIG
hogwash	hag/waS
hokey	ho/ki
hold	hold
holder	hol/dR
holding	hol/dIG
holds	holdz
holdup	hol/d^p
hole	hol
holes	holz
holey	ho/li
holiday	ha/lI/de
holler	ha/lR
hollering	ha/lx/rIG
holly	ha/li
hollyhock	ha/li/hak
hollywood	ha/li/wUd
holy	ho/li
home	hom
homemade	ho/med
homes	homz
homework	hom/wRk
honestly	a/nIst/li
honey	h^/ni
honey's	h^/niz
honeysuckle	h^/ni/s^/kxl
honk	hcGk
honker	haG/kR
honking	hcG/kIG
hoo@o	hu
hoochie	hu/Ci
hoochoo	hu/Cu
hood	hUd
hook	hUk
hooked	hUkt
hooking	hU/kIG
hooks	hUks
hoop	hup
hoops	hups
hooray	hU/re
hoot	hut
hop	hap
hope	hop
hoped	hopt
hopeful	hop/fxl
hopefully	hop/fx/li
hopes	hops
hophop	hap/hap
hopie	ho/pi
hoping	ho/pIG
hopped	hapt
hoppety	ha/pI/ti
hopping	ha/pIG
hoppity	ha/pI/ti
hoppy	S0/pI
hops	haps
hopscotch	hap/skaC
horn	hcrn
horner	hcr/nR
horns	hcrnz
horrible	hc/rx/bxl
horribly	hc/rx/bli
horse	hcrs
horseradish	hcrs/r@/dIS
horses	hcr/sIz
horsie	hcr/si
horsie's	hcr/siz
horsieback	hcr/sI/b@k
horsies	hcr/sIz
hose	hoz
hospital	has/pI/txl
hostas	hc/stxz
hostile	has/txl
hosts	hosts
hot	hat
hotdog	hat/dag
hotmitt	hat/mIt
hots	hats
hound	hWnd
hour	W/R
hours	W/Rz
house	hWz
housecoat	hW/skot
houses	hW/sIz
how	hW
how'd	hWd
how're	h/War
how's	hWz
however	h/WE/vR
howling	hW/lIG
hows	hWz
huber	hyu/bR
hubers	hu/bRz
hue	hyu
huff	h^f
huffed	h^ft
hug	h^g
huge	hyuJ
hugged	h^gd
hugger	h^/gR
hugging	h^/gIG
huggy	h^/gi
hugs	h^gz
huh	h^
hum	h^m
human	hyu/mxn
humming	h^/mIG
humor	hyu/mR
hump	h^mp
humpty	h^mp/ti
hundred	h^n/drId
hundreds	h^n/drIdz
hung	h^G
hungrier	h^G/gri/R
hungry	h^G/gri
hunhunh	^/n^n
hunkamunka	h^n/kx/m^G/kx
hunt	h^nt
hunting	h^n/tIG
hurley's	hR/liz
hurray	hU/re
hurried	hR/rid
hurries	hR/riz
hurry	hR/ri
hurrying	hR/ri/IG
hurt	hRt
hurting	hR/tIG
hurts	hRts
husband	h^z/bxnd
husband's	h^z/bxndz
hush	h^S
hut	h^t
hydrant	hY/drInt
hydrogen	hY/drx/JIn
hyena	hY/i/nx
hymnal	hIm/nxl
hyper	hY/pR
hypoallergenic	hY/po/@/lR/JE/nIk
i	Y
i'd	Yd
i'll	Yl
i'm	Ym
i've	Yv
i@l	Y
iago	i/a/go
ice	Ys
ichabod	I/kx/bad
icie	Y/si
icky	I/ki
icy	Y/si
idea	Y/di/x
ideas	Y/di/xz
identify	Y/dEn/tI/fY
idiot	I/di/It
if	If
ignorance	Ig/nx/rIns
ignore	Ig/nor
ignoring	Ig/no/rIG
iguana	I/gwa/nx
ijklmnop@k	Y/Je/ke/E/lE/mE/no/pi
ill	Il
illusory	I/lu/zx/ri
illustrated	I/lx/stre/tId
imaginary	I/m@/Jx/nE/ri
imagination	I/m@/JI/ne/SIn
imagine	I/m@/JIn
imagining	I/m@/JI/nIG
imitate	I/mI/tet
imitates	I/mI/tets
imitating	I/mI/te/tIG
imitative	I/mI/te/tIv
immediately	I/mi/di/It/li
implies	Im/plYz
important	Im/pcr/txnt
impossibility	Im/pa/sx/bI/lI/ti
impossible	Im/pa/sx/bxl
imposter	Im/px/stR
impressed	Im/prEst
improper	Im/pra/pR
improperly	Im/pra/pR/li
in	In
inanimate	I/n@/nx/mIt
inappropriate	I/nx/pro/pri/It
incessently	In/sE/sxnt/li
inches	In/CIz
inching	In/CIG
inchworm	InC/wRm
including	In/klu/dIG
income	In/k^m
increase	In/kris
incredible	In/krE/dx/bxl
incredibly	In/krE/dx/bli
indeed	In/did
indeedie	In/di/di
independent	In/dI/pEn/dInt
independently	In/dI/pEn/dInt/li
indestructible	In/dIs/tr^k/tx/bxl
india	In/di/x
indian	In/di/In
indians	In/di/Inz
indigo	In/dI/go
individual	In/dI/vI/Ju/xl
individuals	In/dx/vI/Jxlz
indoors	In/dorz
inexpensive	I/nEks/pEn/sIv
infant	In/fxnt
infantry	In/fxn/tri
infection	In/fEk/SIn
infections	In/fEk/SInz
infinity	In/fI/nI/ti
inflicting	In/flIk/tIG
influence	In/flu/Ins
inform	In/fcrm
informed	In/fcrmd
informing	In/fcr/mIG
informs	In/fcrmz
infrastructures	In/frx/str^k/CRz
initiated	I/nI/Si/e/tId
injuries	In/JR/iz
injury	In/Jx/ri
ink	IGk
inning	I/nIG
innocent	I/nx/sInt
innovative	I/nx/ve/tIv
input	In/pUt
inside	In/sYd
insist	In/sIst
insistent	In/sIs/tInt
insists	In/sIsts
inspire	In/spYr
instance	In/stxns
instantly	In/stInt/li
instead	In/stEd
instructions	In/str^k/SInz
instrument	In/strx/mInt
instruments	In/strx/mInts
intense	In/tEns
intent	In/tEnt
interaction	In/tR/@k/Sxn
interest	In/tx/rIst
interested	In/tx/rE/stId
interesting	In/tx/rE/stIG
internet	In/tR/nEt
interpret	In/tR/prIt
interrupt	In/tx/r^pt
into	In/tu
intrigued	In/trigd
introduced	In/trx/dust
invent	In/vEnt
invented	In/vEn/tId
investigate	In/vEs/tI/get
investigator	In/vEs/tI/ge/tR
invisible	In/vI/zx/bxl
invitation	In/vI/te/SIn
invitations	In/vI/te/Sxnz
invited	In/vY/tId
invites	In/vYts
inviting	In/vY/tIG
involved	In/valvd
involves	In/valvz
iron	Y/Rn
ironed	Yrnd
ironing	Yr/nIG
irons	Y/Rnz
irritable	I/rI/tx/bxl
irritate	I/rI/tet
irritated	I/rI/te/tId
irritates	I/rI/tets
irritating	I/rI/te/tIG
is	Iz
isaac	Y/zIk
isabel	I/zx/bxl
isaiah	Y/ze/x
island	Y/lxnd
island's	Y/lxndz
isn't	I/zInt
israel	Iz/ril
israelite	Iz/re/lYt
it	It
it'd	I/tId
it'll	I/txl
it's	Its
italian	I/t@l/yIn
italy	I/tx/li
itch	IC
itches	I/CIz
itching	I/CIG
itchy	I/Ci
items	Y/txmz
its	Its
itself	It/sElf
itsy	It/si
itty	wI/tI
ivy	Y/vi
j	Je
j's	Jez
j@l	Je
jabbering	J@/bR/IG
jack	J@k
jacket	J@/kIt
jackets	J@/kIts
jackie	J@/ki
jackrabbit	J@/kr@/bIt
jacks	J@ks
jacob	Je/kxb
jacob's	Je/kxbz
jafar	Jx/far
jafar's	Jx/farz
jail	Jel
jake	Jek
jam	J@m
james	Jemz
jammie@s	J@/mi
jammies	J@/miz
jane	Jen
jane's	Jenz
janie's	Je/niz
jar	Jar
jarred	Jard
jars	Jarz
jasmine	J@z/mIn
jaw	Jc
jaws	Jcz
jay	Je
jaylen	Je/lxn
jaylen's	Je/lxnz
jealous	JE/lIs
jeans	Jinz
jeez	Jiz
jeff	JEf
jeff's	JEfs
jeffrey	JE/fri
jeffrey's	JE/friz
jello	JE/lo
jelly	JE/li
jellyfish	JE/li/fIS
jemima	Jx/mY/mx
jeremiah	JE/rx/mY/x
jeremy	JE/rx/mi
jerk	JRk
jerome	Jx/rom
jerry	JE/ri
jesse	JE/si
jesus	Ji/zxs
jesus's	Ji/zx/sxz
jethro	JE/Tro
jewelry	Jul/ri
jewish	Ju/IS
jig	JIg
jiggety	JI/gx/ti
jiggling	JI/gx/lIG
jill	JIl
jim	JIm
jim's	JImz
jimmy	JI/mi
jingle	JIG/gxl
jingles	JIG/gxlz
jingly	JIG/gx/li
job	Jab
jodie	Jo/di
joe	Jo
joey	Jo/i
jog	Jag
jogging	Ja/gIG
john	Jan
john's	Janz
johnny	Ja/ni
johns	Janz
join	JOn
joke	Jok
joking	Jo/kIG
jolly	Ja/li
jonah	Jo/nx
jordan	Jcr/dxn
jordan's	Jcr/dxnz
jordan's	Jcr/dxnz
joseph	Jo/sIf
joshua	Ja/Su/x
joy	JO
joyful	JO/fxl
judge	J^J
judy	Ju/di
judy's	Ju/diz
jug	J^g
juggling	J^/gx/lIG
juice	Jus
juices	Ju/sIz
juicie	Ju/si
juicy	Ju/si
julia	Jul/yx
julie	Ju/li
july	JU/lY
jumble	J^m/bxl
jumbled	J^m/bxld
jump	J^mp
jumped	J^mpt
jumper	J^m/pR
jumping	J^m/pIG
jumpingjack	J^m/pIG/J@k
jumpingjacks	J^m/pIG/J@ks
jumps	J^mps
june	Jun
june's	Junz
jungle	J^G/gxl
junior	Ju/nyR
junk	J^Gk
junkajunka	J^G/kx/J^G/kx
junky	J^G/ki
just	J^st
jut	J^t
k	ke
k@l	ke
kaboom	kx/bum
kaboomie@o	kx/bu/mi
kanga	k@G/gx
kanga's	k@G/gxz
kangaroo	k@G/gx/ru
kangaroos	k@G/gx/ruz
kansas	k@n/zxs
karate	kx/ra/ti
karen	k@/rIn
karen's	kE/rxnz
kate	ket
katherine	k@/TrIn
katie	ke/ti
katy	ke/ti
kay	ke
kay's	kez
kayla	ke/lx
keaton	ki/txn
keaton's	ki/txnz
keep	kip
keeper	ki/pR
keeping	ki/pIG
keeps	kips
keisha	ki/Sx
kekek@p	ke/ke
kelly	kE/li
kelsey	kEl/si
ken	kEn
kenny	kE/ni
kept	kEpt
kerchief	kR/CIf
kerchoo	kR/Cu
ketchup	kE/Cxp
kettle	kE/txl
kevin's	kE/vInz
key	ki
key's	kiz
keyboard	ki/bord
keys	kiz
kick	kIk
kickball	kIk/bcl
kicked	kIkt
kicking	kI/kIG
kicks	kIks
kid	kId
kid's	kIdz
kiddie	kI/di
kidding	kI/dIG
kiddo	kI/do
kidney	kId/ni
kids	kIdz
kids'	kIdz
kiki	ki/ki
kill	kIl
killed	kIld
killing	kI/lIG
kills	kIlz
kim	kIm
kimani	kI/ma/ni
kind	kYnd
kinda	kYn/dx
kindly	kYn/dli
kinds	kYndz
king	kIG
king's	kIGz
kingdom	kIG/dxm
kings	kIGz
kiss	kIs
kissable	kI/sx/bxl
kissed	kIst
kisses	kI/sIz
kissie	kI/si
kissies	kI/siz
kissing	kI/sIG
kit	kIt
kitchen	kI/CIn
kite	kYt
kitten	kI/txn
kittens	kI/txnz
kitties	kI/tiz
kitty	kI/ti
kitty's	kI/tiz
kittycakes	kI/ti/keks
kittycat	kI/ti/k@t
kittycats	kI/ti/k@ts
kittykitty	kI/ti/kI/ti
kiwi	ki/wi
kleenex	kli/nEks
knack	n@k
knapsack	n@p/s@k
knee	ni
kneedeep	ni/dip
kneel	nil
kneeling	ni/lIG
knees	niz
knew	nu
knick	nIk
knife	nYf
knifes	nYfs
knob	nab
knobs	nabz
knock	nak
knocked	nakt
knocking	na/kIG
knocks	naks
knot	nat
know	no
knowledge	na/lIJ
known	non
knows	noz
knox	naks
koala	ko/a/lx
kool	kul
krista	krI/stx
kristen	krI/stIn
kristen's	krI/stxnz
kristin	krI/stxn
kungfu	k^G/fu
kwanzaa	kwan/zx
kyle	kYl
kyle's	kYlz
l	El
l@l	El
la	la
la@si	la
label	le/bxl
labels	le/bxlz
lace	les
laced	lest
laces	le/sIz
lacing	le/sIG
lack	l@k
lacking	l@/kIG
ladder	l@/dR
ladies	le/diz
lady	le/di
lady's	le/diz
ladybug	le/di/b^g
lake	lek
lamb	l@m
lambie	l@/mi
lambs	l@mz
lame	lem
lamp	l@mp
land	l@nd
landed	l@n/dId
landing	l@n/dIG
landings	l@n/dIGz
lane	len
language	l@G/gwIJ
lantern	l@n/tRn
lap	l@p
lapful	l@p/fxl
laps	l@ps
large	larJ
last	l@st
latch	l@C
latches	l@/CIz
late	let
lately	let/li
later	le/tR
latest	le/tIst
latin	l@/txn
laugh	l@f
laughed	l@ft
laughing	l@/fIG
laughs	l@fs
laundromat	lcn/drx/m@t
laundry	lcn/dri
laura	lc/rx
laura's	lc/rxz
lauren	lc/rxn
lauren's	lc/rxnz
law	lc
lawn	lcn
lawnmower	lan/mo/wR
lawrence	lc/rIns
lay	le
layed	led
laying	le/IG
lays	lez
lazy	le/zi
leader	li/dR
leading	li/dIG
leaf	lif
leafy	li/fi
leaking	li/kIG
lean	lin
leaned	lind
leaning	li/nIG
leap	lip
leaped	lipt
leaping	li/pIG
leaps	lips
learn	lRn
learned	lRnd
learning	lR/nIG
learns	lRnz
leash	liS
least	list
leave	liv
leaves	livz
leaving	li/vIG
led	lEd
ledge	lEJ
lee	li
left	lEft
leftie	lEf/ti
leftover	lEf/to/vR
leftovers	lEf/to/vRz
lefty	lEf/ti
leg	lEg
legend	lE/JInd
leggie	lE/gi
leggings	lE/gIGz
lego	lE/go
legos	lE/goz
legs	lEgz
lemme	lE/mi
lemon	lE/mxn
lemons	lE/mxnz
lena	li/nx
lena's	li/nxz
leopard	lE/pRd
less	lEs
let	lEt
let's	lEts
lets	lEts
letter	lE/tR
letters	lE/tRz
letting	lE/tIG
lettuce	lE/tIs
level	lE/vxl
lever	li/vR
levis	li/vYz
lexington	lEk/sIG/txn
library	lY/brE/ri
lick	lIk
licked	lIkt
licking	lI/kIG
licks	lIks
lid	lId
lid's	lIdz
lids	lIdz
lie	lY
lied	lYd
lies	lYz
life	lYf
lifesaver	lYf/se/vR
lifesavers	lYf/se/vRz
lift	lIft
liftie	lIf/ti
lifting	lIf/tIG
lifts	lIfts
light	lYt
light's	lYts
lightbulb	lYt/b^lb
lightbulbs	lYt/b^lbz
lighted	lY/tId
lightening	lY/tx/nIG
lighter	lY/tR
lightning	lYt/nIG
lights	lYts
lightyear	lYt/yIr
like	lYk
liked	lYkt
likely	lYk/li
likes	lYks
liking	lY/kIG
lil	lIl
lilies	lI/liz
lillian	lI/li/In
lily	lI/li
lilypad	lI/li/p@d
lima	li/mx
limbs	lImz
lime	lYm
limit	lI/mIt
limits	lI/mIts
linda	lIn/dx
lindsey's	lInd/ziz
line	lYn
lined	lYnd
linen	lI/nIn
lingo	lIG/go
lining	lY/nIG
links	lIGks
lint	lInt
lion	lY/xn
lions	lY/xnz
lip	lIp
lippie	klI/pI
lips	lIps
lipstick	lIp/stIk
liquid	lI/kwId
liquids	lI/kwIdz
lisa	li/sx
list	lIst
listen	lI/sIn
listened	lI/sInd
listening	lI/sI/nIG
listens	lI/sxnz
lists	lIsts
lit	lIt
liter	li/tR
litter	lI/tR
litters	lI/tRz
little	lI/txl
littler	lI/tx/lR
littlest	lI/tx/lIst
live	lIv
lived	lIvd
liver	lI/vR
lives	lIvz
living	lI/vIG
liz	lIz
lizard	lI/zRd
lizard's	lI/zRdz
load	lod
loads	lodz
loaf	lof
loan	lon
loans	lonz
loaves	lovz
lobster	lab/stR
lobsters	lab/stRz
lock	lak
locked	lakt
locking	la/kIG
locks	laks
log	lcg
lola	lo/lx
lollipop	la/li/pap
lollipops	la/li/paps
lolly	la/li
lolo	lo/lo
london	l^n/dxn
lonely	lon/li
lonesome	lon/sxm
long	lcG
longed	lcGd
longer	lcG/gR
longest	lcG/gIst
look	lUk
looka	lU/kx
looked	lUkt
lookee	lU/ki
lookie	lU/ki
looking	lU/kIG
lookit	lU/kIt
looks	lUks
loom	lum
looneytoons	lu/ni/tunz
loons	lunz
loop	lup
looped	lupt
loops	lups
loose	lus
loosed	lust
loosen	lu/sIn
loosens	lu/sInz
lop	lap
lopsided	lap/sY/dId
lord	lcrd
lord's	lcrdz
lordie	lcr/di
lordy	lcr/di
loren	lc/rxn
lori	lc/ri
lose	luz
loses	lu/zIz
losing	lu/zIG
lost	lcst
lot	lat
lot's	lats
lotion	lo/SIn
lots	lats
lou	lu
loud	lWd
louder	lW/dR
loudie	lW/di
love	l^v
loved	l^vd
lovely	l^v/li
lover	l^/vR
loves	l^vz
lovie	l^/vi
loving	l^/vIG
lovings	l^/vIGz
low	lo
lowed	lod
lower	lo/R
luck	l^k
luckily	l^/kI/li
lucky	l^/ki
lucy	lu/si
luggage	l^/gIJ
luggages	l^/gx/Jxz
luis	lu/Is
lujah@si	lu/yx
lump	l^mp
lumpy	l^m/pi
lunatic	lu/nI/tIk
lunatics	lu/nx/tIks
lunch	l^nC
lunchie	l^n/Ci
lunchmeat	l^nC/mit
lunchtime	l^nC/tYm
lure	lUr
luther	lu/TR
lydia	lI/di/x
lying	lY/IG
lynn	lIn
lyricists	lI/rI/sIsts
lysol	lY/scl
m	Em
m@l	Em
ma	ma
ma'am	m@m
ma@q	ma
mac	m@k
macarena	ma/kx/rE/nx
macaroni	m@/kx/ro/ni
macaroniandcheese	m@/kx/ro/ni/@nd/Ciz
macaronis	m@/kx/ro/niz
macdonald	mxk/da/nxld
macgruff	mxk/gr^f
machine	mx/Sin
machines	mx/Sinz
mad	m@d
made	med
madman	m@d/mxn
mag	m@g
magarina	m@/gx/ri/nx
magazine	m@/gx/zin
magazines	m@/gx/zinz
magba	m@g/bx
magenta	mx/JEn/tx
maggarina	m@/gx/rI/nx
maggie	m@/gi
maggie's	m@/giz
magic	m@/JIk
magical	m@/JI/kxl
magically	m@/JI/kli
magnet	m@g/nIt
magnets	m@g/nIts
mags	m@gz
magsterina	m@g/stR/I/nx
maid	med
maids	medz
mail	mel
mailbox	mel/baks
mailboxes	mel/bak/sIz
mailed	meld
mailing	me/lIG
maillady	mel/le/di
mailman	mel/m@n
mails	melz
main	men
maine	men
mainly	men/li
maintenance	men/tI/nIns
make	mek
maked	mekt
makes	meks
makeup	me/k^p
making	me/kIG
malfunction	m@l/f^Gk/SIn
malfunctioned	m@l/f^G/Cxnd
malfunctioning	m@l/f^G/Cx/nIG
malfunctions	m@l/f^G/Cxnz
mall	mcl
mallet	m@/lIt
malnutrition	m@l/nx/trI/SIn
malt	malt
malto	mal/to
mama	ma/mx
mama's	ma/mxz
mama@q	ma/mx
mamama	ma/ma/ma
mamma	ma/mx
mammals	m@/mxlz
mammy	m@/mi
mamoo@q	ma/mu
man	m@n
manage	m@/nIJ
managed	m@/nIJd
mandy	m@n/di
mandy's	m@n/diz
maneuvering	mx/nu/vx/rIG
manger	men/JR
mango	m@G/go
manipulate	mx/nIp/yx/let
manniken	m@/nI/kIn
manually	m@n/yu/x/li
many	mE/ni
map	m@p
marble	mar/bxl
march	marC
marcha	mar/Cx
marcher	mar/CR
marches	mar/CIz
marco	mar/ko
marco's	mar/koz
margaret	mar/grIt
margarine	mar/Jx/rIn
marianne's	m@/rI/@nz
marie	mx/ri
marie's	mx/riz
marigolds	mE/rI/gold
marino	mx/ri/no
mark	mark
mark	mark
marked	markt
marker	mar/kR
markers	mar/kRz
market	mar/kIt
marking	mar/kIG
marks	marks
marks	marks
marmalade	mar/mx/led
marni	mar/ni
marriage	m@/rIJ
married	m@/rid
marry	m@/ri
mars	marz
marsh	marS
marshalls	mar/Sxlz
marshmallow	mar/SmE/lo
marshmallows	marS/mE/loz
martha	mar/Tx
mary	me/ri
mary's	me/riz
mash	m@S
mashed	m@St
mashing	m@/SIG
mason	me/sIn
mass	m@s
massage	mx/saZ
massive	m@/sIv
master	m@s/tR
mastercard	m@/stR/kard
masterpieces	m@/stR/pi/sIz
mat	m@t
match	m@C
matches	m@/CIz
matching	m@/CIG
mate	met
mates	mets
material	mx/tI/ri/xl
matt	m@t
matter	m@/tR
matters	m@/tRz
matthew	m@T/yu
matthew's	m@T/yuz
mattress	m@/trIs
maura	mc/rx
maura's	mc/rxz
max	m@ks
max's	m@k/sxz
maximum	m@k/sI/mxm
may	me
maybe	me/bi
mayonnaise	me/x/nez
mayor	me/R
mcdonald	mxk/da/nxld
mcdonalds	mxk/da/nxldz
mcgregor	mx/grE/gR
mcgregor's	m^k/grE/gRz
mcmuffin	mxk/m^/fIn
me	mi
me's	miz
meadow	mE/do
meal	mil
mealtime	mil/tYm
mean	min
meaned	mind
meanie	mi/ni
means	minz
meant	mEnt
meantime	min/tYm
meanwhile	min/wYl
measure	mE/ZR
measures	mE/ZRz
measuring	mEZ/x/rIG
meat	mit
meatballs	mit/bclz
meatloaf	mit/lof
meaty	mi/ti
mechanical	mx/k@/nI/kxl
meddle	mE/dxl
meddled	mE/dxld
meddles	mE/dxlz
meddlesome	mE/dxl/sxm
meddling	mE/dx/lIG
medical	mE/di/kxl
medicine	mE/dI/sIn
medicine's	mE/dI/sInz
medium	mi/di/xm
meeko	mi/ko
meet	mit
meeting	mi/tIG
meets	mits
meg	mEg
mega	mE/gx
megablocks	mE/gx/bl^ks
megan	me/gxn
melanie	mE/lx/ni
melissa	mx/lI/sx
melon	mE/lxn
melt	mElt
meltdown	mElt/dWn
melted	mEl/tId
melting	mEl/tIG
melts	mElts
membrane	mEm/bren
meme	me/me
memee	mi/mi
memorize	mE/mx/rYz
memory	mE/mx/ri
men	mEn
mention	mEn/SIn
mentioned	mEn/Sxnd
meow	mi/W
meow@o	mi/W
merchant	mR/CInt
mercies	mR/siz
mercy	mR/si
mermaid	mR/med
merrily	mE/rI/li
mesh	mES
mess	mEs
message	mE/sIJ
messages	mE/sI/JIz
messed	mEst
messer	mE/sR
messes	mE/sIz
messing	mE/sIG
messy	mE/si
met	mEt
metal	mE/txl
method	mE/Txd
mets	mEts
mew	myu
mi@si	mi
mice	mYs
michael	mY/kxl
michael's	mY/kxlz
micies	mY/siz
mickey	mI/ki
mickey's	mI/kiz
mickie	mI/ki
micky	mI/ki
microphone	mY/krx/fon
microphone's	mY/krx/fonz
microphones	mY/krx/fonz
microwave	mY/kro/wev
middle	mI/dxl
midmorning	mId/mcr/nIG
midnight	mId/nYt
midwest	mId/wEst
might	mYt
mighty	mY/ti
mike	mYk
mike's	mYks
mikey	mY/ki
mikie	mY/ki
mile	mYl
miles	mYlz
military	mI/lI/tE/ri
milk	mIlk
milkie	mIl/ki
milkies	mIl/kiz
milky	mIl/ki
million	mI/lyIn
millions	mIl/yxnz
mimi	mi/mi
mind	mYnd
mine	mYn
minestrone	mI/nI/stro/ni
minnie	mI/ni
minnies	mI/niz
minnows	mI/noz
mint	mInt
minute	mY/nut
minutes	mI/nIts
miranda	mI/r@n/dx
mirror	mI/rR
mirrors	mI/rRz
miserable	mI/zx/rx/bxl
misery	mI/zx/ri
miss	mIs
missed	mIst
missing	mI/sIG
mission	mI/SIn
missus	mI/sIz
missy	mI/si
mistake	mIs/tek
mistaken	mIs/te/kxn
mister	mIs/tR
mistreat	mI/strit
mistress	mI/strIs
mit@l	E/mY/ti
mittens	mI/txnz
mix	mIks
mixed	mIkst
mixer	mIk/sR
mixes	mIk/sxz
mixing	mIk/sIG
mkay	xm/ke
mmhm	xm/hxm
mm	xm
mhm	xm/hxm
ohgoodness	o/gUd/nIs
mygoodness	mY/gUd/nIs
ohmygoodness	o/mY/gUd/nIs
guzenheit@snle	gx/z^nd/hYt
mms	xmz
mmm	xm
mmming	x/mIG
mmms	xmz
mo	mo
moaning	mo/nIG
moat	mot
mobile	mo/bil
mockingbird	ma/kIG/bRd
mode	mod
model	ma/dxl
modeling	ma/dx/lIG
moira	mO/rx
molar	mo/lR
mom	mam
mom'll	ma/mxl
mom's	mamz
moment	mo/mInt
moments	mo/mInts
momma	ma/mx
momma's	mc/mxz
mommies	ma/miz
mommy	ma/mi
mommy'll	ma/mi/xl
mommy's	ma/miz
moms	mamz
monday	m^n/de
money	m^/ni
moneys	m^/ni
monica	ma/nI/kx
monitor	ma/nI/tR
monkey	m^G/ki
monkey's	m^G/kiz
monkeys	m^G/kiz
monst	manst
monster	man/stR
monster's	man/stRz
monsters	man/stRz
monstrous	mans/trIs
month	m^nT
months	m^nTs
moo	mu
moo@o	mu
mooboosh	mu/buS
moocow	mu/kW
mood	mud
moody	mu/di
mookaboosh	mu/kx/buS
moomoo	mu/mu
moomooshas	mu/mu/Sxz
moon	mun
moonlight	mun/lYt
moose	mus
moosh	muS
mooshaboosh	mu/Sx/buS
mooshaboosha	mu/Sx/bu/Sx
mooshabooshas	mu/Sx/bu/Sxz
mooshas	mu/Sxz
mooshasboosh	mu/Sxz/buS
mooshboosh	muS/buS
mooshbooshas	muS/bu/Sxs
mooshieboosh	mu/Si/buS
mooshiebooshas	mu/Si/bu/Sxz
mooshmoosh	mu/SmuS
mooski	mu/ski
mootas	mu/txz
mootash	mu/t@S
mootie	mu/ti
mootieboosh	mu/ti/buS
mootiebooshas	mu/ti/bu/Sxz
mootiemoo	mu/ti/mu
mootiemooshas	mu/ti/mu/Sxz
mop	map
mopped	mapt
moppet	ma/pxt
mopping	ma/pIG
mops	maps
mopsy	map/si
more	mor
morgan	mor/gIn
morgan's	mor/gInz
morgie	mcr/gi
morgie's	mcr/giz
morning	mor/nIG
moses	mo/zIz
mosquito	mxs/ki/to
mosquitos	mx/ski/toz
moss	mcs
most	most
mostest	mo/stEst
mostly	mos/tli
mother	m^/DR
mother's	m^/DRz
motherland	m^/DR/l@nd
mothers	m^/DRz
moths	mcDz
motive	mo/tIv
motor	mo/tR
motorbike	mo/tR/bYk
motorcycle	mo/tR/sY/kxl
mount	mWnt
mountain	mWn/txn
mountains	mWn/txnz
mountaintop	mWn/txn/tap
mouse	mWs
mouse's	mW/sxz
mouses	mW/sIz
mousie	mW/si
mouth	mWT
mouthful	mWT/fxl
mouthie	mW/Ti
mouthing	mW/DIG
mouthpiece	mWT/pis
mouths	mWTs
move	muv
moved	muvd
movement	muv/mInt
movements	muv/mEnts
moves	muvz
movie	mu/vi
movies	mu/viz
moving	mu/vIG
mow	mo
mower	mo/R
mowing	mo/IG
ms	mIz
much	m^C
mud	m^d
muddy	m^/di
mufasa	mu/fa/sx
muffet	m^/fxt
muffin	m^/fIn
muffins	m^/fInz
mug	m^g
mugs	m^gz
mulan	mu/lan
mulberry	m^l/bE/ri
mules	myulz
multicolored	m^l/ti/k^/lRd
multiple	m^l/tI/pxl
multitalented	m^l/ti/t@/lxn/txd
mum	m^m
mumbling	m^m/blIG
mummy	m^/mi
munch	m^nC
munchkin	m^nC/kIn
muppet	m^/pIt
muppets	m^/pIts
murphy	mR/fi
muscleman	m^/sxl/m@n
muses	myu/zIz
museum	myu/zi/xm
mush	m^S
mushed	m^St
mushing	m^/SIG
mushroom	m^/Srum
mushrooms	m^S/rumz
mushy	m^/Si
music	myu/zIk
musical	myu/zI/kxl
muskrats	m^/skr@ts
must	m^st
mustache	m^/st@S
mustard	m^s/tRd
mustn't	m^/sxnt
mutilate	myu/tx/let
my	mY
myself	mY/sElf
mystery	mIs/tx/ri
n	En
n@l	En
nah	nR
nail	nel
nails	nelz
naked	ne/kId
nala	na/lx
name	nem
name's	nemz
named	nemd
names	nemz
naming	ne/mIG
nan	n@n
nan's	n@nz
nana	n@/nx
nana's	na/nxz
nananana	na/nx/na/nx
nap	n@p
napkin	n@p/kIn
napkins	n@p/kInz
nappie	n@/pi
nappies	n@/piz
napping	n@/pIG
nappy	n@/pi
naps	n@ps
naptime	n@p/tYm
nas	naz
nasty	n@s/ti
nathan	ne/Txn
nation	ne/SIn
nations	ne/SInz
natural	n@/Cx/rxl
naturally	n@C/rx/li
naughty	nc/ti
nautilus	nc/tI/lxs
navigate	n@/vI/get
navy	ne/vi
near	nir
nearby	nir/bY
nearer	ni/rR
nearly	nir/li
neat	nit
neatest	ni/tIst
neatly	nit/li
neato	ni/to
necessarily	nE/sx/sE/rx/li
necessary	nE/sI/sE/ri
neck	nEk
necklace	nEk/lIs
necklaces	nE/klI/sIz
neckties	nEk/tYz
ned	nEd
need	nid
needed	ni/dId
needing	ni/dIG
needle	ni/dxl
needs	nidz
negative	nE/gx/tIv
neglecting	nx/glEk/tIG
neigh	ne
neighbor	ne/bR
neighbor's	ne/bRz
neighborhood	ne/bR/hUd
neighborly	ne/bR/li
neighbors	ne/bRz
neither	ni/DR
nellie	nE/li
neon	ni/an
nephew	nE/fyu
nephew's	nE/fyuz
nerve	nRv
nerves	nRvz
nervous	nR/vxs
nest	nEst
nesting	nE/stIG
nests	nEsts
net	nEt
neuter	nu/tR
neutral	nu/trxl
never	nE/vR
new	nu
newborns	nu/bcrnz
newport	nu/port
news	nuz
newspaper	nuz/pe/pR
newt	nut
next	nEkst
nibbled	nI/bxld
nice	nYs
nicely	nY/sli
nicer	nY/sR
nick	nIk
nickel	nI/kxl
nickelodeon	nI/kx/lo/di/In
nicole	nI/kol
niece	nis
nigerians	nY/JI/ri/Inz
night	nYt
night's	nYts
nightgown	nYt/gWn
nightgowns	nYt/gWnz
nightie	nY/ti
nightlight	nYt/lYt
nightmare	nYt/mEr
nightnight	nYt/nYt
nights	nYts
nightshirt	nYt/SRt
nighttime	nYt/tYm
nilly	nI/li
nine	nYn
nineteen	nYn/tin
ninety	nYn/ti
ninja	nIn/Jx
nino	ni/no
ninth	nYnT
nipple	nI/pxl
nixie	nIk/sI
no	no
noah	no/x
noah's	no/xz
noba@c	no/bx
nobody	no/bx/di
nobody's	no/bx/diz
nodded	na/dId
nodding	na/dIG
noggin	na/gIn
noise	nOz
noises	nO/zIz
noisy	nO/zi
none	n^n
nonexistent	na/nIg/zI/stxnt
nono	no/no
nonono@si	no/no/no
nononoing	no/no/no/IG
noodle	nu/dxl
noodles	nu/dxlz
nookcase@n	nU/kes
noontime	nun/tYm
nope	nop
nopes	nops
nopie	no/pi
nor	ncr
normal	ncr/mxl
normally	ncr/mx/li
north	ncrT
nose	noz
nosed	nozd
nosedives	noz/dYvz
noses	no/zIz
nosey	n@U/zI
nosie	no/zi
not	nat
note	not
notes	nots
nothing	n^/TIG
nothing's	n^/TIGz
notice	no/tIs
noticed	no/tIst
notices	no/tI/sIz
noticing	no/tI/sIG
novelty	na/vxl/ti
november	no/vEm/bR
now	nW
nowhere	no/wer
nudieper	nu/di/pR
nudist	nu/dIst
nugget	n^/gIt
nuggets	n^/gIts
nuhuh	n^/^
nuisance	nu/sIns
num	n^m
number	n^m/bR
numbers	n^m/bRz
nummies	n^/miz
nummy	n^/mi
numnum	n^m/n^m
nurse	nRs
nursery	nR/sx/ri
nurses	nR/sIz
nursing	nR/sIG
nut	n^t
nutcracker	n^t/kr@/kR
nutrient	nu/tri/Int
nutritional	nu/trI/SI/nxl
nutritious	nu/trI/SIs
nuts	n^ts
nutty	n^/ti
o	o
o'clock	x/klak
o'clocker	o/kla/kR
o'clocks	x/klaks
o@l	o
o@l-s	o
oatmeal	ot/mil
oats	ots
obedient	o/bi/di/Int
obekaybe	o/bi/ke/bi
obey	o/be
obi	o/bi
obi's	o/biz
obie	o/bi
objects	ab/JIks
observed	xb/zRvd
observing	xb/zR/vIG
obsessed	xb/sEst
obtained	xb/tend
obvious	ab/vi/xs
obviously	ab/vi/I/sli
occasion	x/ke/ZIn
occasionally	x/keZ/x/nxl
occurred	x/kRd
ocean	o/SIn
octagon	ak/tx/gan
october	ak/to/bR
octopi	ak/tx/pY
octopus	ak/tx/pxs
odd	ad
of	^v
off	cf
off@n	af
offensive	x/fEn/sIv
offer	c/fR
offered	c/fRd
offers	c/fRz
offhand	cf/h@nd
office	c/fIs
official	x/fI/Sxl
officially	x/fI/Sx/li
often	c/fxn
oh	o
ohio	o/hY/o
oil	Ol
oiled	Old
oink	OGk
oink@o	OGk
oinkoink	OG/kOGk
ointment	On/tmInt
ok	o/ke
okay	o/ke
okeydokey	o/ki/do/ki
old	old
olden	ol/dxn
older	ol/dR
olive	a/lIv
olives	a/lIvz
olivia	o/lI/vi/x
omega	o/mE/gx
on	an
once	w^ns
one	w^n
one's	w^nz
ones	w^nz
onesie	w^n/si
onie	w^/ni
onion	^/nyxn
onions	^n/yxnz
online	an/lYn
only	on/li
onsie	w^n/si
onsies	w^n/siz
onto	an/tu
oop	up
oops	ups
oopsadaisy	up/sx/de/zi
oopsadaisys	up/sx/de/ziz
oopsie	up/si
oopsiedoozies	up/si/du/ziz
oopsiedoozy	up/si/du/zi
oopsies	up/ziz
op@c	ap
open	o/pxn
opened	o/pxnd
opener	o/px/nR
opening	o/px/nIG
opens	o/pxnz
operation	a/px/re/Sxn
operator	a/px/re/tR
opinion	x/pI/nyIn
opportunity	a/pR/tu/nI/ti
opposed	x/pozd
opposite	a/px/zIt
opposites	a/px/zIts
option	apCG
options	ap/SInz
or	cr
orange	c/rInJ
oranges	c/rIn/JIz
orangish	c/rIn/JIS
orangutan	c/r@G/gx/t@n
order	cr/dR
ordered	cr/dRd
ordering	cr/dx/rIG
orderly	cr/dR/li
ordinary	crd/nx/ri
organize	cr/gx/nYz
organized	cr/gx/nYzd
originally	x/rI/Jx/nx/li
orioles	o/ri/olz
ornaments	cr/nx/mInts
orphan	cr/fxn
orthodontic	cr/Tx/dan/tIk
orthodontics	cr/Tx/dan/tIks
orthodontist	cr/Tx/dan/tIst
orthodontist's	cr/Tx/dan/tIsts
orthodontists	cr/Tx/dan/tIsts
oscar	a/skR
oscar's	a/skRz
ostrich	as/trIC
otay	o/te
other	^/DR
others	^/DRz
otherwise	^/DR/wYz
ouch	WC
ouchie	W/Ci
ouchies	W/Ciz
ought	ct
oughtta	c/tx
ounce	Wns
ounces	Wn/sIz
our	W/R
ours	W/Rz
ourself	ar/sElf
out	Wt
outdoor	Wt/dcr
outdoors	Wt/dcrz
outer	W/tR
outfit	Wt/fIt
outgrown	Wt/gron
outlaw	Wt/lc
outlet	Wt/lEt
outlets	Wt/lEts
outrageous	Wt/re/JIs
outside	Wt/sYd
outtalk	Wt/tck
oval	o/vxl
oven	^/vxn
over	o/vR
overalls	o/vR/clz
overboard	o/vR/bord
overflow	o/vR/flo
overflowing	o/vR/flo/IG
overload	o/vR/lod
overnight	o/vR/nYt
overtime	o/vR/tYm
overzealous	o/vR/zE/lxs
ow	W
owe	o
owie	Wi
owl	Wl
owl's	Wxlz
owls	Wlz
own	on
owned	ond
owner	o/nR
owowow@o	W/WW
oyster	Os/tR
p	pi
p@l	pi
pacie	pe/si
pacifier	p@/si/fYr
pacifiers	p@/sI/fYrz
pack	p@k
package	p@/kIJ
packages	p@/kx/Jxz
packed	p@kt
packet	p@/kIt
packing	p@/kIG
packs	p@ks
pad	p@d
pad's	p@dz
paddy	p@/di
page	peJ
paged	peJd
pager	pe/JR
pages	pe/JIz
paging	pe/JIG
paid	ped
pail	pel
pain	pen
painful	pen/fxl
paint	pent
painted	pen/tId
painting	pen/tIG
pair	per
pairs	perz
pajama	px/Ja/mx
pajamaies	px/ja/mxz
pajamas	px/Ja/mxz
pal	p@l
palace	p@/lIs
paly	pe/li
pamper	p@m/pR
pamper's	p@m/pRz
pampers	p@m/pRz
pan	p@n
pancake	p@n/kek
pancakes	p@n/keks
panda	p@n/dx
panicked	p@/nIkt
pans	p@nz
pant	p@nt
panther	p@n/TR
panties	p@n/tiz
panting	p@n/tIG
pantry	p@n/tri
pants	p@nts
pantsie	p@nt/si
pantsies	p@nt/siz
papa	pa/px
papaya	px/pY/x
paper	pe/pR
papers	pe/pRz
paperwork	pe/pR/wRk
papou	px/pu
parade	px/red
parading	px/re/dIG
paranoid	p@/rx/nOd
parcheesi	par/Ci/zi
pardon	par/dxn
parents	p@/rInts
parents's	pE/rEnt/sxz
park	park
parked	parkt
parkie	par/ki
parlor	par/lR
parrot	p@/rIt
parsnipie	par/snI/pi
parsnips	par/snIps
part	part
participate	par/tI/sI/pet
particular	pR/tI/kyx/lR
particularly	pR/tI/kyx/lR/li
parting	par/tIG
partner	part/nR
parts	parts
party	par/ti
pass	p@s
passed	p@st
passenger	p@/sIn/JR
passes	p@/sIz
passing	p@/sIG
password	p@/swRd
past	p@st
pasta	pa/stx
paste	pest
pasty	pes/ti
pat	p@t
patch	p@C
patched	p@Ct
patches	p@/CIz
patching	p@/CIG
patchy	p@/Ci
path	p@T
patience	pe/SIns
patient	pe/SInt
patients	pe/SInts
patio	p@/ti/o
patrice	px/tris
patrick	p@/trIk
patricks	p@/triks
pats	p@ts
patted	p@/tId
patterns	p@/tRnz
patting	p@/tIG
patty	p@/ti
pattycake	p@/ti/kek
pattycaking	p@/ti/ke/kIG
pattytake	p@/ti/tek
paul	pcl
paul's	pclz
paula	pc/lx
pause	pcz
paused	pczd
pausing	pc/zIG
pavement	pev/mInt
pavilioned	px/vIl/yxnd
paw	pc
paws	pcz
pay	pe
paycheck	pe/CEk
payed	ped
paying	pe/IG
payment	pe/mInt
payments	pe/mxnts
payperview	pe/pR/vyu
pea	pi
peace	pis
peaceful	pis/fxl
peach	piC
peaches	pi/CIz
peanut	pi/n^t
peanutbutter	pi/n^t/b^/tR
peanuts	pi/n^ts
pear	per
pearie	pE/ri
pearl	pRl
pearly	pR/li
pears	perz
peary	pi/ri
peas	piz
pedals	pE/dxlz
pedialyte	pi/di/x/lYt
pee	pi
peed	pid
peeing	pi/IG
peek	pik
peeka	pi/kx
peekaboo	pi/kx/bu
peeks	piks
peel	pil
peeled	pild
peeling	pi/lIG
peels	pilz
peep	pip
peeped	pipt
peepee	pi/pi
peepees	pi/piz
peeping	pi/pIG
peers	pIrz
pees	piz
peeyou	pi/yu
peeyoustinky	pi/yu/stIG/ki
peg	pEg
pegasus	pE/gx/sIs
pegger	pE/gR
peggie	pE/gi
pegs	pEgz
pen	pEn
pencil	pEn/sxl
pencils	pEn/sxlz
penguin	pEG/gwIn
penguins	pEGg/wInz
penney	pE/ni
pennies	pE/niz
penny	pE/ni
pens	pEnz
pentagon	pEn/tx/gan
peonies	pi/x/niz
peony	pi/x/ni
people	pi/pxl
people's	pi/pxlz
pepe	pe/pe
pepper	pE/pR
pepper's	pE/pRz
peppers	pE/pRz
pepsi	pEp/si
per	pR
percent	pR/sEnt
perfect	pR/fEkt
perfectly	pR/fIkt/li
perform	pR/fcrm
performed	pR/fcrmd
performer	pR/fcr/mR
performing	pR/fcr/mIG
performs	pR/fcrmz
perfume	pR/fyum
perhaps	pR/h@ps
period	pI/ri/xd
permission	pR/mI/SIn
peroxide	px/rak/sYd
perpendicular	pR/pxn/dI/kyx/lR
persistent	pR/sIs/tInt
person	pR/sIn
person's	pR/sxnz
personal	pR/sI/nxl
personality	pR/sI/n@/lI/ti
personnel	pR/sI/nEl
perspective	pR/spEk/tIv
perspiration	pRs/px/re/SIn
pesky	pEs/ki
pester	pE/stR
pet	pEt
petal	pE/txl
petals	pE/txlz
pete	pit
peter	pi/tR
peter's	pi/tRz
pets	pEts
petted	pE/tId
petting	pE/tIG
phil	fIl
phillip	fI/lIp
philosophy	fI/la/sx/fi
phone	fon
phone's	fonz
phones	fonz
phonics	fa/nIks
phony	fo/ni
photo	fo/to
photogenic	fo/tx/JE/nIk
photographic	fo/tx/gr@/fIk
photosynthesis	fo/to/sIn/Tx/sIs
phrase	frez
piano	pi/@/no
picachu	pi/ka/Cu
pick	pIk
picked	pIkt
picking	pI/kIG
pickle	pI/kxl
pickles	pI/kxlz
picks	pIks
picky	pI/ki
picnic	pIk/nIk
picnics	pIk/nIks
picture	pIk/CR
pictures	pIk/CRz
pie	pY
piece	pis
pieces	pi/sIz
pies	pYz
pig	pIg
pigeon	pI/JIn
pigeons	pI/JInz
piggie	pI/gi
piggies	pI/giz
piggy	pI/gi
piggy's	pI/giz
piglet	pIg/lIt
piglet's	pI/glEts
piglets	pI/glIts
pigpen	pIg/pEn
pigs	pIgz
pigtail	pIg/tel
pike	pYk
pile	pYl
piles	pYlz
pillow	pI/lo
pillows	pI/loz
pin	pIn
pina	pin/yx
pinch	pInC
pinched	pInCt
pinchie	pIn/Ci
pinching	pIn/CIG
pine	pYn
pineapple	pY/n@/pxl
pineapples	pY/n@/pxlz
pinecones	pYn/konz
pink	pIGk
pinkie	pIG/ki
pinky	pI9/kI
pinnochio	pI/no/ki/o
pins	pInz
pinto	pIn/to
pipe	pYp
piper's	pY/pRz
piping	pY/pIG
pipsqueak	pIp/skwik
pissant@n	pI/s@nt
pissy	pI/si
pit	pIt
pitched	pICt
pitcher	pI/CR
pitiful	pI/tI/fxl
pizza	pit/sx
pjs	pi/Jez
place	ples
placed	plest
places	ple/sIz
plain	plen
plainly	plen/li
plan	pl@n
plane	plen
planet	pl@/nIt
planing	ple/nIG
plant	pl@nt
planted	pl@n/tId
plants	pl@nts
plastic	pl@s/tIk
plate	plet
plates	plets
platinum	pl@/tI/nxm
platter	pl@/tR
play	ple
played	pled
player	ple/R
playful	ple/fxl
playground	ple/grWnd
playgroup	ple/grup
playhouse	ple/hWs
playing	ple/IG
playoffs	ple/cfs
playpen	ple/pEn
playpenie	ple/pE/ni
playroom	ple/rum
plays	plez
playtex	ple/tEks
playtime	ple/tYm
pleasant	plE/zInt
please	pliz
pleased	plizd
pleasure	plEZ/R
plenty	plEn/ti
plop	plap
plops	plaps
plow	plW
plug	pl^g
plugged	pl^gd
plugs	pl^gz
plum	pl^m
plums	pl^mz
plunged	pl^nJd
plus	pl^s
pluto	plu/to
pochahontas	po/kx/han/txs
pocket	pa/kIt
pocketbook	pa/kIt/bUk
pockets	pa/kIts
pod	pad
point	pOnt
pointed	pOn/tId
pointer	pOn/tR
pointers	pOn/tRz
pointing	pOn/tIG
points	pOnts
pointy	pOn/ti
poison	pO/zIn
poisonous	pOz/In/Is
poke	pok
pokecenter	pok/sEn/tR
poked	pokt
pokefood	pok/fud
pokemon	po/ki/man
pokes	poks
pokey	po/ki
pokie	po/ki
poking	po/kIG
polar	po/lR
pole	pol
poles	polz
police	px/lis
policeman	px/lis/mxn
policy	pa/lI/si
polish	pa/lIS
polished	pa/lISt
polishes	pa/lI/Sxz
polishing	pa/lI/SIG
polite	px/lYt
politely	px/lYt/li
polkadot	pol/kx/dat
polo	po/lo
polyester	pa/li/E/stR
pond	pand
pony	po/ni
ponytail	po/ni/tel
poo	pu
poo's	puz
poodle	pu/dxl
pooh	pu
pooh's	puz
poohs	puz
pooie	pu/i
pookie	pu/ki
pool	pul
poop	pup
poopie	pu/pi/e
poopied	pu/pId
poopies	pu/pIz
pooping	pu/pIG
poopoo	pu/pu
poopoos	pu/puz
poops	pups
poopsie	pup/si
poopsie^boo	pup/si/bu
poopsieboo	pup/si/bu
poor	pUr
poos	puz
pop	pap
popbeads	pap/bidz
popcorn	pap/kcrn
popeye	pa/pY
popped	papt
poppetypoppoppop	pa/pE/ti/pap/pap/pap
popping	pa/pIG
poppy	pa/pi
popsicle	pap/sI/kxl
popular	pa/pyx/lR
popup	pa/p^p
porch	porC
porcupine	pcr/kyx/pYn
porridge	pc/rIJ
portfolio	port/fo/li/o
porthole	port/hol
pose	poz
poser	po/zR
posies	po/ziz
position	px/zI/SIn
positive	pa/zI/tIv
possible	pa/sx/bxl
possibly	pa/sx/bli
possums	pa/sxmz
post	post
posted	po/stxd
poster	pos/tR
posting	po/stIG
posts	posts
posy	po/zi
pot	pat
potato	px/te/to
potatos	px/te/toz
potent	po/txnt
potholder	pat/hol/dR
potpourri	po/pU/ri
pots	pats
potted	pa/tId
potter	pa/tR
potty	pa/ti
pottytrain	pa/ti/tren
pouch	pWC
pouches	pW/Cxz
pouncy	pWnt/si
pound	pWnd
pounding	pWn/dIG
pounds	pWndz
pour	por
poured	pord
pouring	po/rIG
pours	porz
pouting	pW/tIG
pouty	pW/ti
pow	pW
powder	pW/dR
powells	pWlz
power	pW/R
powerful	pW/R/fxl
practically	pr@k/tI/kli
practice	pr@k/tIs
practicing	pr@k/tI/sIG
prairie	pre/ri
praise	prez
praised	prezd
pray	pre
prayer	prer
prayers	prerz
precious	prE/SIs
precisely	prI/sY/sli
prefer	prI/fR
prefers	prI/fRz
pregnant	prEg/nInt
prehistoric	pri/hI/stc/rIk
premiums	pri/mi/xmz
preparation	prE/px/re/SIn
prepare	prI/pEr
preschool	pri/skul
prescription	prIs/krIp/SIn
prescriptions	prI/skrIp/SInz
presence	prE/zIns
present	prE/zInt
presents	prE/zInts
preserver	prI/zR/vR
press	prEs
pressed	prEst
pressing	prE/sIG
pressure	prE/SR
pretend	prI/tEnd
pretending	prI/tEn/dIG
prettier	prI/ti/R
pretties	prI/tiz
pretty	prI/ti
pretzel	prEt/sxl
pretzels	prEt/sxlz
prevents	prx/vEnts
price	prYs
prick	prIk
pricked	prIkt
prickly	prIk/li
primarily	prY/mE/rx/li
primary	prY/mE/ri
prime	prYm
prince	prIns
princess	prIn/sEs
principle	prIn/sI/pxl
printed	prIn/tId
prior	prY/R
priority	prY/c/rI/ti
private	prY/vxt
privilege	prI/vx/lIJ
prize	prYz
pro	pro
probably	pra/bx/bli
problem	prab/lxm
problems	pra/blxmz
procedure	prx/si/JR
process	pra/sEs
produce	pra/dus
produced	prx/dust
product	pra/dxkt
products	pra/dxkts
professor	prx/fE/sR
profiling	pro/fY/lIG
program	pro/gr@m
project	pra/JEkt
projects	pra/JEkts
promise	pra/mIs
promised	pra/mIst
promises	pra/mI/sIz
promote	prx/mot
pronunciation	prx/n^n/si/e/Sxn
proof	pruf
propeller	prx/pE/lR
proper	pra/pR
properly	pra/pR/li
protect	prx/tEkt
protected	prx/tEk/tId
protecting	prx/tEk/tIG
protection	prx/tEk/SIn
protein	pro/tin
protest	pro/tEst
protesting	prx/tE/stIG
proud	prWd
prove	pruv
provider	prx/vY/dR
proving	pru/vIG
prowl	prWl
prunes	prunz
psalm	sam
psalms	samz
psghettios	p/skE/ti/oz
psycho	sY/ko
publish	p^b/lIS
pucker	p^/kR
puckering	p^/kx/rIG
pudding	pU/dIG
puddle	p^/dxl
puddleduck	p^/dxl/d^k
puddles	p^/dxlz
puddy	p^/di
puff	p^f
puffed	p^ft
pull	pUl
pulled	pUld
pulling	pU/lIG
pullover	pU/lo/vR
pulls	pUlz
pumba	pum/bx
pump	p^mp
pumpkin	p^m/pkIn
pumpkins	p^mp/kInz
punch	p^nC
punishment	p^/nIS/mInt
punkin	p^G/kIn
punky	p^G/ki
pup	p^p
puppet	p^/pIt
puppets	p^/pIts
puppies	p^/piz
puppy	p^/pi
puppy's	p^/piz
puppydog	p^/pi/dcg
pups	p^ps
purchase	pR/CIs
purifier	pyU/rI/fYr
purple	pR/pxl
purpose	pR/pxs
purr	pR
purse	pRs
push	pUS
pushed	pUSt
pushes	pU/SIz
pushing	pU/SIG
pushovers	pU/So/vRz
pussycat	pU/si/k@t
put	pUt
puts	pUts
putted	p^/tId
putting	p^/tIG
puzzle	p^/zxl
puzzles	p^/zxlz
q@l	kyu
qrs@k	kyu/a/rEs
quack	kw@k
quackeroo	kw@/kx/ru
quacking	kw@/kIG
quackquack	kw@k/kw@k
quail	kwel
quails	kwelz
quality	kwa/lI/ti
quarrel	kwc/rxl
quarter	kwcr/tR
quarters	kwcr/tRz
quasimodo	kwa/zi/mo/do
queeka	kwi/kx
queekie	kwi/ki
queekiemoo	kwi/ki/mu
queekola	kwi/ko/lx
queekster	kwik/stR
queen	kwin
quesadillas	kE/sx/di/yxz
question	kwEs/CIn
questionable	kwEs/Cx/nx/bxl
questioning	kwEs/CI/nIG
quick	kwIk
quickly	kwI/kli
quiet	kwY/It
quieter	kwY/I/tR
quietly	kwY/It/li
quietness	kwY/It/nIs
quilt	kwIlt
quilts	kwIlts
quincy	kwIn/si
quit	kwIt
quite	kwYt
quitter	kwI/tR
quiver	kwI/vR
quivering	kwI/vx/rIG
quiz	kwIz
quizzed	kwIzd
quote	kwot
r	ar
r@l	ar
rabbit	r@/bIt
rabbit's	r@/bIts
rabbits	r@/bIts
raccoon	r@/kun
raccoon's	r@/kunz
raccoons	r@/kunz
race	res
raced	rest
races	re/sIz
raceway	re/swe
racing	re/sIG
radiator	re/di/e/tR
radio	re/di/o
radio's	re/di/oz
radios	re/di/oz
radish	r@/dIS
rag	r@g
raggedy	r@/gI/di
rags	r@gz
rahab	rx/hab
rail	rel
railing	re/lIG
railroad	re/lrod
rain	ren
rainbow	ren/bo
raincoat	ren/kot
raindrops	ren/draps
rained	rend
raineth	re/nIT
raining	re/nIG
rains	renz
rainy	re/ni
raise	rez
raisin	re/zIn
raisinbran	re/zIn/br@n
raising	re/zIG
raisins	re/zInz
rake	rek
ram	r@m
ramble	r@m/bxl
rambling	r@m/bx/lIG
ramen	ra/mxn
ramshacking	r@m/S@/kIG
ran	r@n
ranch	r@nC
rang	r@G
range	renJ
rap	r@p
rap's	r@ps
rapped	r@pt
rapping	r@/pIG
raps	r@ps
rarely	rEr/li
rascal	r@s/kxl
rash	r@S
rashes	r@/SIz
raspberry	r@z/bE/ri
rat	r@t
rather	r@/DR
rats	r@ts
rattle	r@/txl
rattles	r@/txlz
rattly	r@t/li
raven	re/vxn
ravens	re/vInz
ray	re
raying	re/IG
raymond	re/mxnd
rays	rez
razor	re/zR
re@si	re
reach	riC
reached	riCt
reaches	ri/CIz
reaching	ri/CIG
react	ri/@kt
read	rEd
reading	rE/dIG
reads	ridz
ready	rE/di
real	ril
realistic	ri/x/lI/stIk
realize	ri/x/lYz
realized	ri/x/lYzd
really	ri/x/li
reapplied	ri/a/plYd
rear	rir
rearrange	ri/x/renJ
rearranged	ri/^/renJd
rearranges	ri/^/ren/Jxz
rearranging	ri/x/ren/JIG
reason	ri/zIn
reassured	ri/x/SUrd
reattach	ri/x/t@C
rebuild	ri/bIld
receipt	rI/sit
receipts	rI/sits
receive	rI/siv
received	rI/sivd
receiver	rI/si/vR
receives	rI/sivz
receiving	rI/si/vIG
recently	ri/sxnt/li
recharges	ri/Car/Jxz
recite	rI/sYt
recognize	rE/kxg/nYz
recognizes	rE/kxg/nY/zIz
recognizing	rE/kxg/nY/zIG
recommended	rE/kx/mEn/dId
record	rE/kRd
recorded	rI/kcr/dId
recorder	rI/kcr/dR
recorder's	rE/kcr/dRz
recordie	rE/kcr/di
recording	rI/kcr/dIG
recordings	rI/kcr/dIGz
records	rE/kRdz
recovered	rI/k^/vRd
rectangle	rEk/t@G/gxl
recyclable	rI/sY/klx/bxl
recycling	rI/sY/kx/lIG
red	rEd
redhead	rEd/hEd
redid	ri/dId
redo	ri/du
reference	rE/frxns
refill	ri/fIl
reflection	rI/flEk/SIn
refraction	rI/fr@k/SIn
refrigerant	rI/frI/Jx/rInt
refrigerator	rI/frI/Jx/re/tR
refuge	rE/fyuJ
refused	rI/fyuzd
regarding	rI/gar/dIG
reggie	rE/Ji
register	rE/JIs/tR
registered	rE/JI/stRd
registering	rE/JI/stR/IG
registers	rE/JI/stRz
regressing	rI/grE/sIG
regular	rE/gyx/lR
regularly	rEg/yx/lR/li
regulate	rE/gyx/let
regurgitated	rI/gR/JI/te/tId
reindeer	ren/dir
rejected	rI/JEk/tId
rejoice	rI/JOs
relate	rI/let
related	rx/le/tId
relationship	rI/le/Sxn/SIp
relax	rx/l@ks
relaxed	rx/l@kst
relaxing	rx/l@k/sIG
relay	ri/le
released	rx/list
relieves	rx/livz
religious	rx/lI/JIs
relocate	ri/lo/ket
remco	rEm/ko
remedy	rE/mx/di
remember	rx/mEm/bR
remembered	rx/mEm/bRd
remembers	rx/mEm/bRz
remifasolatido@si	rE/mi/fa/so/la/ti/do
remind	rx/mYnd
reminded	rI/mYn/dId
reminding	rx/mYn/dIG
reminds	rx/mYndz
remote	rx/mot
remove	rx/muv
removed	rx/muvd
renewed	rI/nud
rent	rEnt
rented	rEn/txd
renting	rEn/tIG
rents	rEnts
repaint	ri/pent
repairman	rI/per/m@n
repeat	rI/pit
repeated	rI/pi/tId
repeating	rI/pi/tIG
repetition	rE/pI/tI/Sxn
replace	rI/ples
replant	ri/pl@nt
replied	rI/plYd
reply	rI/plY
report	rI/port
reported	rI/por/tId
repot	ri/pat
representative	rE/pri/zEn/tx/tIv
reptar	rEp/tar
republic	rI/p^b/lIk
requires	rI/kwYrz
rescue	rEs/kyu
rescued	rEs/kyud
rescues	rEs/kyuz
resealable	ri/si/lx/bxl
resistant	rI/zIs/tInt
respect	rIs/pEkt
respond	rI/spand
responding	rI/span/dIG
response	rIs/pans
rest	rEst
restaurant	rE/stx/rant
resting	rE/stIG
restrain	rIs/tren
restrained	ri/strend
result	rI/z^lt
resulted	rI/z^l/txd
resulting	rI/z^l/tIG
results	rI/z^lts
retarded	rI/tar/dId
retardo	rI/tar/do
retired	rI/tYrd
return	rI/tRn
returned	rI/tRnd
returning	rI/tR/nIG
returns	rI/tRnz
reunion	ri/yu/nyIn
reveal	rI/vil
reversal	rI/vR/sxl
reverse	rI/vRs
reversible	rI/vR/sx/bxl
review	rI/vyu
reward	rI/wcrd
rex	rEks
rhinoceros	rY/na/sx/rxs
rhinoceroses	rY/nc/sE/rx/sxz
rhyme	rYm
rhymes	rYmz
rhyming	rY/mIG
rhythm	rI/Dxm
ribbet	rI/bIt
ribbon	rI/bxn
ribbons	rI/bxnz
ribs	rIbz
rice	rYs
rich	rIC
richard	rI/CRd
rick	rIk
ricky	rI/ki
rid	rId
ride	rYd
riders	rY/dRz
rides	rYdz
ridiculous	rI/dI/kyx/lIs
riding	rY/dIG
right	rYt
rightie	rY/ti
ring	rIG
ringer	rI/GR
ringing	rIG/IG
rings	rIGz
rinse	rIns
rinsed	rInst
rinsing	rIn/sIG
rip	rIp
ripe	rYp
ripped	rIpt
ripping	rI/pIG
rips	rIps
risen	rI/zIn
river	rI/vR
rivers	rI/vRz
road	rod
roadblock	rod/blak
roadrunner	ro/dr^/nR
roads	rodz
roaming	ro/mIG
roar	ror
roast	rost
robbin's	rc/bInz
robert	ra/bRt
roberts	ra/bRts
robin	ra/bIn
robitussin	ro/bI/t^/sIn
rock	rak
rockandroll	ra/k@n/drol
rocker	ra/kR
rockers	ra/kRz
rocketship	ra/kEt/SIp
rockie	rc/ki
rocking	ra/kIG
rockingchair	rc/kIG/CEr
rockinghorse	rc/kIG/hcrs
rocks	raks
roll	rol
rolled	rold
roller	ro/lR
rolling	ro/lIG
rolls	rolz
rolypoly	ro/li/po/li
rommy	ra/mi
romper	ram/pR
ron	ran
roo	ru
roof	rUf
roofing	rU/fIG
room	rum
room's	rumz
rooms	rumz
roomy	ru/mi
roosteen	ru/stin
rooster	rus/tR
roosters	ru/stRz
root	rUt
rope	rop
rose	roz
roses	ro/zIz
rosey	ro/zi
rosie	ro/zi
rosies	ro/ziz
ross	rcs
rosy	ro/zi
rote	rot
rotten	ra/txn
rough	r^f
rougher	r^/fR
round	rWnd
router	rW/tR
routine	ru/tin
routines	ru/tinz
rove	rov
rover	ro/vR
row	rW
roy	rO
rub	r^b
rubbed	r^bd
rubber	r^/bR
rubbery	r^/bx/ri
rubbing	r^/bIG
rubs	r^bz
ruby	ru/bi
rude	rud
ruffle	r^/fxl
ruffly	r^/fx/li
rug	r^g
rugrat	r^/gr@t
rugrats	r^/gr@ts
rugs	r^gz
ruin	ru/In
rule	rul
rules	rulz
rumbling	r^m/blIG
run	r^n
runaway	r^/nx/we
runner	r^/nR
running	r^/nIG
runny	r^/ni
runs	r^nz
rush	r^S
rushed	r^St
rushing	r^/SIG
russell	r^/sxl
rustles	r^/sxlz
rustling	r^/sx/lIG
rutabaga	rU/tx/be/gx
ryan	rY/In
rye	rY
s	Es
s@l	Es
sad	s@d
sadly	s@d/li
safe	sef
safer	se/fR
safest	se/fIst
safety	sef/ti
said	sEd
sailboat	sel/bot
sailed	seld
sailing	se/lIG
sailor	se/lR
sailors	se/lRz
saint	sent
sakes	seks
salad	s@/lId
salads	s@/lxdz
sale	sel
sally	s@/li
salmon	s@/mxn
salsa	scl/sx
salt	sclt
salvation	s@l/ve/SIn
sam	s@m
samantha	sx/m@n/Tx
same	sem
samich	s@/mIC
sammy	s@/mi
sample	s@m/pxl
sampling	s@m/px/lIG
samuel	s@/myu/xl
sand	s@nd
sandal	s@n/dxl
sandals	s@n/dxlz
sandwich	s@n/dwIC
sandy	s@n/di
sang	s@G
sanitize	s@/nI/tYz
santa	s@n/tx
santas	s@n/txz
sara	s@/rx
sarah	s@/rx
sat	s@t
satisfied	s@/tIs/fYd
satisfies	s@/tI/sfYz
satisfy	s@/tIs/fY
satisfying	s@/tIs/fY/IG
saturday	s@/tR/de
sauce	scs
saucer	sc/sR
saucers	sc/sRz
sauces	sc/sxz
sausage	sc/sIJ
save	sev
saved	sevd
saves	sevz
saving	se/vIG
savings	se/vIGz
saw	sc
say	se
saybut	se/b^t
saychugga@o	se/C^/gx
saying	se/IG
says	sEz
scale	skel
scamper	sk@m/pR
scare	sker
scarecrow	sker/kro
scared	skerd
scarf	skarf
scaring	ske/rIG
scarry	skE/ri
scary	ske/ri
scary's	skE/riz
scattering	sk@/tx/rIG
scene	sin
scenes	sinz
scent	sEnt
schedule	skE/JUl
scheduled	skE/Jxld
schedules	skE/Jxlz
scheduling	skE/JU/lIG
schnucks	Sn^ks
school	skul
schoolhouse	skul/hWs
science	sY/Ins
scissorhand	sI/zR/h@nd
scissors	sI/zRz
scooby	sku/bi
scoop	skup
scooping	sku/pIG
scoot	skut
scooter	sku/tR
scooting	sku/tIG
scored	skord
scorpion	skcr/pi/In
scott	skat
scottish	ska/tIS
scramble	skr@m/bxl
scrambled	skr@m/bxld
scrape	skrep
scraped	skrept
scraping	skre/pIG
scratch	skr@C
scratch	skr@C
scratched	skr@Ct
scratches	skr@/Cxz
scratching	skr@/CIG
scratching	skr@/CIG
scratchy	skr@/Ci
scream	skrim
screaming	skri/mIG
screams	skrimz
screech	skriC
screecher	skri/tSR
screen	skrin
screw	skru
screwdriver	skru/drY/vR
screwed	skrud
screwy	skru/i
scribble	skrI/bxl
scribbles	skrI/bxlz
scrub	skr^b
scrubbed	skr^bd
scrubbie	skr^/bi
scrubby	skr^/bi
scrumbilicious@n	skr^m/bI/lI/Sxs
scrumblicious@n	skr^m/blI/Sxs
scrumptious	skr^m/pSIs
scuba	sku/bx
scurry	skR/ri
sea	si
seafood	si/fud
seagulls	si/g^lz
seal	sil
seal's	silz
sealie	si/li
sean	Scn
search	sRC
searched	sRCt
seashells	si/SElz
seashore	si/Sor
season	si/zIn
seasoning	si/zI/nIG
seasons	si/zInz
seat	sit
seats	sits
sebastian	sx/b@s/CIn
sec	sEk
second	sE/kxnd
seconds	sE/kxndz
secret	si/krIt
secrets	si/krIts
sectioned	sEk/Sxnd
sections	sEk/Sxnz
secure	sx/kyUr
see	si
seeandsay	si/@nd/se
seed	sid
seeds	sidz
seeing	si/IG
seek	sik
seem	sim
seemed	simd
seemingly	si/mIG/li
seems	simz
seen	sin
sees	siz
seesaw	si/sc
segment	sEg/mxnt
seize	siz
selection	sI/lEk/Sxn
self	sElf
sell	sEl
selling	sE/lIG
sells	sElz
seltzer	sElt/sR
semicircle	sE/mi/sR/kxl
send	sEnd
sending	sEn/dIG
sends	sEndz
sense	sEns
sensitive	sEn/sI/tIv
sent	sEnt
sentence	sEn/txns
sentences	sEn/txn/sIz
separate	sE/px/ret
separation	sE/px/re/Sxn
september	sEp/tEm/bR
sequential	sI/kwEn/Sxl
series	si/riz
serious	sI/ri/xs
seriously	sI/ri/I/sli
serpent	sR/pInt
serve	sRv
served	sRvd
serves	sRvz
service	sR/vIs
serving	sR/vIG
sesame	sE/sx/mi
session	sE/SIn
set	sEt
setting	sE/tIG
settle	sE/txl
settled	sE/txld
seuss	sus
seuss's	su/sIz
seven	sE/vIn
seventeen	sE/vIn/tin
seventeenth	sE/vIn/tinT
seventh	sE/vInT
seventy	sE/vIn/ti
several	sE/vx/rxl
sew	so
sewed	sod
sewer	so/R
sewing	so/IG
sewingmachine	so/IG/mx/Sin
sewn	son
sews	soz
sex	sEks
sexual	sEk/Su/xl
sexy	sEk/si
sgabettios	skx/bE/ti/oz
shabby	S@/bi
shade	Sed
shades	Sedz
shadow	S@/do
shadows	S@/doz
shady	Se/di
shaggy	S@/gi
shake	Sek
shaked	Sekt
shakes	Seks
shaking	Se/kIG
shaky	Se/ki
shall	S@l
shallots	S@/lxts
shallow	S@/lo
shame	Sem
shampoo	S@m/pu
shape	Sep
shaped	Sept
shapes	Seps
share	Ser
shared	Serd
sharing	Se/rIG
shark	Sark
sharks	Sarks
sharon	S@/rIn
sharp	Sarp
shave	Sev
shaving	Se/vIG
she	Si
she'd	Sid
she'll	Sil
she's	Siz
sheared	Sird
shedding	SE/dIG
sheedy	Si/di
sheep	Sip
sheet	Sit
sheets	Sits
sheila	Si/lx
shelby	SEl/bi
shelf	SElf
shell	SEl
shells	SElz
shena	Si/nx
shepherd	SE/pRd
sheriff	SE/rIf
sherri	SE/ri
sherry	SE/ri
shes	Siz
shh	S
shield	Sild
shielded	Sil/dId
shift	SIft
shifts	SIfts
shimmering	SI/mx/rIG
shimmy	SI/mi
shin	SIn
shine	SYn
shining	SY/nIG
shiny	SY/ni
ship	SIp
ships	SIps
shirt	SRt
shirt's	SRts
shirts	SRts
shiver	SI/vR
shock	Sak
shocked	Sakt
shod	Sad
shoe	Su
shoe's	Suz
shoelace	Su/les
shoelaces	Su/le/sIz
shoeless	Su/lIs
shoes	Suz
shoesies	Su/ziz
shoestring	Su/strIG
shoestrings	Su/strIGz
shook	SUk
shoot	Sut
shooting	Su/tIG
shop	Sap
shopper	Sa/pR
shopping	Sa/pIG
short	Scrt
shorter	Scr/tR
shortly	Scrt/li
shorts	Scrts
shot	Sat
shots	Sats
should	SUd
should've	SU/dxv
shoulda	SU/dx
shoulder	Sol/dR
shoulders	Sol/dRz
shouldn't	SU/dxnt
shout	SWt
shouted	SW/tId
shouting	SW/tIG
shove	S^v
shoved	S^vd
shovel	S^/vxl
shoveled	sh^/vxl
shoveling	S^/vx/lIG
shovels	S^/vxlz
show	So
showed	Sod
shower	SW/R
showing	So/IG
shows	Soz
shred	rEd
shrimp	rImp
shriveled	rI/vxld
shut	S^t
shutter	S^/tR
shutters	S^/tRz
shutting	S^/tIG
shy	SY
sibling	sIb/lIG
sick	sIk
sickie	sI/ki
sid	sId
side	sYd
sides	sYdz
sidewalk	sYd/wck
sidewalks	sY/dwcks
sideways	sYd/wez
sidney	sId/ni
sidney's	sId/niz
sieve	sIv
sigh	sY
sighed	sYd
sight	sYt
sign	sYn
signal	sIg/nxl
signed	sYnd
signs	sYnz
silence	sY/lIns
silent	sY/lInt
silky	sIl/ki
sill	sIl
sillier	sI/li/R
silly	sI/li
sillywilly	sI/li/wI/li
silver	sIl/vR
silverware	sIl/vR/wer
simba	sIm/bx
simmer	sI/mR
simmered	sI/mRd
simmering	sI/mR/IG
simmers	sI/mRz
simple	sIm/pxl
simply	sIm/pli
since	sIns
sing	sIG
singing	sIG/IG
sings	sIGz
sink	sIGk
sip	sIp
sipped	sIpt
sipper	sI/pR
sippie	sI/pi
sips	sIps
sir	sR
siree	sR/i
siren	sY/rIn
sirree	sR/ri
sissy	sI/si
sister	sIs/tR
sister's	sI/stRz
sisters	sI/stRz
sit	sIt
sits	sIts
sitting	sI/tIG
situation	sI/Cu/e/SIn
six	sIks
sixpence	sIk/spEns
sixteen	sIks/tin
sixteenth	sIks/tinT
sixty	sIk/sti
size	sYz
sized	sYzd
skanky	sk@G/ki
skateboard	sket/bord
skateboards	sket/bordz
skates	skets
skating	ske/tIG
skelter	skEl/tR
skies	skYz
skill	skIl
skills	skIlz
skin	skIn
skinnier	skI/ni/R
skinny	skI/ni
skip	skIp
skipped	skIpt
skips	skIps
skirt	skRt
skirts	skRts
skull	sk^l
skunk	sk^Gk
sky	skY
slam	sl@m
slammed	sl@md
slamming	sl@/mIG
slams	sl@mz
slapped	sl@pt
slash	sl@S
slave	slev
sleek	slik
sleep	slip
sleeper	sli/pR
sleepie	sli/pi
sleepies	sli/piz
sleeping	sli/pIG
sleeps	slips
sleepy	sli/pi
sleepyhead	sli/pi/hEd
sleet	slit
sleeting	sli/tIG
sleets	slits
sleeve	sliv
sleeves	slivz
slept	slEpt
slew	slu
slice	slYs
slick	slIk
slid	slId
slide	slYd
slides	slYdz
sliding	slY/dIG
slight	slYt
slightest	slY/tIst
slime	slYm
slimy	slY/mi
slink	slIGk
slinky	slIG/ki
slip	slIp
slipped	slIpt
slipper	slI/pR
slipper's	slI/pRz
slippers	slI/pRz
slippery	slI/px/ri
slippies	slI/piz
slipping	slI/pIG
slippy	slI/pi
slips	slIps
slob	slab
slobber	sla/bR
slobbered	sla/bRd
slobbering	sla/bx/rIG
slobbers	sla/bRz
slobingslobingdobbin	sla/bIG/sla/bIG/d^/bxn
slopping	sla/pIG
sloppy	sla/pi
slosh	slaS
slot	slat
slouch	slWC
slouching	slW/CIG
slow	slo
slower	slo/R
slowing	slo/wIG
slowly	slo/li
slows	sloz
slug	sl^g
slumber	sl^m/bR
slumbers	sl^m/bRz
slurping	slR/pIG
smack	sm@k
smackerel	sm@/kR/xl
smackerel@c	sm@/kR/xl
smacking	sm@/kIG
smakerel@c	sm@/kR/xl
small	smcl
smaller	smc/lR
smallness	smcl/nIs
smart	smart
smarter	smar/tR
smartest	smar/tIst
smartie	smar/ti
smarty	smar/ti
smartypants	smar/ti/p@nts
smashing	sm@/SIG
smell	smEl
smelled	smEld
smelling	smE/lIG
smells	smElz
smelly	smE/li
smile	smYl
smiled	smYld
smiles	smYlz
smiley	smY/li
smiling	smY/lIG
smith	smIT
smoke	smok
smoky	smo/ki
smooth	smuD
smoother	smu/DR
smorgasbord	smor/gxs/bord
smuch	sm^C
smush	sm^S
smushed	sm^St
smushing	sm^/SIG
snack	sn@k
snack's	sn@ks
snackie	sn@/ki
snacking	sn@/kIG
snacks	sn@ks
snail	snel
snails	snelz
snake	snek
snakes	sneks
snakie	sne/ki
snap	sn@p
snapped	sn@pt
snappie	sn@/pi
snapping	sn@/pIG
snaps	sn@ps
snatch	sn@C
snatched	sn@Ct
sneak	snik
sneakers	sni/kRz
sneaking	sni/kIG
sneaky	sni/ki
sneeze	sniz
sneezed	snizd
sneezes	sni/zIz
sneezing	sni/zIG
sniff	snIf
snip	snIp
snipped	snIpt
snipper	snI/pR
snippers	snI/pRz
snippy	snI/pi
snoops	snups
snooze	snuz
snoring	sno/rIG
snort	sncrt
snorting	sncr/tIG
snot	snat
snotty	sna/ti
snow	sno
snow's	snoz
snowballs	sno/bclz
snowblower	sno/blo/R
snowed	snod
snowflakes	sno/fleks
snowing	sno/IG
snowman	sno/m@n
snowman's	sno/mxnz
snowmen	sno/mEn
snows	snoz
snowsuit	sno/sut
snowy	sno/i
snuck	sn^k
snuff	sn^f
snuffy	sn^/fi
snug	sn^g
snuggle	sn^/gxl
snuggled	sn^/gxld
snuggly	sn^/gli
so	so
so@si	so
soak	sok
soaked	sokt
soaking	so/kIG
soaky	so/ki
soap	sop
soappies	so/piz
soapy	so/pi
soccer	sa/kR
sock	sak
sockie	sa/ki
sockies	sa/kiz
socks	saks
socksies	sak/siz
soda	so/dx
sodas	so/dxz
sodium	so/di/xm
sofa	so/fx
soft	scft
softball	scft/bcl
softest	scf/tIst
softly	scft/li
software	scf/twEr
soggy	sc/gi
soiled	sOld
sold	sold
soldier	sol/JR
soldiers	sol/JRz
solid	sa/lId
solidified	sx/lI/dI/fYd
solomon	sa/lx/mxn
some	s^m
somebody	s^m/b^/di
somebody's	s^m/b^/diz
someday	s^m/de
somehow	s^m/hW
someone	s^/mw^n
someone's	s^m/w^nz
someplace	s^m/ples
somersault	s^/mR/sclt
somersaults	s^/mR/sclts
something	s^m/TIG
something's	s^m/TIGz
sometime	s^m/tYm
sometimes	s^m/tYmz
somewhat	s^/mwat
somewhere	s^/mwer
son	s^n
song	scG
songlike	ScG/lYk
songs	scGz
sonic	sa/nIk
sonny	s^/ni
sonogram	sa/nx/gr@m
sons	s^nz
soon	sun
sooner	su/nR
sophie	so/fi
sophisticated	sx/fI/stI/ke/tId
sopped	sapt
sorcerer	scr/sx/rR
sore	sor
sorry	sa/ri
sort	scrt
sorted	scr/tId
sorter	scr/tR
sorts	scrts
sound	sWnd
sounded	sWn/dId
sounding	sWn/dIG
sounds	sWndz
soup	sup
soups	sups
soupy	su/pi
sour	sW/R
source	sors
south	sWT
space	spes
spaceship	spes/SIp
spaghetti	spx/gE/ti
spaghettio	spx/gE/ti/o
spaghettios	spx/gE/ti/oz
span	sp@n
spanish	sp@/nIS
spank	sp@Gk
spanked	sp@N/kt
spare	sper
sparkle	spar/kxl
sparkly	spar/kli
sparky	spar/ki
sparrow	sp@/ro
speak	spik
speaker	spi/kR
speaking	spi/kIG
speaks	spiks
special	spE/Sxl
specific	spI/sI/fIk
specks	spEks
specter	spEk/tR
spectrum	spEk/trxm
speed	spid
speeds	spidz
speedy	spi/di
spell	spEl
spelling	spE/lIG
spend	spEnd
spended	spEn/dxd
spends	spEndz
spent	spEnt
sphere	fir
spice	spYs
spices	spY/sIz
spider	spY/dR
spike	spYk
spill	spIl
spilled	spIld
spilling	spI/lIG
spills	spIlz
spin	spIn
spinach	spI/nIC
spines	spYnz
spinning	spI/nIG
spins	spInz
spirit	spI/rIt
spit	spIt
spits	spIts
spitting	spI/tIG
splash	spl@S
splashasplashasplasha	spl@/Sx/spl@/Sx/spl@/Sx
splashed	spl@St
splashie	spl@/Si
splashing	spl@/SIG
splat	spl@t
splendid	splEn/dId
splendor	splEn/dR
splishiesplashie	splI/Si/spl@/Si
splishsplash	splIS/spl@S
splishysplashy	splI/Si/spl@/Si
split	splIt
splitsplacksplash	splIt/spl@k/spl@S
spoil	spOl
spoiled	spOld
spoke	spok
sponge	sp^nJ
sponges	sp^n/JIz
spontaneously	span/te/ni/xs
spool	spul
spools	spulz
spoon	spun
spoonful	spun/fxl
spoonfuls	spun/fxlz
spoons	spunz
sport	sport
sports	sports
spot	spat
spot's	spats
spots	spats
spotty	spa/ti
spout	spWt
sprat	spr@t
spray	spre
spraying	spre/IG
spread	sprEd
spreads	sprEdz
spring	sprIG
springs	sprIGz
springtime	sprIG/tYm
sprinkler	sprIG/klR
sprint	sprInt
spruce	sprus
spud	sp^d
spunky	sp^G/ki
spy	spY
spying	spY/IG
square	skwer
squares	skwerz
squarular	skwEr/yx/lR
squash	skwaS
squashed	skwaSt
squashie	skwc/Si
squashies	skwc/Siz
squawky	skwc/ki
squeak	skwik
squeaked	skwikt
squeaker	skwi/kR
squeaking	skwi/kIG
squeaks	skwiks
squeaky	skwi/ki
squeal	skwil
squealed	skwild
squeeze	skwiz
squeezed	skwizd
squeezes	skwi/zxz
squeezing	skwi/zIG
squid	skwId
squinting	skwIn/tIG
squirm	skwRm
squirming	skwR/mIG
squirmy	skwR/mi
squirrel	skw/Rrxl
squirrellie	skwR/x/li
squirrellies	skwR/x/liz
squirrels	skwR/rxlz
squirt	skwRt
squirted	skwR/tId
squirting	skwR/tIG
squish	skwIS
squished	skwISt
squishing	skwI/SIG
squishy	skwI/Si
ssh	S
stable	ste/bxl
stack	st@k
stacked	st@kt
stacking	st@/kIG
stacks	st@ks
stage	steJ
stages	ste/JIz
stain	sten
stair	ster
stairs	sterz
stale	stel
stale	stel
stalking	stc/kIG
stall	stcl
stamp	st@mp
stance	st@ns
stand	st@nd
standing	st@n/dIG
standpoint	st@n/dpOnt
stands	st@ndz
staples	ste/pxlz
star	star
starch	starC
stare	ster
starfish	star/fIS
staring	ste/rIG
stars	starz
start	start
started	star/tId
starting	star/tIG
startle	star/txl
startled	star/txld
starts	starts
starve	starv
starved	starvd
starves	starvz
starving	star/vIG
stash	st@S
static	st@/tIk
staticing@n	st@/tI/kIG
staticky	st@/tI/ki
staticling@n	st@/tIk/klIG
station	ste/SIn
statue	st@/Cu
stay	ste
stayed	sted
staying	ste/IG
stays	stez
steadfast	stEd/f@st
steadier	stE/di/R
steady	stE/di
steak	stek
steak's	steks
steal	stil
stealing	sti/lIG
steals	stilz
steam	stim
steamed	stimd
steep	stip
steer	stir
steering	sti/rIG
stegosaurus	stE/gx/sc/rxs
stem	stEm
step	stEp
stephanie	stE/fx/ni
stepped	stEpt
stepping	stE/pIG
steps	stEps
stereo	stE/ri/o
stereos	stE/ri/oz
steve	stiv
steven	sti/vxn
stew	stu
stick	stIk
sticker	stI/kR
stickers	stI/kRz
stickie	stI/ki
stickies	stI/kiz
sticking	stI/kIG
stickle	stI/kxl
stickleback	stI/kl/b@k
sticks	stIks
sticky	stI/ki
stikle	stI/kxl
stile	stYl
still	stIl
stimulated	stI/myx/le/tId
sting	stIG
stingy	stIn/Ji
stink	stIGk
stinkaroosies	stIG/kx/ru/ziz
stinker	stIG/kR
stinkier	stIG/ki/R
stinkies	stIG/kiz
stinkiest	stIG/ki/xst
stinking	stIG/kIG
stinkpot	stIGk/pat
stinks	stIGks
stinky	stIG/ki
stir	stR
stirring	stR/rIG
stitches	stI/CIz
stock	stak
stocking	sta/kIG
stole	stol
stomach	st^/mxk
stomachache	st^/mx/kek
stomp	stamp
stomped	stampt
stomping	stam/pIG
stoneham	sto/nxm
stones	stonz
stood	stUd
stool	stul
stop	stap
stopped	stapt
stopper	sta/pR
stopping	sta/pIG
stops	staps
store	stor
stores	storz
stories	sto/riz
storm	stcrm
stormy	stcr/mi
story	sto/ri
storybook	sto/ri/bUk
stout	stWt
stove	stov
straight	stret
straighten	stre/txn
straightened	stre/txnd
straightens	stre/txnz
straining	stre/nIG
strange	strenJ
stranger	stren/JR
strap	str@p
strapped	str@pt
straps	str@ps
straw	strc
strawberries	strc/bE/riz
strawberry	strc/bE/ri
streaks	striks
stream	strim
street	strit
streetlight	strit/lYt
streetlights	strit/lYts
streets	strits
strength	strEGkT
strengthening	strEGk/Tx/nIG
stress	strEs
stressed	strEst
stretch	strEC
stretches	strE/CIz
stretching	strE/CIG
strike	strYk
string	strIG
stringing	strIG/IG
strings	strIGz
strip	strIp
stripe	strYp
striped	strYpt
stroke	strok
stroll	strol
stroller	stro/lR
strong	strcG
stronger	strcG/R
struck	str^k
structure	str^k/CR
struggle	str^/gxl
struggled	str^/gxld
strum	str^m
stubborn	st^/bRn
stuck	st^k
studies	st^/diz
studio	stu/di/o
study	st^/di
studying	st^/di/IG
stuff	st^f
stuffed	st^ft
stuffy	st^/fi
stung	st^G
stupid	stu/pId
sturdy	stR/di
stutter	st^/tR
style	stYl
styling	stY/lIG
stylish	stY/lIS
styrofoam	stY/rx/fom
sub	s^b
subject	s^b/JIkt
substitute	s^b/stI/tut
substituted	s^b/stI/tu/tId
succeed	sxk/sid
successful	sxk/sE/sfxl
successfully	sxk/sEs/fx/li
such	s^C
suchi	su/Ci
suck	s^k
sucked	s^kt
sucker	s^/kR
sucking	s^/kIG
sucks	s^ks
suction	s^k/SIn
sudden	s^/dxn
suddenly	s^/dxn/li
suds	s^dz
sudsies	s^d/siz
sudsy	s^d/si
sue	su
sued	sud
sues	suz
sugar	SU/gR
sugarpie	SU/gR/pY
suggest	sx/JEst
suggestion	sx/JEs/CIn
suing	su/IG
suit	sut
suitcase	sut/kes
suits	suts
sultan	s^l/tIn
sultan's	s^l/txnz
sultans	s^l/txnz
sultans's	s^l/txn/zxz
summer	s^/mR
summer's	s^/mRz
summers	s^/mRz
summertime	s^/mR/tYm
summoned	s^/mxnd
sumpin	s^m/pIn
sun	s^n
sun's	s^nz
sunblock	s^n/blck
sunburn	s^n/bRn
sunday	s^n/de
sunflower	s^n/flW/R
sunflowers	s^n/flW/Rz
sunglasses	s^n/gl@/sIz
sunny	s^/ni
sunscreen	s^n/skrin
sunscreens	s^n/skrInz
sunshine	s^n/SYn
suntan	s^n/t@n
super	su/pR
superman	su/pR/m@n
supper	s^/pR
supper's	s^/pRz
supplement	s^p/lx/mInt
supplies	sx/plYz
supply	sx/plY
suppose	sx/poz
supposed	sx/pozd
sure	SUr
surely	SUr/li
surface	sR/fIs
surprise	sR/prYz
surprised	sR/prYzd
surprising	sR/prY/zIG
surrounded	sx/rWn/dId
survey	sR/ve
survive	sR/vYv
survivor	sR/vY/vR
susan	su/zIn
susie	su/zi
suspender	sxs/pEn/dR
suspenders	sx/spEn/dRz
suspicious	sxs/pI/SIs
susy	su/zi
suzie	su/zi
suzy	su/zi
swallow	swa/lo
swallowed	swa/lod
swallowing	swa/lo/wIG
swallows	swa/loz
swam	sw@m
swan	swcn
swans	swcnz
swear	swEr
swearie	swE/ri
sweat	swEt
sweater	swE/tR
sweaters	swE/tRz
sweatpants	swEt/p@nts
sweatshirt	swE/tSRt
sweatshirts	swE/tSRts
sweatsuit	swEt/sut
sweaty	swE/ti
sweep	swip
sweeped	swipt
sweepie	swi/pi
sweeping	swi/pIG
sweeps	swips
sweet	swit
sweeta	swi/tx
sweeterpeters	swi/tR/pi/tRz
sweeters	swi/tRz
sweeterspeters	swi/tRz/pi/tRz
sweetest	swi/tIst
sweetheart	swit/hart
sweetie	swi/ti
sweetiepie	swi/ti/pY
sweetiepies	swi/ti/pYz
sweeties	swi/tiz
sweetiest	swi/ti/Est
sweetpea	swit/pi
sweets	swits
sweetsies	swit/siz
sweetum	swi/t^m
sweetums	swi/t^mz
swell	swEl
swell	swEl
swelling	swE/lIG
swelling	swE/lIG
swept	swEpt
swim	swIm
swimmer	swI/mR
swimming	swI/mIG
swimmingpool	swI/mIG/pul
swims	swImz
swimsuit	swIm/sut
swing	swIG
swingie	swIG/gi
swinging	swIG/IG
swings	swIGz
swish	swIS
switch	swIC
switched	swICt
swollen	swo/lIn
swoosh	swUS
sydney's	sId/niz
sylvester	sIl/vE/stR
symbiotic	sIm/bi/a/tIk
symphony	sIm/fx/ni
syndrome	sIn/drom
synthesized	sIn/Tx/sYzd
syrup	sI/rxp
system	sIs/txm
t	ti
t@l	ti
ta	ta
tab	t@b
tabitha	t@/bI/Tx
tabitha's	t@/bI/Txz
table	te/bxl
tablecloth	te/bxl/klcT
tablespoon	te/bxl/spun
tabs	t@bz
tad	t@d
tadah	tx/da
tag	t@g
tags	t@gz
tail	tel
tail's	te/la
tails	telz
take	tek
taken	te/kxn
takes	teks
taking	te/kIG
talk	tck
talkative	tc/kx/tIv
talked	tckt
talker	tc/kR
talking	tc/kIG
talks	tcks
tall	tcl
taller	tc/lR
tallest	tc/lIst
tambourine	t@m/bx/rin
tan	t@n
tangerine	t@n/JR/in
tangerines	t@n/Jx/rinz
tangled	t@G/gxld
tangling	t@G/glIG
tanish	t@/nIS
tank	t@Gk
tantrum	t@n/trxm
tantrums	t@n/trxmz
tap	t@p
tape	tep
taped	tept
tapemeasure	tep/mE/sUr
taperecorded	te/prE/Ccr/dEd
taperecording	te/prE/Ccr/dIG
tapes	teps
taping	te/pIG
tapioca	t@/pi/o/kx
tapped	t@pt
tapping	t@/pIG
taps	t@ps
tar	tar
target	tar/gIt
tart	t@t
tarts	tarts
tarzan	tar/z@n
tasmanian	t@z/me/ni/In
taste	test
tasted	te/stId
tastes	tests
tasting	te/stIG
tasty	tes/ti
tata	t@/t@
tata's	t@/t@z
tata@q	tc/tc
taters	te/tRz
tattoos	t@/tuz
taught	tct
taxi	t@k/si
taxis	t@k/siz
taz	t@z
tea	ti
teach	tiC
teacher	ti/CR
teacher's	ti/CRz
teaching	ti/CIG
team	tim
teapot	ti/pat
tear	tEr
tearing	tE/rIG
tears	tErz
teas	tiz
teasing	ti/zIG
teaspoon	tis/pun
teaspoonfuls	ti/spun/fxlz
technical	tEk/nI/kxl
technically	tEk/nI/kx/li
teddies	tE/diz
teddy	tE/di
tee	ti
teefers	ti/fRz
teenager	tin/e/JR
teenie	ti/ni
teensie	tin/si
teeny	ti/ni
teenyweeny	ti/ni/wi/ni
teepy	ti/pi
teeth	tiT
teether	ti/TR
teethers	ti/TRz
teethie	ti/Ti
teethies	ti/Tiz
teething	ti/DIG
telemarketing	tE/lx/mar/kI/tIG
telephone	tE/lx/fon
telephone's	tE/lx/fonz
telephones	tE/lx/fonz
teletubbies	tE/lx/t^/biz
teletubby	tE/lx/t^/bi
television	tE/lx/vI/ZIn
televisions	tE/lx/vIZ/xnz
tell	tEl
telling	tE/lIG
tells	tElz
telly	tE/li
temper	tEm/pR
temperature	tEm/px/rx/CR
tempt	tEmpt
ten	tEn
tend	tEnd
tender	tEn/dR
tenderness	tEn/dR/nIs
tending	tEn/dIG
tennis	tE/nIs
tense	tEns
tent	tEnt
tenth	tEnT
tents	tEnts
term	tRm
terms	tRmz
terri	tE/ri
terri's	tE/riz
terrible	tE/rx/bxl
terribly	tE/rx/bli
terrific	tx/rI/fIk
terrorizing	tE/rx/rY/zIG
terry	tE/ri
terry's	tE/riz
test	tEst
tested	tE/stId
testing	tE/stIG
than	D@n
thank	T@Gk
thanked	T@Gkt
thanking	T@G/kIG
thanks	T@Gks
thankyou	T@G/kyu
that	D@t
that'd	D@/tId
that'll	D@/txl
that's	D@ts
thaw	Tc
the	D^
thee	Di
theif	TIf
their	Der
theirs	Derz
them	DEm
them's	DEmz
themselves	DEm/sElvz
then	DEn
theodore	Ti/x/dcr
there	Der
there'll	Der/xl
there's	Derz
therefore	Der/for
theresa	tx/ri/sx
thermometer	TR/ma/mx/tR
these	Diz
they	De
they'd	Ded
they'll	Del
they're	Der
they've	Dev
thick	TIk
thicker	TI/kR
thigh	TY
thighs	TYz
thin	TIn
thing	TIG
thing's	TIGz
thingamajigger	TIG/x/mx/JI/gR
thingie	TIG/i
thingies	TIG/iz
things	TIGz
think	TIGk
thinking	TIG/kIG
thinks	TIGks
third	TRd
thirst	TRst
thirsty	TRs/ti
thirteen	TR/tin
thirty	TR/ti
this	DIs
thistle	TI/sxl
thorn	Tcrn
thornbushes	Tcrn/bU/Sxz
thorns	Tcrnz
thorny	Tcr/ni
those	Doz
though	Do
thought	Tct
thoughtful	Tct/fxl
thousand	TW/zInd
thrash	Tr@S
thrasher	Tr@/SR
thread	TrEd
three	Tri
threes	Triz
threw	Tru
throat	Trot
throats	Trots
through	Tru
throughout	Tru/Wt
throw	Tro
throwing	Tro/IG
thrown	Tron
throws	Troz
thumb	T^m
thumbprints	T^m/prInts
thumbs	T^mz
thumbtacks	T^m/t@ks
thumper	T^m/pR
thunder	T^n/dR
thundered	T^n/dRd
thursday	TRz/de
thy	DY
ti@si	ti
tic	tIk
tick	tIk
ticket	tI/kIt
tickets	tI/kIts
tickie	tI/ki
tickle	tI/kxl
tickled	tI/kxld
tickler	tI/klR/
tickles	tI/kxlz
tickletickle	tI/kxl/tI/kxl
ticklie	tI/kli
tickling	tI/kx/lIG
ticklish	tI/kxl/IS
tickly	tI/kxl/I
ticks	tIks
tictactoe	tIk/t@k/to
tiddywinkle	tI/di/wIG/kxl
tide	tYd
tie	tY
tied	tYd
ties	tYz
tiger	tY/gR
tigers	tY/gRz
tigger	tI/gR
tiggers	tI/gRz
tiggywinkle	tI/gi/wIG/kxl
tight	tYt
tighter	tY/tR
tightly	tYt/li
tights	tYts
tile	tYl
tilt	tIlt
tilted	tIl/tId
tim	tIm
timber	tIm/bR
timberland	tIm/bR/l@nd
timbers	tIm/bRz
time	tYm
timer	tY/mR
times	tYmz
timing	tY/mIG
timmer	tI/mR
timmonium	tI/mo/ni/^m
timmy	tI/mi
timmy's	tI/miz
timone	tI/mon
timothy	tI/mx/Ti
tims	tImz
tin	tIn
tiniest	tY/ni/Ist
tinkerbell	tIG/kR/bEl
tinkle	tIG/kxl
tinky	tIG/ki
tinkywink	tIG/ki/wIGk
tinkywinky	tIG/ki/wIG/ki
tiny	tY/ni
tip	tIp
tipietoe	tI/pi/to
tipietoes	tI/pi/toz
tipped	tIpt
tippietoe	tI/pi/to
tippietoes	tI/pi/toz
tipping	tI/pIG
tippy	ti/pi
tippy's	ti/piz
tips	tIps
tiptoe	tIp/to
tiptoed	tIp/tod
tiptoes	tIp/toz
tire	tYr
tired	tYrd
tires	tYrz
tiring	tY/rIG
tissue	tI/Su
tissues	tI/Suz
to	tu
toandfro	tu/@nd/fro
toast	tost
toasted	to/stId
toaster	tos/tR
toastest	to/stEst
toasty	to/sti
tock	tak
today	tx/de
today's	tx/dez
toddler	tad/lR
toe	to
toe's	toz
toenail	to/nel
toenails	to/nelz
toes	toz
toesie	to/zi
toesies	to/ziz
tofu	to/fu
together	tx/gE/DR
toilet	tO/lIt
tokyo	to/ki/o
told	told
tom	tam
tom's	tamz
tomato	tx/me/to
tomatos	tx/me/toz
tomboy	tam/bO
tomcat	tam/k@t
tommy	ta/mi
tomorrow	tx/ma/ro
tomorrow's	tx/ma/roz
ton	t^n
tonga	taG/gx
tongue	t^G
tongue's	t^Gz
tonight	tx/nYt
tonka	taG/kx
tonka's	taG/kxz
tons	t^nz
tonya	tan/yx
too	tu
took	tUk
tool	tul
toolbox	tul/baks
tools	tulz
toolshed	tul/shEd
toot	tut
tootaloo	tu/tx/lu
tooth	tuT
toothbrush	tuT/br^S
toothbrushes	tuT/br^/SIz
toothie	tu/Ti
toothies	tu/Tiz
toothless	tuT/lIs
tooting	tu/tIG
tootleloo	tu/tx/lu
toots	tuts
tootsie	tUt/si
tootsies	tUt/siz
top	tap
topic	ta/pIk
toppings	ta/pIGz
tops	taps
tore	tor
torn	torn
tortoise	tcr/tIs
torturing	tcr/Cx/rIG
toss	tcs
tossed	tcst
tosses	tc/sIz
totally	to/tx/li
totem	to/txm
toucan	tu/k@n
touch	t^C
touchdowns	t^C/dWnz
touched	t^Ct
touches	t^/CIz
touchie	t^/Ci
touching	t^/CIG
touchy	t^/Ci
tough	t^f
toughie	t^/fi
tow	to
toward	tord
towards	tordz
towel	tWl
towels	tWlz
tower	tW/R
towers	tW/Rz
town	tWn
toy	tO
toy'll	tO/xl
toybox	tO/baks
toys	tOz
track	tr@k
tracks	tr@ks
tractor	tr@k/tR
trade	tred
traditional	trx/dI/SI/nxl
traffic	tr@/fIk
trailed	treld
trails	trelz
train	tren
trained	trend
training	tre/nIG
trains	trenz
translate	tr@ns/let
trapeze	trx/piz
trapped	tr@pt
trash	tr@S
trashed	tr^St
trashes	tr^/Sxz
trashing	tr@/SIG
traumatizing	trc/mx/tY/zIG
traveler	tr@/vx/lR
traveling	tr@/vx/lIG
travels	tr@/vxlz
tray	tre
treat	trit
treatment	trit/mInt
treats	trits
tree	tri
trees	triz
treetop	tri/tap
triangle	trY/@G/gxl
triangles	trY/@G/gxlz
triangular	trY/@G/gyx/lR
trick	trIk
tricked	trIkt
tricks	trIks
tricky	trI/ki
tricycle	trY/sI/kxl
tried	trYd
tries	trYz
trike	trYk
trim	trIm
trip	trIp
triple	trI/pxl
tripled	trI/pxld
tripod	trY/pad
tripped	trIpt
tripping	trI/pIG
trombone	tram/bon
troop	trup
trouble	tr^/bxl
trough	trcf
trousers	trW/zRz
trout	trWt
truck	tr^k
truckie	tr^/ki
trucks	tr^ks
true	tru
truly	tru/li
trunk	tr^Gk
trunks	tr^Gks
trust	tr^st
truth	truT
truthfully	truT/fx/li
try	trY
trying	trY/IG
trys	trYz
tub	t^b
tubbie	t^/bi
tube	tub
tubes	tubz
tubing	tu/bIG
tuck	t^k
tucked	t^kt
tucker	t^/kR
tuesday	tuz/de
tuffet	t^/fxt
tug	t^g
tugged	t^gd
tugging	t^/gIG
tulip	tu/lIp
tulips	tu/lIps
tumble	t^m/bxl
tumbled	t^m/bxld
tumbles	t^m/bxlz
tumbling	t^m/bx/lIG
tummies	t^/miz
tummy	t^/mi
tumtum	t^m/t^m
tuna	tu/nx
tune	tun
tunes	tunz
tunnel	t^/nxl
tupperware	t^/pR/wer
turkey	tR/ki
turkey's	tR/kiz
turkeys	tR/kiz
turkies	tR/kiz
turn	tRn
turnaround	tR/nx/rWnd
turned	tRnd
turning	tR/nIG
turns	tRnz
turtle	tR/txl
turtle's	tR/txlz
turtleneck	tR/txl/nEk
turtles	tR/txlz
tush	tUS
tutti	tu/ti
tuttletuttle	t^/txl/t^/txl
tutu	tu/tu
tuv@k	ti/yu/vi
tv	ti/vi
tweaks	twiks
tweedle	twi/dxl
tweedlebug	twi/dxl/b^g
tweedledee	twi/dxl/di
tweedledum	twi/dxl/d^m
tweet	twit
tweetie	twi/ti
tweetie's	twi/tiz
tweety	twi/ti
twelfth	twElfT
twelve	twElv
twenty	twEn/ti
twice	twYs
twiddle	twI/dxl
twiddlebug	twI/dxl/b^g
twinkle	twIG/kxl
twirl	twRl
twirly	twR/li
twist	twIst
twister	twIs/tR
twisting	twI/stIG
twisty	twIs/ti
two	tu
twos	tuz
twy	twY
twying	twY/IG
ty	tY
tyco	tY/ko
tying	tY/IG
tylenol	tY/lx/ncl
type	tYp
typing	tY/pIG
tyrese	tY/ris
u	yu
u@l	yu
ubb's	^bz
ugh	^g
uglier	^/gli/R
ugliest	^/gli/Est
ugly	^g/li
uh	^
uhhuh	^/h^
uhhum	^/h^m
uhoh	^/o
uhuh	^/h^
ukelele	yu/kx/le/li
ulterior	xl/tI/ri/R
um	^m
umbrella	xm/brE/lx
unbearable	^n/bE/rx/bxl
unbreakable	^n/bre/kx/bxl
unbuckle	xn/b^/kxl
unbuckled	xn/b^/kxld
unbutton	xn/b^/txn
uncheerful	^n/CIr/fxl
uncle	^G/kxl
uncles	^G/kxlz
uncomfortable	xn/k^m/fR/tx/bxl
unconsciously	^n/kan/Sx/sli
uncover	xn/k^/vR
uncovering	xn/k^/vx/rIG
uncurl	xn/kRl
under	^n/dR
underarm	^n/dR/arm
underarms	^n/dR/armz
underneath	^n/dR/niT
underpants	^n/dR/p@nts
undershirt	^n/d@/St
understand	^n/dR/st@nd
understandable	^n/dR/st@n/dx/bxl
understanding	^n/dR/st@n/dIG
understands	^n/dR/st@ndz
understood	^n/dR/stUd
underwear	^n/dR/wer
underwears	^n/dR/wErz
undies	^n/diz
undo	^n/du
undone	^n/d^n
undress	^n/drEs
undressed	xn/drEst
undressing	^n/drE/sIG
unfair	xn/fer
unfold	xn/fold
unfortunate	xn/fcr/CI/nIt
unfortunately	xn/fcr/CI/nIt/li
unfree	^n/fri
unhappy	xn/h@/pi
unhook	xn/hUk
unicorn	yu/nI/kcrn
unicycle	ju/nI/saI/kl
unidentifiable	x/nY/dEn/tI/fY/x/bxl
uniform	yu/nx/fcrm
uniforms	yu/nI/fcrmz
unique	yu/nik
unit	yu/nIt
universal	yu/nI/vR/sxl
universe	yu/nI/vRs
unless	xn/lEs
unlimited	xn/lI/mI/tId
unload	^n/lod
unlock	^n/lak
unlocked	xn/lakt
unorganized	x/ncr/gx/nYzd
unpacking	xn/p@/kIG
unpause	^n/pcz
unpleasant	xn/plE/zInt
unplug	xn/pl^g
unplugged	xn/pl^gd
unplugging	xn/pl^/gIG
unplugs	^n/pl^gz
unravels	^n/r@/vxlz
unruly	^n/ru/li
unscrew	xn/skru
unsnap	^n/sn@p
unsnapped	^n/sn@pt
unstrap	^n/str@p
untape	^n/tep
untie	xn/tY
untied	xn/tYd
unties	^n/tYz
until	xn/tIl
untying	^n/tY/IG
unused	xn/yuzd
unusual	xn/yu/Zu/xl
unzip	xn/zIp
unzipped	^n/zIpt
unzipperoni	^n/zI/pR/o/ni
unzipping	^n/zi/pIG
up	^p
uphill	xp/hIl
upieday	^/pi/de
upon	x/pcn
upper	^/pR
uppie	^/pi
ups	^ps
ups@c	^ps
upsa	^p/sx
upsadaisy	^p/sx/de/zi
upset	^p/sEt
upside	^p/sYd
upsidedown	^p/sY/dWn
upsie	^p/si
upstairs	xp/sterz
upstream	^p/strim
uptown	^p/tWn
urchins	R/CInz
urge	RJ
us	^s
use	yus
used	yuzd
useful	yus/fxl
useless	yu/slIs
uses	yu/sIz
using	yu/zIG
usual	yu/Zu/xl
usually	yuZ/u/x/li
utensil	yu/tEn/sxl
utensils	yu/tEn/sxlz
utmost	^t/most
v	vi
v's	viz
v@l	vi
vacation	ve/ke/SIn
vacuum	v@/kyum
vacuumed	v@/kyumd
vacuums	v@/kyumz
valentine	v@/lIn/tYn
valentine's	v@/lIn/tYnz
valentines	v@/lIn/tYnz
vampire	v@m/pYr
van	v@n
van's	v@nz
vandross	v@n/drcs
vane	ven
vanilla	vx/nI/lx
vans	v@nz
variable	v@/ri/x/bxl
variety	vx/rY/I/ti
vas	v^z
vaseline	va/sx/lin
vasie	ve/zi
vat	v@t
vegetable	vEJ/tx/bxl
vegetables	vEJ/tx/bxlz
veggie	vE/Ji
vehicle	vi/I/kxl
veils	velz
velcro	vEl/kro
velcroed	vel/krod
velveteen	vEl/vx/tin
vent	vEnt
vera	vi/rx
verbalize	vR/bx/lYz
vern	vRn
versatile	vR/sI/txl
verse	vRs
version	vR/ZIn
versus	vR/sIs
very	vE/ri
vests	vEsts
victoria	vIk/to/ri/x
video	vI/di/o
videos	vI/di/oz
view	yu
viewpoint	vyu/pOnt
vigorously	vI/gR/xs
vin	vIn
vine	vYn
vinegar	vI/nx/gR
vines	vYnz
vinnie	vI/ni
vintage	vIn/tIJ
violence	vY/x/lIns
violent	vY/x/lInt
violet	vY/x/lIt
violin	vY/x/lIn
viper	vY/pR
virginia	vR/JIn/yx
virtually	vR/Cu/x/li
visit	vI/zIt
visited	vI/zI/txd
visiting	vI/zI/tIG
visits	vI/zIts
visual	vI/Zu/xl
vitamin	vY/tx/mIn
vitamins	vY/tx/mInz
vividly	vI/vId/li
vocal	vo/kxl
voice	vOs
voices	vO/sIz
volcano	vcl/ke/no
vole	vol
volleyball	va/li/bcl
volunteer	va/lxn/tir
vroom	vrum
w	d^/bxl/yu
w@l	d^/bxl/yu
wackwackwack@o	w@/kw@/kw@k
wacky	w@/ki
wafer	we/fR
wafers	we/fRz
waffle	wc/fxl
waffles	wc/fxlz
wag	w@g
wagon	w@/gxn
wahwahwah	w@/w@/w@
wahwahwah@si	w@/w@/w@
wait	wet
waited	we/tId
waiting	we/tIG
wake	wek
wakes	weks
waking	we/kIG
waldo	wcl/do
walk	wck
walkandtalk	wc/k@nd/tck
walked	wckt
walker	wc/kR
walkie	wc/ki
walkietalkie	wc/ki/tc/ki
walkietalkies	wc/ki/tc/kiz
walking	wc/kIG
walks	wcks
wall	wcl
wallet	wc/lIt
wallpaper	wcl/pe/pR
walls	wclz
walt	wclt
walters	wcl/tRz
walters's	wal/tR/zxz
wand	wand
wandered	wan/dRd
wandering	wan/dx/rIG
wanna	wa/nx
want	w^nt
want's	wants
wanted	w^n/tId
wanting	w^n/tIG
wants	w^nts
war	wcr
warm	wcrm
warmed	wcrmd
warmer	wcr/mR
warming	wcr/mIG
warn	wcrn
warning	wcr/nIG
warren	wc/rIn
warrior	wc/rir
was	w^z
wash	wcS
washcloth	wcS/klcT
washcloths	wcS/klcTs
washed	wcSt
washer	wc/SR
washes	wc/SIz
washie	wa/Si
washing	wc/SIG
washrag	wa/Sr@g
wasn't	w^/zInt
wasp	wasp
wasps	wasps
waste	west
wasted	we/stId
wasting	we/stIG
watch	waC
watched	waCt
watches	wa/CIz
watching	wa/CIG
water	wc/tR
water's	wc/tRz
waterfall	wc/tR/fcl
watering	wc/tx/rIG
waterloo	wc/tR/lu
watermelon	wc/tR/mE/lxn
watermelons	wc/tR/mE/lxnz
watery	wc/tx/ri
wave	wev
waved	wevd
waves	wevz
waving	we/vIG
wawa	wa/wa
wax	w@ks
way	we
way's	wez
ways	wez
we	wi
we'd	wid
we'll	wil
we're	wir
we've	wiv
weak	wik
wear	wer
wearable	we/rx/bxl
wearing	we/rIG
wears	werz
weasel	wi/zxl
weasels	wi/zxlz
weather	wE/DR
weaving	wi/vIG
web	wEb
webs	wEbz
wednesday	wEnz/de
wee	wi
weebles	wi/bxlz
weed	wid
weeds	widz
week	wik
weekend	wi/kEnd
weeks	wiks
weens	winz
weensie	win/si
weepee	wi/pi
weepie	wi/pi
weepy	wi/pi
weeta	wi/tx
weewee	wi/wi
weewees	wi/wiz
weeweeweeweewee	wi/wi/wi/wi
weigh	we
weight	wet
weird	wird
weirdest	wir/dIst
weirdo	wir/do
welcome	wEl/kxm
well	wEl
went	wEnt
were	wR
weren't	wRnt
wet	wEt
wetter	wE/tR
wh	W
whack	w@k
whaddya	w^/dyx
whale	wel
whales	welz
wham	w@m
what	w^t
what'd	w^/tId
what's	w^ts
whatcha	W^t/Cx
whatchamacallit	w^t/Cx/mx/kc/lIt
whatever	w^t/E/vR
wheat	wit
wheaties	wi/tiz
whee	wi
wheel	wil
wheelbarrow	Wil/bE/ro
wheeling	wi/lIG
wheels	wilz
when	wEn
when's	wEnz
whence	WEns
whenever	wEn/E/vR
where	wer
where	wer
where'd	werd
where're	WE/rR
where's	werz
whereas	WE/r@z
whereupon	WE/rx/pan
wherever	we/rE/vR
whether	WE/DR
whew	wEw
whey	we
which	wIC
while	wYl
whine	wYn
whined	WYnd
whines	WYnz
whiney	wY/ni
whineyness	wY/ni/nEs
whining	wY/nIG
whip	wIp
whipped	WIpt
whipping	wI/pIG
whips	WIps
whirled	wRld
whirlwind	wR/lwInd
whisker	wIs/kR
whiskers	wI/skRz
whisper	wIs/pR
whispered	wI/spRd
whispering	wI/spx/rIG
whistle	wI/sxl
white	wYt
whitney	wIt/ni
who	hu
who's	huz
whoa	wo
whoever	hu/E/vR
whole	hol
whom	hum
whoop	wup
whoopee	wU/pi
whoopie	wU/pi
whoops	wups
whoopsadaisy	wUp/sx/de/zi
whoopsie	wUp/si
whoopsiedoozies	wUp/si/du/ziz
whoopsiedoozy	wUp/si/du/zi
whoosh	wuS
whose	huz
whoville	hu/vIl
why	wY
why's	wYz
whys	wYz
wick	wIk
wicked	wI/kxd
wide	wYd
wider	wY/dR
width	wIdT
wife	wYf
wig	wIg
wiggins	wI/gInz
wiggle	wI/gxl
wiggles	wI/gxlz
wiggly	wIg/li
wild	wYld
wildly	wYld/li
wiled	wIld
will	wIl
william	wIl/yxm
willie	wI/li
willing	wI/lIG
willow	wI/lo
willy	wI/li
wilted	wIl/tId
wily	wY/li
win	wIn
wind	wInd
wind's	wIndz
windbreaker	wInd/bre/kR
winder	wYn/dR
window	wIn/do
window's	wIn/doz
windows	wIn/doz
windowsill	wIn/do/sIl
winds	wIndz
windshield	wInd/Sild
windshield's	wIn/Sildz
windshields	wIn/Sildz
windy	wIn/di
wing	wIG
wings	wIGz
wink	wIGk
winkie	wIG/ki
winkle	wIG/kxl
winky	wIG/ki
winnie	wI/ni
winter	wIn/tR
wipe	wYp
wiped	wYpt
wipeout	wY/pWt
wiper	wY/pR
wipers	wY/pRz
wipes	wYps
wipie	wY/pi
wipies	wY/piz
wiping	wY/pIG
wire	wYr
wires	wYrz
wish	wIS
wishbone	wIS/bon
wished	wISt
wishes	wI/SIz
witch	wIC
with	wID
within	wI/DIn
without	wI/DWt
wittle	wI/txl
wittles	wI/txlz
wobbly	wc/bli
wocket@n	wa/kxt
woe	wo
woke	wok
wolf	wUlf
wolfie	wUl/fi
woman	wU/mxn
womb	wum
women	wI/mIn
won	w^n
won't	wont
wonder	w^n/dR
wondered	w^n/dRd
wonderful	w^n/dR/fxl
wonderfully	w^n/dR/fx/li
wondering	w^n/dx/rIG
wonders	w^n/dRz
woo	wu
wood	wUd
wooden	wU/dxn
woods	wUdz
woody	wU/di
woof	wUf
woofwoof	wUf/wUf
wool	wUl
woolly	wU/li
wooly	wU/li
woowoo	wu/wu
word	wRd
words	wRdz
wore	wor
work	wRk
worked	wRkt
workie	wR/ki
working	wR/kIG
workout	wR/kWt
workplace	wRk/ples
workroom	wR/krum
works	wRks
world	wRld
world's	wRldz
worm	wRm
worms	wRmz
worn	worn
worried	wR/rid
worries	wR/riz
worry	wR/ri
worse	wRs
worship	wR/SIp
worst	wRst
worth	wRT
wosuits	wo/sut
would	wUd
would've	wU/dxv
wouldn't	wU/dxnt
wound	wWnd
wow	wW
wrap	r@p
wrapped	r@pt
wrapper	r@/pR
wrapping	r@/pIG
wrappings	r@/pIGz
wreath	riT
wreck	rEk
wrecker	rE/kR
wrecking	rE/kIG
wrestle	rE/sxl
wrestled	rE/sxld
wrestles	rE/sxlz
wrestling	rE/sx/lIG
wriggly	rI/gx/li
wrinkled	rIG/kxld
wrinkles	rIG/kxlz
wrinkly	rIG/kli
wrist	rIst
write	rYt
writes	rYts
writing	rY/tIG
writings	rY/tIGz
written	rI/txn
wrong	rcG
wrote	rot
wuss	wUs
wuzzy	w^/zi
x	Eks
x@l	Eks
x@l-s	Eks
xavier	zev/yR
xavier's	Ek/se/vi/Rz
xylophone	zY/lx/fon
y	wY
y@l	wY
ya	ya
yahtzee	yat/zi
yak	y@k
yaks	y@ks
yall	ycl
yam	y@m
yams	y@mz
yank	y@Gk
yanked	y@Gkt
yankee	y@G/ki
yanking	y@G/kIG
yanks	y@Gks
yard	yard
yarn	yarn
yawn	ycn
yawned	ycnd
yawning	yc/nIG
yay	ye
yaya	ya/ya
yaya's	ya/yaz
yayayaya	ya/ya/ya
ye	yi
yea	ye
yeah	yR
year	yir
yearling	yR/lIG
years	yirz
yeast	yist
yeh	yE
yell	yEl
yelled	yEld
yelling	yE/lIG
yellow	yE/lo
yells	yElz
yep	yEp
yeps	yeps
yes	yEs
yessiriebobs	yE/sR/i/babz
yesterday	yEs/tR/de
yet	yEt
yicky	yI/ki
yikes	yYks
yipped	yIpt
yoda	yo/dx
yogurt	yo/gRt
yogurt's	yo/gRts
yolanda	yo/lan/dx
yolk	yok
yomiko	yo/mi/ko
yonder	yan/dR
yorgensen	ycr/gxn/sxn
york	ycrk
you	yu
you'd	yud
you'll	yul
you're	yur
you've	yuv
young	y^G
younger	y^G/gR
your	yUr
your	yUr
yours	yUrz
yourself	yUr/sElf
yous	yuz
youth	yuT
yoyo	yo/yo
yuck	y^k
yucka	y^/kx
yucketyyuck	y^/kE/ti/y^k
yuckies	y^/kiz
yucks	y^ks
yucky	y^/ki
yukon	yu/kan
yuli	yu/li
yuli's	yu/liz
yulibaba	yu/li/ba/bx
yulibabaf	yu/li/ba/bxf
yulibob	yu/li/bab
yulibobs	yu/li/babz
yum	y^m
yumbum	y^m/b^m
yummies	y^/miz
yummy	y^/mi
yumsie	y^m/zi
yumyum	y^/my^m
yumyums	y^/my^mz
yup	y^p
z@l	zi
zach	z@k
zachary	z@/kx/ri
zaps	z@ps
zealand	zi/lxnd
zebra	zi/brx
zebras	zi/brxz
zenga	zEG/gx
zero	zi/ro
zeus	zus
ziggy's	zI/giz
zigzag	zIg/z@g
zigzagging	zIg/z@/gIG
zinnias	zI/ni/xz
zip	zIp
ziploc	zI/plak
zipped	zIpt
zipper	zI/pR
zipper's	zI/pRz
zippered	zI/pRd
zippers	zI/pRz
zipping	zI/pIG
zips	zIps
zipzapzuds	zIp/z^dz
zizzerzazzerzoo	zI/zR/z@/zR/zu
zizzerzazzerzuzz	zI/zR/z@/zR/z^z
zone	zon
zoo	zu
zookeeper	zu/ki/pR
zookeeper's	zu/ki/pRz
zoological	zo/x/la/JI/kxl
zoom	zum
zooming	zu/mIG
zoomzoom	zum/zum
zoos	zuz
zum@o	zum
