	ã‰¨
@	ã‚˜
@C	è³
@G	ãŒµ
@S	ã²
@U	ä•
@b	ã„•
@bd	ç¡
@bt	ç”–
@bts	ç”—
@bz	ç˜
@d	ã†™
@dm	ç™¥
@ds	çš„
@dz	ãˆ
@f	ãˆ´
@ft	ç‡
@g	ã‰‚
@gn	çˆ
@gz	ç•
@k	ã„·
@ks	ã’‡
@kst	ç¡—
@kt	ã†ˆ
@kts	ã†—
@l	ã‰¦
@lC	ç¦˜
@ld	ğˆ
@lf	ç¤
@lm	ç¥¦
@lps	ç¦€
@lt	ç¦‘
@lz	ç¡ 
@m	ãŒ‰
@mp	è•
@mz	è€
@n	ãŒ¤
@nC	ğ•Š…
@nd	ãŒ§
@ndz	è„‚
@ng	è„¡
@nk	è‚‘
@ns	è…ƒ
@nt	ã“
@nts	ã™
@nz	åš†
@p	è†‚
@ps	èˆ¢
@pt	èˆ§
@s	ã‘
@sk	ã·
@sks	ã‘€
@skt	ã¸
@sp	è¹
@st	è•
@sts	ğ‘”ƒ
@t	ã‘—
@ts	è‘˜
@v	ã‘¸
@z	ã±
@zp	è•§
C	é¥¤
C@	ä€¦
C@d	é¡´
C@dz	é¡µ
C@f	é¢‚
C@g	é¢ƒ
C@k	ç˜ 
C@l	é¢ˆ
C@m	é¢“
C@mp	é¢–
C@mps	é¢—
C@n	é¢˜
C@nd	é¤€
C@ns	ä€¨
C@nt	ä€©
C@nts	é¤ƒ
C@nz	é¢™
C@p	ä€²
C@ps	é¤†
C@s	é¤–
C@t	ä„
C@ts	é¤ 
C@z	é¤±
CE	äˆ
CEC	é¤¹
CEf	èœ¥
CEk	ä†
CEks	ä
CEkt	ä‡
CEl	è†
CElf	é¥…
CElm	é¥†
CEm	é¥ˆ
CEn	è‰
CEnh	é¥‘
CEns	é¥’
CEnz	é¥
CEr	å‰…
CErd	é¢†
CErz	å‰†
CEs	é¡ˆ
CEst	ä£
CEsts	é¥¢
CEt	é¥£
CEts	ğ”™“
CEv	ğ’’“
CEvz	ğ’’•
CEz	é¥´
CI	ä–
CIC	ğ“¡™
CIG	ãœ‡
CId	é¥¹
CIf	å‘·
CIfs	å…µ
CIg	é¦‚
CIh	ğ“•–
CIk	ä§
CIks	ä¨
CIkt	é¥¶
CIl	ä²
CIld	é¦…
CIlz	é¦
CIm	ä¶
CImp	ä·
CImps	é¦’
CIn	ä¹
CInk	é¦“
CInks	é¦”
CInt	ãŒ¦
CInz	ç…‡
CIp	ä‚
CIps	ä‚ƒ
CIpt	é¦˜
CIr	ç„°
CIrd	é¥‚
CIs	æ…°
CIt	é§
CIts	ğ€ƒ
CIz	ã‡
CO	ä‚ˆ
COd	ğ‰µ
COn	ğ€‘
COs	ä‚‡
CR	ã€™
CRC	ä„‘
CRd	æŠƒ
CRdz	é„¡
CRn	é¥•
CRnd	ğ†
CRnz	ğ‡
CRp	ä‚„
CRps	ğ€€
CRt	è•¹
CRts	é¥—
CRz	äŒ¶
CU	ğ…
CUk	ğ€•
CUkz	ğ“•±
CUn	é¤‚
CUp	é ¡
CUr	ğ“¥·
CUrz	ğ“¥¸
CW	é¡‡
CWs	é¤¥
CWt	ğ–¡
CWz	ğ€™
CY	ä‚€
CYd	é¥·
CYdz	é¥¸
CYl	é¥„
CYld	ä±
CYldz	é¦„
CYlz	é¦‰
CYm	ä´
CYmd	é¦‘
CYmz	äµ
CYn	ğ”‘·
CYnz	ğ”‘¸
CYr	ğ–¤
CYs	ğ–™
CYvz	ğ€„
CYz	é¤™
CYzd	ğ‘€
C^	ä„ˆ
C^G	ä„
C^b	ğ€µ
C^bz	ğ€¶
C^d	ğ€¹
C^f	ğ”„˜
C^fs	ğ““
C^g	ğ€
C^gd	ğ
C^k	ğ€·
C^ks	ä„‰
C^kt	ğ€¸
C^l	ç¦—
C^lz	ğ’”†
C^m	è ¥
C^mp	ğ‚
C^mz	è¡§
C^n	ç”
C^nd	è•¶
C^nk	ğƒ
C^nks	ğ„
C^ns	ğ“˜µ
C^nt	ğ¨
C^nts	è‚
C^nz	ç”‘
C^p	é ¨
C^ps	ğ“¥³
C^s	è–
C^st	ğ”¤¡
C^sts	ğ‰
C^t	ğ
C^ts	ğ’ …
C^v	ğ“•€
C^y	ğ€’
C^z	ç—
Ca	èŒ¹
Cak	ä€¤
Cal	ğ”¦
Cam	ğ€”
Camp	ä‚“
Can	é¤
Cap	ä‚•
Caps	ğ€—
Capt	ä‚–
Car	ä€¸
CarJ	ä€¶
CarJd	ä€·
Card	å€¦
Carg	ğ 
Cargd	ğ¦–
Carl	é¤‰
Carlz	é¤
Carm	ä€
Carmd	é¤‘
Carmz	é¤’
Carn	é¤“
Cart	ä
Carts	é¤•
Cat	ğ“Œ¶
Cats	ğ”€
Cav	ğ“†
Caz	é¡³
Cc	ä‚†
Ccf	ğ’’”
Ccfs	ğ’’–
Cck	ä€£
Ccks	é¢‘
Cckt	é¢
Ccl	é  
Ccm	ğ“
Ccn	é¤¤
Ccns	é¤£
Ccr	æ¤µ
Ccrt	ğ€˜
Ccrz	ä‚˜
Ccv	ğ’”¤
Ce	ä€—
Ced	ğ”Œ´
Cef	é¡¹
Cefs	é¢
Ceft	é¢€
Cem	è¡˜
Cen	ä€™
CenJ	ä€°
CenJd	ä€±
Cend	é¢…
Ceng	ğ‘˜¦
Cengd	ğ‘˜§
Cenz	ä€ 
Cer	ä€¡
Cerz	ä€¢
Ces	ä‚
Cest	äƒ
Cet	é¢‡
Cevz	é¤¨
Cez	é¤³
Ci	ã€§
CiC	é¥€
Cif	é¦€
Cifs	é¦
Cig	ğ•„ƒ
Cik	ä‘
Ciks	ä’
Cikt	é¥
Cil	ğ“•ˆ
Cilz	ğ”¨
Cin	è™‚
Cinz	è™ƒ
Cip	ä…
Cir	ä“
Cirz	ä˜
Cis	ğ–•¨
Cit	é¤·
Cits	é¤¸
Civ	ã…¨
Civd	ã…©
Civz	ã…°
Ciz	ä™
Co	ä‚
Cok	ä‚‰
Coks	èŒ°
Cokt	ğ€“
Colts	ğ‘Š™
Con	ğ–¦€
Cor	ä‚—
Cot	ğ€ˆ
Coz	ä‚™
Cu	ã…²
Cud	ä¤
Cuk	ä‚”
Cun	ğ€–
Cunz	ğ’€™
Cus	é¥¥
Cut	ğ–•
Cuts	ğ––
Cuz	ä¥
Cx	ã€±
Cxnd	å™°
Cxnz	å™±
Cxp	å‘¸
Cxz	ä„’
D@	æ¥©
D@n	æ¥£
D@t	æ¥¨
D@ts	å‰¢
DEm	æ¥¶
DEmz	æ¥·
DEn	æ¥¹
DIG	ã–
DIn	çŠ–
DIs	æ¦•
DR	ãŒ‡
DRd	ã€
DRz	ã
DWt	çŠ—
DY	ç€—
D^	æ¥±
De	æ¦
Ded	æ¦‚
Del	æ¦ƒ
Der	æ¥´
Derz	æ¥µ
Dev	æ¦„
Di	æ¥²
Diz	æ¦€
Do	ãŒ…
Doz	æ¦™
Dx	ã‰
Dxm	æ‰·
E	ã…¸
EC	ğ‘–’
ECt	ğ‘–“
EJ	ä™¤
Eb	ğ‘
Ebz	ğ‘‘
Ed	ã€—
Edz	ğ†•
Ef	ã„ƒ
Efd	ğ‘š
Efs	ğ‘š‘
Eft	è¥ˆ
Eg	ã¤ƒ
Egd	ğ‘—
Egz	ä™²
Ek	ã€–
Eks	ä†
Ekt	ğ‰
Ekts	ğ
Ekz	ğ‘˜”
El	ä™¶
Elb	ğ‘…
Elf	ğ‘“
Elfs	ğ‘”
Elg	ğ‘–
Elk	ğ‘¹
Elks	ğ‘—
Elm	ğ‘£
Elmz	ğ‘¤
Els	äš•
Elt	ğ‘§
Elv	ğ‘©
Elvz	äš–
Elz	é™’
Em	äš—
EmC	ğ‘¶
Emd	ğ‘·
Emg	ğ‘‘‚
Emp	ğ‘‘…
Empt	ğ‘‘†
Empts	ğ‘‘ˆ
Emt	ğ‘‘‡
Emz	è€‘
En	äœ„
End	äœ†
Endz	äœ‡
Eng	ğ‘‘¨
Enk	ğ‘‘•
Ens	ğ‘’™
Ent	ğ¥£
Ents	ğ‘””
Enz	é¥³
Ep	ğ‘”¡
Eps	ğ‘”²
Er	ã‰¢
Erd	ç ©
Erk	ğ‘ƒ
Erp	ç¡ƒ
Erts	çœ—
Erz	ç ¤
Es	äœ¥
Esk	ğ‘–‚
Esp	ğ¡
Est	ã…·
Ests	èŒ™
Et	çœ£
Ets	é‰
Ev	äœµ
Evz	ğ‘‰²
Ez	è€„
Ezm	ğ‘•¨
GR	å…¸
I	ä™·
IC	å…
IG	ã†
IGk	å±
IGz	ã˜¹
IJd	äœ…
IS	å„
IT	ä ¶
Ib	ğ“„²
Id	çœ
Idz	ä¤…
If	å‰
Ifs	ğ“…€
Ig	ä‚
Igd	ğ‘€„
Ik	ä•
Iks	äˆ
Ikt	ğ”ˆ•
Ikz	é”¦
Il	å’
Ilg	ğ“…ƒ
Ilk	ğ“…„
Ils	ğ“……
Ilz	ğ‘‘‰
Im	å”
Imp	ğ‘‘„
In	ã…’
InC	å 
InCt	ğ“…µ
Ind	ğ•‰…
Ing	ğ‘‘¶
Ink	ğ“…°
Inks	ğ“…±
Ins	ä—
Int	ä”°
Inw	ğ‘”–
Inz	ä‘…
Ip	ğ“ˆ™
Ir	é©
Ird	ğ¤¹
Irk	ğ“…‚
Irn	ğ“„¹
Irz	ä™
Is	å†
Isk	è“
Isks	ğ–Œ´
Iss	ğ‘¢–
Ist	ä™˜
Ists	è¢„
It	ä’•
Its	å‚
Iv	ğœ¸
Iz	å–
J@	å‡
J@k	åˆ
J@ks	å‰
J@m	å•
J@z	å¢
JE	ã€¸
JEd	ã‚ˆ
JEf	å§
JEfs	å¨
JEk	æ‰ƒ
JEkt	æ…€
JEkts	æ…
JElz	å€‘
JEn	å€•
JEnt	å€–
JEnts	ä’ƒ
JEs	ä‰‚
JEst	æ¡´
JI	ã™ˆ
JIG	ã¥
JIS	å¤ƒ
JIZ	å€™
JIg	å´
JIk	å™–
JIks	å¡©
JIkt	æ¡¢
JIl	åµ
JIm	å…”
JImz	å¶
JIn	äœ€
JInd	å•˜
JInt	ä’‚
JInz	æ€•
JIs	å´
JIt	ã ´
JIz	ã ±
JO	äœ‘
JOd	äœ’
JOn	å‘ƒ
JOs	æ‰„
JOz	äœ“
JR	ã¢
JRk	å©
JRz	æ™•
JU	ä™¥
JUl	æ¦
JY	å€£
J^	ãˆ“
J^G	å‘–
J^Gk	å‘˜
J^J	å‘†
J^g	å‘‡
J^m	å‘‰
J^mp	å‘‘
J^mps	å‘“
J^mpt	å‘’
J^s	ãˆ”
J^st	ãˆ–
J^t	å‘ 
Ja	ã§
Jab	å¸
Jabz	å¹
Jag	å‘€
Jan	å‘
Janz	å‘‚
Jar	å™
Jard	å 
Jarz	å¡
Jc	å£
Jcr	å€˜
JcrJ	å€—
Jcz	å¤
Je	å€“
Jek	å”
Jel	å“
Jemz	å–
Jen	å—
Jenz	å˜
Jez	å†
Ji	ã€‚
Jin	å€’
Jinz	å¥
Jits	ã µ
Jiz	å¦
Jo	ã•†
Jok	å‘„
Ju	ä™‡
Jul	å³
Jun	å‘”
Junz	å‘•
Jus	å‘ˆ
Jx	ã™˜
Jxl	ãŒ³
Jxld	æ§
Jxlz	ãŒ´
Jxn	äœˆ
Jxnt	æ¥
Jxz	ä€¹
O	èŒ¢
OG	å¢…
OGk	å¢„
Od	è”
Odz	è•
Ol	å¢‚
Old	å¢ƒ
Olz	ğ”§
On	å¢‡
Os	å¤°
R	ä€€
RJ	ç…ˆ
RT	ä™–
Rb	ğ‘•‚
Rbz	ğ‘•„
Rd	ç–’
Rdz	ğ•–„
Rg	ğ˜
Rgd	ğ–™
Rk	ğ‘•…
Rks	ğ“ˆ¤
Rkt	ğ“ˆ£
Rl	ğ‘Œ¶
Rld	ğ”Œ¢
Rlz	ğ‘Œ·
Rn	å’
Rnd	ä™’
Rnst	ğ‘•‡
Rnz	å•
Rp	ğ‘€
Rps	ğ‘•‰
Rr	éŒ¡
Rrxl	æ¡
Rs	ğ†—
Rst	è•—
Rt	ğ™•
Rts	ğ‘
Rv	ğ“ˆ¨
Rz	ä¤
S	æ‘°
S0	åŠ˜
S@	æˆ’
S@l	æ‘†
S@m	æ‘‰
SE	æ‘£
SEf	ä¡
SEl	æ‘§
SElf	æ‘¨
SElz	æ„
SI	äˆ·
SIG	ã…™
SIft	æ‘²
SIfts	æ‘³
SIn	ã†‰
SInd	ä‘
SIns	å¥¨
SInt	å¥©
SInts	å¥°
SInz	ä’
SIp	æ‰…
SIps	æ‘¶
SIs	ãŒ”
SIz	ã´
SR	ä”¥
SRt	å¡„
SRts	æ‘·
SU	æ’‘
SUd	æ’
SUk	æ’‚
SUr	æ¢€
SUrd	æˆ©
SW	æ’•
SWt	æ’”
SY	æ‘µ
SYn	æ‘´
S^	æ’˜
S^t	æ”…
S^v	æ’–
S^vd	æ’—
Sa	æ’„
Sad	æ’€
Sak	æ‘¸
Sakt	æ‘¹
Sap	æ’ƒ
Sark	æ‘–
Sarks	æ‘—
Sarp	æ‘˜
Sat	æ’ˆ
Sats	æ’‰
ScG	æ™£
Scn	æ‚
Scr	æ’†
Scrt	æ’…
Scrts	æ’‡
Se	æ‘‚
Sed	æ‘€
Sedz	æ‘
Sek	æ‘ƒ
Seks	æ‘…
Sekt	æ‘„
Sem	æ‘ˆ
Semd	ã³
Sep	æ‘‘
Seps	æ‘“
Sept	æ‘’
Ser	æ‘”
Serd	æ‘•
Sev	æ‘™
Sez	ã‘¢
Si	ã’
Sid	æ‘ 
Sil	æ‘¡
Sild	æ‘±
Sildz	çŠ…
Sin	å™
Sinz	å™‘
Sip	æ‘¤
Sird	æ‘¢
Sit	æ‘¥
Sits	æ‘¦
Siz	ä¡™
SmE	åš”
SmuS	å©
Smxn	ä¥’
Sn^ks	æ¨
So	æ…´
Sod	æ”
Sol	æ’“
Sor	æ…
Soz	æ”‚
Sr@g	ä”¤
Srum	å …
St	ç„²
Su	å€
Sut	ä„“
Suz	å
Sx	ãˆ†
Sxl	ã˜
Sxlz	äˆ˜
Sxn	ã„‘
Sxnd	åœ¢
Sxnz	äˆ 
Sxs	ã¡°
Sxz	ãŠƒ
T@G	æ¥¦
T@Gk	æ¥¤
T@Gks	æ¥§
T@Gkt	æ¥¥
T@n	å  
TI	æ¦†
TIG	ã¤
TIGk	æ¦
TIGks	æ¦‘
TIGz	äœ¸
TIf	æ¥³
TIk	æ¦…
TIn	æ¦‰
TR	ã¨
TRd	æ¦’
TRs	æ¦”
TRst	æ¦“
TRz	ã©
TW	ç€
TY	æ¦‡
TYz	æ¦ˆ
T^m	ç€”
T^mz	ç€•
T^n	ç€–
Tc	æ¥°
Tcr	æ¦˜
Tcrn	æ¦–
Tcrnz	æ¦—
Tct	ç€€
Ti	ã‘™
Tif	ğ–™
Tiz	æ¥•
Tr@	ç€…
Tr@S	ç€„
TrEd	ç€†
TrIn	å‘§
Tri	ç€‡
Triz	ç€ˆ
Tro	å²
Tron	ç€’
Trot	ç€
Trots	ç€‘
Troz	ç€“
Tru	ç€‰
Trum	ã–„
Trumz	ã–…
Tu	äœ—
Tx	ã¦–
Txd	åœ§
Txn	äœ©
Txz	ã™£
U	ğ“••
Ul	ğ–˜„
Ulf	ğ¡“
Ur	ğ–˜†
Urk	ğ”‘•
W	åŒ“
W@k	ğ“‘„
WC	å¤•
WE	åŒ™
WEns	ç‰‰
WEt	ğ’
WI	ğ“¨
WIn	ç¥“
WIns	ğ””
WInz	ğ’”¢
WIps	ç‰˜
WIpt	ç‰—
WIs	ğ‘…¤
WIst	ğ“¥
WIsts	ğ“¥‚
WIt	ğ“¦
WIts	ğ“˜ƒ
WR	ç¡„
WRd	é•”
WRdz	ğ¸
WRk	ğ’‰
WRn	è ˆ
WRr	ğ•Œ„
WRt	ğ”Š–
WRz	ä¤€
WW	å¤©
WY	ğ“–
WYnd	ç‰“
WYnz	ç‰”
W^	ç¥
W^d	è”µ
W^k	ğ”„
W^l	è‘´
W^ld	ğ“¥
W^lz	éƒ
W^m	ğ“
W^n	ç¥’
W^nh	ğœ³
W^ns	ç¥‘
W^nt	ğ”¢”
W^nz	è…¹
W^s	ğ”¢•
W^sts	ğ–„
W^t	ç‰„
W^tr	ğ…’
W^z	é¥µ
Wa	ğ“ 
Wal	ğ“•™
War	åŒ˜
Wart	ğ¹
Wat	ğ’§
Wb	è•ˆ
Wcld	ğ“¤•
Wd	ğ‘¹
Wf	è‘¶
Wg	è‘¹
Wgz	è‘¸
Wi	å¤¤
Wid	ğ“¡‡
Wik	éŒ 
Wil	ç‰†
Wiz	ğ“§
Wk	è‘¡
Wl	å¤¥
Wlz	å¤§
Wn	å¤˜
Wnd	ğ–‰‡
Wndz	ğ–‰ˆ
Wngst	è’„
Wns	å¤—
Wol	ğ‘„
Wot	ğ”…
Wr	è‘µ
Wrz	ğ“”
Ws	è’‡
Wst	ğ”‘±
Wsts	ğ”’†
Wt	å¤™
Wts	éˆ‘
Wun	è…¸
Wunz	è†€
Wuz	ğ””™
Wx	äŒ’
Wxlz	å¤¦
Wz	èŒ‘
Wzd	èŒ’
Wzts	ğ”’…
Y	ã’ˆ
Yd	å±
Ydz	ğ”
Yg	ä²
Yk	ğ‘…
Yks	ğ“„¶
Yl	ã‰¤
Ylts	ğ‘‰
Ylz	ã‰¥
Ym	å…
Ymz	ğ“…ˆ
Yn	èœ‡
Ynd	ğ‘
Ynz	ğ–š•
Yr	å”
Yrn	ğ“ˆ¦
Yrnd	å“
Ys	å‡
Yst	ğ“„³
Yt	ç¡‰
Yts	ğ’“
Yv	å†
Yvz	èŒ 
Yz	äµ
Yzd	ç”±
ZIn	ä£
ZR	åœ“
ZRz	å€³
Zi	å€°
Ziz	å€±
Zu	ç…
^	äš‚
^G	ç„±
^b	ç£
^bs	ğ”“
^bz	ç„¨
^d	ç˜©
^dz	ğˆ¦
^g	ç„©
^gd	ğ‘‘—
^k	ç”¦
^ks	ğ‘˜ˆ
^l	ç´
^lC	ğ–˜‡
^ld	ğ¤¶
^lf	ğ–˜ˆ
^lm	ğ–˜‰
^ls	ğ“¥™
^lt	ğ¤·
^lz	ç•‘
^m	ã—
^mf	ğ–”·
^mfs	ğ–”¹
^mft	ğ–”¸
^mp	ğ–˜‘
^mz	ç‘‚
^n	ãˆ
^nC	ğ–˜™
^nb	ğ“œ·
^nd	ç €
^nk	ğ–˜˜
^ns	ç¸
^nst	ğ‘™–
^nt	ç”§
^ntk	è…£
^nts	ç”¨
^nz	ç‘
^p	ãœ©
^ps	ç…†
^pt	ğ–
^pts	ğ—
^r	ğ”€“
^s	ç…‰
^sk	ğ”˜´
^st	è‰
^sts	è´
^t	ç…“
^tl	ğ¥ 
^ts	çœ°
^tz	ğ¥¢
^v	å¡¶
^z	ãŒ©
a	ã‚—
aC	ğ•šˆ
ab	å¡¨
abst	ğ””
ad	å¡µ
adz	è• 
af	å¡¸
afsk	ğ“ƒ
ag	ç‡
ah	ç•´
ak	ã‚
aks	ğˆ§
akt	ğ” 
al	ç™
ald	ğ•ˆ€
alf	ç †
alg	ç¤—
alm	ç¥£
almz	ç¥©
alt	ç¦†
alz	çœ”
am	ç˜—
amz	ç¥°
an	äŒ±
and	ã™±
ankst	è„™
ans	ğ“¥
anst	ğ”ˆ
ant	ğ‘Œƒ
ants	æ‰¤
anz	äŒ²
ap	å¢—
apCG	å¤
aps	ğ”¸
apt	ğ…´
apts	ğ”‘ƒ
ar	ã†
arC	è‰–
arCt	è‰ 
arb	è‰…
arbz	è‰‘
ard	ç
ardz	è‰°
arg	ã’
ark	ã…
arks	è‰§
arlt	èŠ
arm	ã–
armd	èŠ“
armz	ã™
arn	èŒ‚
arnst	èŒ‡
arnt	ã‰
arnts	èŒˆ
arnz	èŒ†
arp	èŒ“
arps	èŒ”
ars	è‰•
art	ã§
arts	ã°
artst	èŒ¸
arv	è
arz	ä¶
arzt	è„
as	å¤’
ast	ğ”‘¥
at	è‚“
ats	ğ”µ
atsz	è€‰
av	è
az	ç •
azd	è’
b	è ‡
b@	ã€ƒ
b@C	è•·
b@G	ã•ƒ
b@Gd	ã•„
b@Gk	ã•‡
b@S	ã•°
b@T	ã–€
b@Ts	ã–†
b@b	è•±
b@bz	è•³
b@d	ã”˜
b@dz	ğ“ˆ³
b@g	ã”™
b@gd	è˜–
b@gz	ã”¡
b@k	ã”…
b@ks	ã”“
b@kst	è™€
b@kt	ã”‡
b@l	ã”¥
b@lC	è™†
b@ld	è™
b@lt	è™¹
b@lts	è™¸
b@m	ã”·
b@n	ã•…
b@nd	ã”¹
b@ndz	ã•‚
b@nf	èš•
b@ng	èš—
b@nk	ç“
b@nks	èš™
b@nkt	èœ
b@nt	èš’
b@nts	èœ’
b@nz	ç¡¶
b@p	è¨
b@ps	ã•‰
b@r	èœ²
b@s	ã•´
b@sk	èµ
b@sks	è¹
b@skt	è¶
b@st	ç
b@sts	ğ“™”
b@t	ã•¹
b@tk	è‰
b@ts	ã–ˆ
b@z	è
bE	ã¶
bEC	è¡’
bET	ã™¨
bETs	äš’
bEb	è¡‰
bEd	ã˜•
bEdz	ã˜–
bEg	ã˜¨
bEgd	è¡¶
bEgz	è¡·
bEk	è”£
bEks	ç·
bEkt	è¡‘
bEl	ã™‚
bElC	ã™
bElCt	è¤ˆ
bEld	ğ“µ
bElfl	è¤‰
bElk	è¢‰
bElm	è¤—
bEls	è¤¢
bElt	ã™‘
bElts	ã™’
bElv	è¤¥
bElz	ã•
bEm	è¢
bEn	ã™“
bEnC	ã™•
bEnd	ã™–
bEndz	è¤±
bEng	è¤´
bEnk	è¢‘
bEnkt	è¤µ
bEns	è¤°
bEnt	ã™ 
bEnts	è¥‚
bEnz	ã™”
bEr	ç„
bErd	è˜±
bErdz	è˜²
bErgz	è¥•
bErn	è˜³
bErnz	è¢—
bErr	ã˜€
bErt	ğ’‰‡
bErts	ğ’‰ˆ
bErz	ã–™
bEs	è¦€
bEsk	è¦ˆ
bEst	ã™¦
bEsts	è¦‘
bEt	ãŒ€
bEtk	é€€
bEts	ãŒ
bEv	é€‰
bEz	é€•
bI	ã„‡
bIC	è•µ
bIG	ãš‚
bIJ	ã¤²
bIb	ã™²
bIbz	ã™³
bId	ã™´
bIdz	é€£
bIf	é€°
bIg	ã™µ
bIgz	é€±
bIk	ç•¦
bIks	çœ„
bIkt	ğ’œ‰
bIl	ã™¸
bIld	ã¢ƒ
bIldz	ã¢†
bIlk	é
bIlkt	é‚
bIln	ç©
bIlt	ã¢‡
bIlts	é€¸
bIlz	ã™¹
bIm	é€´
bIn	ã˜ 
bInd	é
bIng	è•²
bIngd	é“
bInk	é”
bIns	ğ–‚”
bInsk	é¥‡
bInt	ã„¡
bInts	é•
bInz	æŠ–
bIp	é¦
bIr	è ¶
bIrb	é€¦
bIrd	è ±
bIrdz	è ·
bIrn	è¤ƒ
bIrnz	éš€
bIrs	é€§
bIrsk	ğ”
bIrz	è¡´
bIs	ç”¢
bIsk	é¸
bIst	é‚„
bIt	ãš‰
bIts	ãš’
bIv	é‚‡
bIz	ã¤—
bO	ãƒ
bOG	ã„
bOd	éˆ
bOdz	é‰
bOk	é‰§
bOl	ã
bOld	ã‚
bOlz	é‰¨
bOm	èœ³
bOmz	èœ´
bOn	é
bOnk	é‰©
bOs	é‰¦
bOt	é€ˆ
bOz	ã˜
bR	ã•‘
bRC	è¥²
bRT	ãšˆ
bRb	ğ–ˆ©
bRbz	ğ–ˆ°
bRd	ãš†
bRdz	ãš‡
bRg	ã‚‚
bRgz	è¤¦
bRk	ã¤‡
bRks	è¥—
bRl	çµ
bRlz	è¥™
bRm	è¥¢
bRmz	è¥£
bRn	ã¤ˆ
bRnd	ã¤‰
bRnt	ã¤
bRnz	è¥¦
bRnzd	é™‘
bRp	ã¤‘
bRps	ã¤“
bRpt	ã¤’
bRrdz	ğ–†
bRrn	ğ”ˆ
bRs	è µ
bRst	è¥±
bRsts	é™“
bRt	ã™¡
bRtk	è¢
bRts	ã™¢
bRz	ä·
bU	ã—
bUC	é™³
bUS	ã¤•
bUSt	ã¤–
bUd	é–—
bUk	ã™
bUks	ã¡
bUkt	éŠ•
bUl	ã¢ˆ
bUlt	é˜¨
bUlz	é˜¤
bUm	éŒ
bUn	é˜²
bUr	ç”¡
bUrd	éŒ„
bUrk	éŒ·
bUrn	é¡¶
bUrz	éŒ…
bUs	è€¦
bUst	è€§
bUt	ğ“ˆ
bUts	ğ“‡
bW	ãƒ
bWC	è ˜
bWd	ã
bWk	è 
bWl	ã‘
bWlz	ã’
bWm	ç•±
bWmh	è ”
bWmz	ğ“•
bWn	ã‡
bWnd	ç‘¨
bWndz	ã‰
bWns	ã…
bWnst	ã†
bWnt	ãˆ
bWr	éŒ¶
bWs	è —
bWt	ã„’
bWts	ç‘©
bWz	é€·
bWzd	é…
bY	ãŠ
bYb	ğ“…†
bYbd	ğ“…‡
bYd	ç‘ƒ
bYdz	ç‘„
bYg	é€²
bYk	ã™¶
bYks	ã™·
bYkt	é€¶
bYl	è¤€
bYlz	é€¹
bYm	è¤‚
bYn	ãš
bYnd	ãš€
bYndz	é‘
bYnz	é’
bYr	è¢™
bYrg	é™¹
bYrs	é€’
bYrz	è¢˜
bYs	è˜´
bYt	ãš
bYts	ãš‘
bYz	ã¤°
b^	ã 
b^C	é–„
b^G	ã¤‚
b^b	ã¡©
b^d	ã¡¸
b^dz	ã¡¹
b^f	é˜‰
b^fs	é˜
b^ft	ğ•‰
b^g	ã¢€
b^gd	ã¢‚
b^gz	ã¢
b^k	ã¡´
b^ks	ã¡·
b^kt	é–‰
b^l	ç¨
b^lb	å•·
b^lbz	å•¸
b^ld	ç‘’
b^lg	é˜¡
b^lgd	é˜¢
b^lk	é˜£
b^lst	ç‘”
b^lt	é˜§
b^lz	ç°
b^m	ã¢
b^md	ã¢‘
b^mp	ã¢”
b^mps	ã¢—
b^mpt	ã¢•
b^mz	ã¢˜
b^n	ã¢™
b^nC	ã¤€
b^nCt	é˜±
b^nd	é”¥
b^ndz	é˜·
b^ng	é˜¸
b^nk	é”¢
b^nks	é˜¹
b^nkt	ğ¤
b^ns	é˜°
b^nt	é˜
b^nts	é™€
b^nz	ã¤…
b^p	èœ—
b^r	éŒ¹
b^rg	é’€
b^s	ã¤”
b^sk	é™¨
b^st	ã¤˜
b^sts	ã¤¡
b^t	ã¤¢
b^ts	ã¤£
b^v	ã„“
b^vz	ç‘°
b^z	ã¤±
b^zd	é™¶
ba	ã“
baC	é‰†
baCt	éŒ¨
baG	ã
baGk	ã’
baGkt	ã“
bab	ãœ¸
babst	é‰…
babz	ç‘
bad	åˆ
bag	è˜—
bagd	é‰™
bagz	é‰¢
bak	ã’
baks	ã—
bakst	é†
bal	ç…
bald	ğ•…‘
balk	è™—
balm	è™©
balmz	è™²
balt	ğ‘œ¨
balz	è˜ 
bam	è™¨
bamd	éŠ‚
bamh	è “
bamz	è™±
ban	è‘³
band	ã…
bandz	éŠƒ
bank	éŠˆ
banks	ğ”Š’
bans	éŠ‘
bant	éŠ„
banz	éŠ‰
bap	ã²
baps	ã³
bar	ã’‘
barC	è£
barb	ã•’
barbd	èœ£
barbz	èœ¡
bard	èœ©
bardz	èœ°
barf	èœµ
barfk	èœ¶
barg	èœ·
bargd	èœ¹
bark	ã•—
barks	ã•™
barkt	ã•˜
barn	ã• 
barnt	è…
barnz	è†
bars	è•
barsC	è—
bart	ã•§
barts	è˜
barz	ã’’
bas	ç”
bast	éŒ¦
bat	ç‘¦
bats	è”
baz	ã’“
bc	ã„…
bcC	è …
bcd	è †
bcf	é‰–
bcg	ã€
bcgd	é‰ 
bcgz	é‰¡
bck	è™–
bcks	è™ 
bckt	è™™
bcl	ã”§
bcld	ã”¦
bclt	è™·
bclts	è™³
bclz	ã”¨
bcm	è ‘
bcmz	ğ–˜’
bcn	è ‰
bcnz	éŠ
bcp	ğ’‚
bcr	ã„
bcrd	ä€¥
bcrdz	è–‚
bcrg	éŒ”
bcrgz	ğ™ˆ
bcrk	éŒ’
bcrks	éŒ—
bcrn	ãµ
bcrnz	å µ
bcrs	éŒ¢
bcrst	éŒ£
bcrt	ç‘¡
bcrts	ç‘¥
bcrz	é‰“
bcs	éŒ¥
bcst	ğ‘µ
bct	ã„
bcts	è ™
bcz	è –
be	ã’—
beC	è•¸
beb	ã’•
bebz	ã’–
bed	è˜ˆ
bedd	è‡
bedz	èˆ
beg	è˜¡
beh	è˜™
bek	ã”¢
beks	ã”¤
bekt	ã”£
bel	è˜¢
beld	è˜£
belf	è™”
belk	è™˜
belts	è™´
belz	è˜¤
bem	è˜§
ben	è˜¨
benz	è˜©
ber	ã•”
berz	ã˜ƒ
bes	ã•¨
best	è±
bests	ğ“™•
bet	ç’
bets	ç“
bez	ç‘
bezd	ã•©
bi	ã„€
biC	ã–’
biCt	è ¦
bib	è¡¦
bid	ã–“
bidz	ã–”
bif	ã˜™
bifs	è¡©
bift	è¡¨
big	è¡µ
bih	ğ•¡ƒ
bik	ã–•
biks	è¡±
bil	ã‘´
bilk	è¤
bilz	è”†
bim	è °
bimd	è ´
bimz	è ³
bin	ã––
binz	ã–—
bip	ã˜¡
bips	ã˜£
bipt	è¡²
bir	ã˜¤
bird	ã˜‚
birdz	ğ’•™
birz	è¡³
bis	ã˜…
bist	ã˜„
bists	è ¹
bit	ã˜‡
bits	ã˜¦
biv	é€¨
bivz	é€©
biz	ã’˜
bl	éˆ…
bl@	é‚˜
bl@C	é„µ
bl@G	ãœ€
bl@Gk	ãš™
bl@d	ğ‘˜
bl@g	é„…
bl@k	ãš“
bl@ks	ãš”
bl@kt	é‚™
bl@m	é„–
bl@n	é„—
bl@nC	é„ 
bl@nd	é„£
bl@nk	é„˜
bl@nks	é„¥
bl@nkt	é„¤
bl@s	é„©
bl@sk	é„¨
bl@st	ãœƒ
bl@sts	é„´
bl@t	é„¶
bl@ts	é„·
blE	ãœ’
blEd	é…ˆ
blEk	é…†
blEks	é…‡
blEm	é…‘
blEn	é…•
blEnd	ãœ‰
blEndz	ãœ
blEr	é„ˆ
blErd	é„¦
blErz	é„‰
blEs	ãœ‘
blEst	é…—
blEt	ğ–ˆ§
blEz	é„
blI	ã¡³
blIC	é…©
blIG	ã’”
blIGk	ãœ˜
blIg	è—
blIk	æ…–
blIks	ğ“ˆ‰
blIkst	é…´
blImp	é…™
blImps	é… 
blIn	è€¢
blInks	é…£
blInkt	é…¢
blInts	ğ†‚
blInz	ğ‘‰¢
blIp	é…¤
blIps	é…¥
blIs	é…§
blIst	ğ‘–†
blIt	é…±
blIts	è „
blItst	é…²
blO	éˆ”
blOd	éˆ“
blOdz	ğ–Œ¤
blR	ç‘“
blRb	éˆ¨
blRbz	éˆ©
blRd	éˆ°
blRs	ğ’‘“
blRt	éˆ±
blRts	éˆ²
blRz	è˜
blU	éˆ—
blUr	é†—
blW	é„¸
blWC	éˆ„
blWk	ğ“”ˆ
blWnt	éˆ†
blWr	é…€
blWs	ãœ¦
blY	é…“
blYd	é…°
blYg	ğ”
blYgd	ğ”‘
blYk	é…’
blYm	ğ–ˆ¨
blYn	é…¡
blYnd	ãœ–
blYndz	ãœ—
blYt	é…˜
bl^	ãœ²
bl^S	ãœ±
bl^d	ãœ£
bl^dz	é†
bl^f	éˆ¡
bl^fs	éˆ£
bl^ft	éˆ¢
bl^g	è–
bl^k	éš‡
bl^ks	åœ—
bl^m	éˆ¤
bl^mz	ğ‘´
bl^n	é„¢
bl^nk	éˆ¥
bl^ns	ğ•„…
bl^nt	éˆ¦
bl^nts	éˆ§
bl^s	éˆ³
bl^st	ç‘•
bl^t	ğ’Œ¥
bl^ts	ğ–Œ£
bla	ãš—
blaC	é‚—
blab	é…·
blabz	é…¸
blak	ãœ™
blaks	ãœ 
blakt	ãœ¡
blam	é†ˆ
blan	é„™
bland	ãœ¢
blandz	é†‰
blank	ğ”†”
blar	ğ–™‰
blas	é„§
blat	éˆ€
blatC	éˆ
blatCt	éˆ‚
blats	éˆƒ
blc	é†ƒ
blcC	é„¹
blcf	ğ•ˆ¹
blcg	é†‚
blcgz	é†…
blck	æ¡¶
blcm	é…
blcn	ğ”’
blcs	é†˜
ble	é„„
bleC	é„†
bled	ãš•
bledz	ãš–
blek	é„’
bleks	é„“
blem	ãš˜
blemd	é„”
blemz	é„•
blen	é„‡
blenz	é¦ƒ
bles	é„‘
blesk	é„°
blet	ğ”‰
blez	ç‘‘
blezd	é…ƒ
bli	ãœ†
bliC	ãœ„
bliCt	ãœ…
blid	ãœˆ
blidz	é…‰
blik	é…„
blil	é…”
blim	é……
blip	é…
blis	é¢”
bliz	è™
blo	ãœ§
blod	éˆ‡
blok	é††
bloks	é†‡
blom	é†
blon	éˆ
blos	ğ‰°
blot	é…µ
blots	é…¶
bloz	ãœ¨
blu	ãœ•
blud	éˆ•
bluf	ğ–¥•
blum	ãœ¤
blumd	é†–
blumz	é†•
blut	éˆ 
bluz	ãœ°
blxmz	æ„¶
bo	ãœ³
boT	ã¹
bob	é‰‚
bod	ç‘–
bodz	é‰‡
bog	é‰‰
bok	éˆ´
bol	ã“
bolC	é‰±
bold	è‰˜
boldz	é‰²
bolf	é‰µ
bolk	é‰
bolt	é‰³
bolts	é‰¹
bolz	ã”
bom	é‰‘
bon	ã†
bond	éŠ…
bondz	é„
bonk	é‰’
bont	éŠ‡
bonz	ã‰
bor	ãœµ
bord	ãœ´
bordz	æ”¦
bos	è¡‚
bosk	ğ ”
bost	éˆ·
bosts	éˆ¸
bot	ãœ¶
bots	ãœ·
bov	é‰•
boz	ã•
br	ã°
br@	ç‘³
br@C	é¢
br@b	é™
br@d	ã ƒ
br@dt	é¥
br@dz	é¤
br@f	é©
br@g	é°
br@gd	é±
br@gz	é²
br@k	ç’‚
br@kt	é£
br@m	ç‘´
br@mp	é‘
br@mz	é’
br@n	ã ‡
br@nC	ã ˆ
br@nCt	é•
br@nd	ã‰
br@ndz	é–
br@nk	éƒ
br@nks	é„
br@nt	é—
br@nts	ğ•‚ˆ
br@nz	é…
br@s	ã ‰
br@t	ã 
br@ts	é‰
br@z	é¤
brE	å•§
brEC	é‘ 
brET	ã ˜
brEd	ã ’
brEdt	é©
brEdz	é¨
brEg	é‘…
brEk	ã ”
brEkt	ç¡¹
brEkts	ğ“‚†
brEl	é‘’
brEm	é‘†
brEmz	é‘“
brEn	ã ¢
brEnd	é‘”
brEnt	ã ¤
brEnts	é‘–
brEs	é‘—
brEst	ã —
brEsts	é¶
brEt	é¹
brEth	é‘¡
brEts	é‘€
brEz	é‘¥
brI	ã °
brIC	é”
brIG	ã ·
brIGz	ã ¸
brIJ	ã ©
brId	ğ“„ 
brIg	ç’„
brIgd	ç’…
brIgz	é’
brIk	ã §
brIks	ã ¨
brIkt	ğ‘¥
brIl	ç’‡
brIlz	é’”
brIm	é’–
brImd	é’—
brIn	é’˜
brInd	é’™
brInk	é”‚
brInks	é”ƒ
brInz	ğ‘‚™
brIr	é’‡
brIs	é”…
brIsk	é”†
brIst	ğ—‚‰
brIt	ã¡ƒ
brIts	é”‰
brIz	è€£
brIzb	é”„
brO	é”µ
brOC	é”²
brOd	ğ‘ ‰
brOdz	ğ‘ 
brOl	é”³
brOld	é”´
brOlz	é• 
brOn	é”¶
brR	éµ
brU	ã¡’
brUk	ã¡‘
brUks	ç¦ƒ
brW	ã¡™
brWd	é••
brWn	ã˜
brWnd	é•–
brWnz	ã¡ 
brWs	é•“
brWz	ã¡¡
brWzd	é•™
brY	ã ¥
brYC	é‘‘
brYG	ã ¦
brYb	é‘²
brYbd	é‘³
brYbz	é‘´
brYd	é‘¶
brYdz	é‘·
brYg	é’’
brYk	é”‘
brYlz	é’“
brYn	é”€
brYnz	é”
brYr	é‘°
brYs	é‘‡
brYt	ã ³
brYts	ç¢€
br^	ã¡—
br^C	é•¢
br^S	ã¡§
br^St	ã¡¨
br^d	ğ“„™
br^dz	ğ“„¡
br^f	é•§
br^g	é•¨
br^k	é•£
br^ks	é•¤
br^l	é•©
br^lz	ğ’†€
br^m	ç‘¶
br^mz	ç‘µ
br^n	é”
br^nC	ã¡¦
br^nd	ğ’š‰
br^ndz	ğ“¢†
br^nk	é•±
br^ns	ğ•‚‰
br^nt	é•°
br^nts	é•·
br^nz	é•³
br^pt	ç’
br^s	é•¸
br^sk	é–‚
br^st	èŠ’
br^t	ğ ¢
br^ts	ğ‘‚˜
br^z	ğ†ƒ
bra	ã €
brabst	é”™
brad	ã„”
bradt	é”©
brag	é”°
brak	é•
braks	é”¡
bral	éš‘
bralz	éš’
bram	é³
bramz	é´
bran	ç’‰
branf	é•
brank	é•€
branks	é•ƒ
branz	é•‚
branzd	é•„
bras	é–
brast	é•‰
brat	é•‘
brats	é—
brav	ğ‘‰¤
braz	é•¡
brc	ã¡…
brcC	é‘
brcT	ã¡–
brcb	é”˜
brcd	ã¡„
brcdz	é””
brcf	é‰ƒ
brck	ğ‘‰£
brcl	é¢
brclt	é’
brclz	é£
brcn	é“
brcnd	é•
brcnz	é”
brcs	é•ˆ
brct	ã¡˜
brcts	é•
brcv	ğ‘‰¦
brcz	é—
bre	ã „
bred	ã …
bredz	éµ
brek	ã “
breks	ã –
brekt	éˆ
brel	é·
brelz	é¸
brem	é
bren	ã †
brend	é€
brenp	é
brenz	é¹
brer	é¨
bres	ã 
brest	é 
bret	ä€†
brets	ä€‡
brev	ã ‘
brevd	é™
brevz	é 
brez	é…
brezd	é†
bri	ã  
briC	é¦
briCt	é§
briD	ã ™
brid	é‘
bridd	é·
bridz	é¸
brif	ã ²
brifs	é’…
brift	é’ƒ
brig	é‘„
bril	é’†
brim	é³
brin	é´
brinz	é‘•
bris	é‘‚
brit	é‘ˆ
briz	ã ¡
brizd	é‘ƒ
bro	ã¡ˆ
broC	é”’
broCt	é”“
brod	é”¤
brog	é”±
brok	ã¡‡
broks	ğ“™
brol	ç’ˆ
bros	é” 
broz	è€¤
bru	ã¡£
bruC	é•…
brud	é‘¤
brug	é•¥
bruk	é•†
brul	é•¦
brum	ã¡”
brumz	ã¡•
brun	é•’
brus	ã¡¢
brut	ç—
bruz	ã¡¤
bruzd	ã¡¥
brx	ä‘
brxl	å•¦
brxz	ç¹
bu	ã„¥
buC	é˜€
buS	ã§
bub	éŠ’
bubz	éŠ“
bud	ç–
bug	é˜‚
buk	éŠ”
bul	éŒ€
bum	ã¢
bumd	éŒ‚
bumz	ã¤
bun	ã’™
bunz	ã•
bup	ã¥
bups	ã¦
bur	éŒ†
burg	é¥”
bus	ã©
bust	ã¨
busts	éŒ‡
but	ã°
buts	ã±
buz	ã–
bwEb	ä†‘
bx	ã’‰
bxT	äš‘
bxf	ç±
bxl	ã„‰
bxld	å‘
bxlz	ã¡²
bxn	æ‰¸
bxnd	åŒ¹
bxndz	å€
bxnz	æ‰¹
bxs	äˆ
byE	é‚‘
byEn	è¡€
byR	é¡
byRk	é‚’
byU	é™…
byUr	é˜–
by^	è€¥
by^n	éš
bya	ğ’œ’
byard	é™·
bycn	ğ—€˜
bycnz	ğ—€™
bycr	é‚–
bycrg	é‚”
bycrk	é‚•
bycrn	é‚“
byu	ã„¨
byud	ğ§
byuf	é˜ˆ
byug	é˜•
byuk	é˜
byuks	ğ‘‰§
byukt	ğ•
byul	é˜ƒ
byulz	ã´
byun	é˜„
byunz	ğ–”¤
byur	é˜‡
byurg	é˜†
byus	ã„¦
byut	è‘‰
byuts	è‘
byuz	é™”
byuzd	ã„§
byx	ä¸
c	ã€
cC	è‘ 
cb	è‘™
cd	è‘¦
cf	å¡·
cfs	æ„
cft	ğ”¤
cg	ã‘°
cgst	ğ“Œ©
cgz	è‘·
ck	è‘£
ckt	ğ”˜
cl	ãŠ†
cld	è’‚
cldz	è’ƒ
clt	ç¥—
clts	ç¥–
clz	å¤¢
cn	ç¦‰
cnd	ğ’‘
cndz	ğ”…‘
cnts	è’…
cnz	ğ•Š˜
cp	ğ”·
cr	ä‰´
crb	ğ”‘…
crd	å¤…
crf	ğ”‘‡
crg	ğ’Œ€
crk	ğ”‘ˆ
crks	ğ”‘‰
crkt	ğ”‘†
crm	ğ”‘’
crmz	ğ”‘“
crn	ğ”‘”
crs	ğ”‘–
crt	ğ”¦
crz	ğ”†
cs	ğ‘” 
csk	ğ“¶
csks	ğ“·
cst	è’’
ct	å¤–
cv	ğ‘¡
cvz	ğ’…·
cz	ğ”‘™
d	ğœ²
d@	äƒ
d@G	ä¡
d@b	ä
d@bz	ğ™²
d@d	ä‚
d@dz	ä„
d@f	ğ™·
d@ft	ğ™¸
d@g	èš…
d@gz	ğ™¹
d@k	ç˜™
d@ks	é…–
d@kt	ğ••
d@kts	ğ•–
d@l	ä“
d@m	ä—
d@md	ğš˜
d@mp	ä˜
d@mps	ğœ
d@mpt	ğœ€
d@mz	è¢
d@n	ã€
d@nd	å‰ƒ
d@nk	ğšƒ
d@nks	ğœ‰
d@ns	ä 
d@nsk	ğœ‘
d@nst	ğœƒ
d@nt	ğŠ
d@nts	ğŠ‘
d@nz	ä™
d@p	ç˜¤
d@pt	ç˜¥
d@pts	ç˜§
d@s	ç—
d@st	ğœ¤
d@t	ä©
d@ts	ğœ§
d@v	ğœ¹
d@z	ä…
dE	ã„²
dET	ä‘€
dEb	ğ 
dEbz	ğ£
dEd	ä·
dEf	ç¤˜
dEft	ğ•
dEg	ğš„
dEk	ä‘†
dEks	ã‚“
dEkst	ğ“…¹
dEkt	è¡™
dEl	ä‘˜
dElb	ğ •
dElf	ğ ˜
dElfs	ğ –
dElft	ğ —
dElk	ğ ¦
dElp	ğ ²
dElr	ğ ¶
dElt	ğ•
dElv	ğ ¹
dElvd	ğ¡€
dElvz	ğ¡
dElz	ç˜¶
dEm	ğŠ€
dEmd	ğŠ
dEmp	ğ¡’
dEmps	ğ¡”
dEmz	ğŠ‚
dEn	ã…ˆ
dEnd	ğ
dEndz	ğ‘
dEng	ğ¡™
dEnk	ğ¡¡
dEns	ä‘£
dEnst	ğŠƒ
dEnt	ã…‰
dEnts	ã…
dEnz	ğ¡˜
dEp	ğ¡¢
dEpt	ç™‚
dEpts	ğ¡¹
dEr	ç˜˜
dErd	ğœ•
dErn	ğ”… 
dErr	ä¥
dErv	ğ–—
dErz	ğœ–
dEs	èš˜
dEsk	ä‘µ
dEsks	ğ¢—
dEst	å¢
dEt	è‘¨
dEts	éš—
dEv	è™ˆ
dEz	è™‰
dI	ã…¹
dIC	é‚
dICt	ğ‘‚†
dIG	ã…¡
dIGz	ã¢…
dIS	ä”£
dIb	ğ¥“
dIbz	ğ¥”
dId	ãˆ‚
dIdz	ğ–˜ 
dIf	é£
dIfm	ğ¥¨
dIg	ä”‚
dIgz	ä”ƒ
dIh	ğ–Œ¥
dIk	ãˆ…
dIks	ç˜±
dIkt	ãˆƒ
dIkts	ãˆ„
dIl	ä‡
dIlg	ğ¥³
dIlks	ğ¥´
dIlts	ğ¥¶
dIlz	äˆ
dIm	ä”…
dImd	ğ¥¹
dImz	ğ¦€
dIn	ã‰©
dIng	éˆµ
dInh	ğ”…·
dInk	ğ¦‚
dIns	ğ¦„
dInst	ğ“‘·
dInt	ã…‡
dInz	è¢†
dIp	ä”ˆ
dIps	ä”‰
dIpt	ğ¦…
dIr	è¤¤
dIrd	ğˆ¹
dIrz	éŠ
dIs	ä‘¶
dIsk	ä”•
dIsks	ä”˜
dIsp	ğ‘–
dIst	å†…
dIsts	ğ“Š
dIt	äŒ¸
dIts	äŒ¹
dIv	ğ¤²
dIz	ä”©
dO	è¡£
dOC	ğ¤¡
dOg	ğ‘„™
dOl	ğ‘…©
dOlz	ğ‘…°
dOn	è‰©
dOr	éŒ²
dOts	ğ¤¢
dOz	ğ“¥´
dR	ã€‘
dRC	ğ‘Š˜
dRd	ã”‘
dRdz	ğ–€¹
dRf	é—
dRft	ğ”¸
dRg	ğ¦‰
dRk	ğ¢…
dRks	ğ¢†
dRm	é„²
dRn	é†€
dRnz	ğ”…¡
dRp	ğ–˜¡
dRs	ğ¢ˆ
dRst	ğ‘Œ‚
dRt	ä”
dRts	ä”‘
dRv	ğ™§
dRvz	ğ™¨
dRz	ã‰¹
dU	ä™‚
dUn	ğ‘‰¶
dUr	è˜
dUrd	ğ‘‘¤
dUrk	ğ‘‰·
dUrst	ğ‘‰¸
dUrz	è¤†
dW	ä•¶
dWC	ğœ±
dWb	ğ‘…“
dWd	ğœ“
dWdz	ğ‘…–
dWf	è™‡
dWg	é¨
dWn	ä•µ
dWnd	ğ‘…¦
dWnz	å…·
dWr	ğ‘…˜
dWrz	ğ‘…£
dWs	ğ‘…™
dWst	ğœ”
dWt	ä•²
dWts	ğ‘…•
dWz	èš‘
dY	ä’
dYC	ğ ˆ
dYd	ä’“
dYdz	ğ“ˆ˜
dYk	ğ¥±
dYks	ğ¥²
dYkz	ğ–˜·
dYl	ä’
dYlz	ä“
dYm	è€“
dYmz	ğ¥·
dYn	ç˜
dYnd	ğ¦
dYnz	çœ†
dYr	ğ¦‡
dYs	ç¤²
dYst	ğ¥•
dYt	ğ‘••
dYts	ğ‘š…
dYv	ä”¹
dYvd	ä•€
dYvz	ä•
dYz	ä’”
dYzd	ğ“‰·
d^	ã•€
d^C	ğ‘‰¨
d^b	ä˜©
d^bd	ğ‘‰™
d^br	ğ‘„€
d^bz	ğ‘‰ 
d^d	ç’“
d^dz	ğ‘‰´
d^f	ğ‘‰¹
d^g	ä˜´
d^gd	èš†
d^gz	ğ‘…—
d^k	ä˜°
d^ks	ä˜²
d^kt	ç¤
d^kts	ç¥
d^l	ç˜²
d^ld	ç˜³
d^lf	èœ±
d^lg	ğ“†€
d^lgd	ğ“†
d^ls	ğ‘Š†
d^lt	ãˆ¢
d^lts	ãˆ£
d^lz	è–”
d^m	ä˜¶
d^mp	ä˜·
d^mps	ğ‘Š‡
d^mpt	ä˜¸
d^mz	ç˜£
d^n	ãŠ‡
d^nd	ç†
d^nk	ğ‘Šˆ
d^nks	ğ‘Š‘
d^nkt	ğ‘Š‰
d^ns	ç”™
d^nst	ğ‘Š’
d^nt	ç” 
d^nts	ç”²
d^nz	ç‰
d^p	å‰©
d^ps	é˜—
d^s	ä™„
d^sk	ğ‘Œ„
d^st	ä™ƒ
d^sts	é–•
d^t	è‰¨
d^ts	è‘°
d^v	ä•´
d^vz	ğ‘…¢
d^z	ä•‡
da	ã€”
daG	ä•£
daJ	ä•†
dab	ğ‘‚–
dabz	ğ‘‚—
dad	ğ‘„†
dadz	ğ‘„‡
daf	ğ•‰€
dag	åŒ
dagd	ğ‘„ˆ
dak	ä•…
daks	éŒƒ
dakt	ğ‘„‚
dal	ä•”
dald	ğ‘„¤
dalf	ç™©
dalfs	ç™°
dalk	ğš
dalz	ä•“
dam	ğš–
damk	ğ‘„°
damz	ğš‚
dan	ä•™
dand	ğ‘„´
dant	ğˆ¸
danz	ğ‘„±
dap	ãˆ 
dapt	ç™´
dapts	ç™µ
dar	ä§
dard	æ¶
dark	ä¦
darm	ğ™©
darmz	ğ•™¡
darn	ä¨
darnd	ğœ˜
darnz	ğœ 
darst	ğœ¡
dart	ğœ¢
darts	ğœ£
darz	ğ’†’
das	ğ™±
dast	ğ‘…
dat	ã–
dats	ğ‘…’
dav	èµ
davz	è¶
daz	è‘§
dc	ä°
dcG	ä•¤
dcb	ğ™¥
dcbd	ğœ©
dcd	ğ†
dcf	é”¨
dcfs	ğ‘„”
dcg	ä•‰
dcgd	ğ‘„—
dcgz	ä•
dck	ğ‘„…
dcl	ã”‚
dclf	ç™±
dclfs	ğ’ˆˆ
dclt	ğœ´
dclz	ã”ƒ
dcm	ğœµ
dcn	ä³
dcnd	ğ‡
dcnt	ğœ¶
dcnz	ä´
dcr	ã”†
dcrC	ğ‘…†
dcrd	ç™¶
dcrf	ç¤·
dcrfs	ğ”„
dcrk	ğ‘…
dcrmz	ğ‘…‚
dcrn	ç™·
dcrnd	ç™¸
dcrnz	ç™¹
dcrp	ğ”€±
dcrs	ğ‘…ƒ
dcrst	ğ‘…„
dcrt	ğ‘……
dcrz	å¤ 
dcs	ä•±
dct	éš˜
dcv	ğ…
dcz	ğœ·
de	ã€’
ded	èš‡
dedz	ğ”€…
deg	éƒ
dek	åˆˆ
deks	ğ’ ¥
del	ä’
delk	ğš‰
delp	ğš
delz	ç °
dem	ä–
demz	ç˜¢
den	ä‰
dend	ğ ‡
denz	ğš†
der	ä¤
des	ğ™³
det	ã…”
dets	ç•€
dev	ğ€
devz	ğ
dez	äµ
dezd	ğ‰
dfIS	å¢
di	ã„‚
diC	ğ¥¡
dib	ğµ
dibz	ğ¡
did	ä†
didz	ç –
dig	ğ¶
dik	è¤²
diks	ğ“
dil	ä¸
dilz	ğ”
dim	ç”¥
dimd	ğ·
dimz	ğ¸
din	ç³
dinst	ğ¥—
dinz	ã‰°
dip	ä‘
dir	ä¹
dird	ğˆ²
dirks	ğ¥˜
dirz	ğˆ³
dis	ğ–
dist	ğ”·
dit	ğ˜
dits	ğ™
div	ğ™¦
diz	ãŒ²
dli	ä¥ 
do	ãˆ˜
doC	ğ‘„“
dod	ğ’€„
dog	ğ‘„‰
dok	ğ‘‚•
dol	ç™²
dolC	ğ‘„ 
dold	ğ‘„¡
dolf	ç™³
dolt	ğ“™¥
dolz	ğ‘„¢
dom	ä•—
domd	ğ‘„©
domz	ğ‘„¨
don	èŒ—
dond	ğŠ„
dons	ğ‘„³
dont	ä• 
donts	ğ‘„²
donz	ğŠ…
dop	ğ‘„‘
dopk	ğ‘„
dopt	ğ‘…€
dor	ãˆ¡
dorm	ä•°
dorz	ä•§
dos	èœ¢
dost	ğ”’‡
dot	è„„
dots	è„…
doz	ã‘¹
dozd	é˜¥
dpOnt	æ·
dr	ğ‘‰
dr@	ä–‚
dr@C	ğ‘…¶
dr@Gk	ä–‘
dr@b	ğ‘…±
dr@bd	ğ‘…²
dr@bz	ğ‘…´
dr@f	ğ‘…¹
dr@ft	ğ‘…¥
dr@fts	ğ‘…¸
dr@g	ä–€
dr@gd	ä–
dr@gz	ä–†
dr@k	ğ‘…·
dr@m	ğ‘†‡
dr@mz	ğ‘†ˆ
dr@n	ğ‘†
dr@p	ğ‘†“
drE	ä˜‚
drEb	ğ‘ˆ
drEd	ä–—
drEdz	ğ‘†™
drEg	ç¢‰
drEgd	ğ‘ˆƒ
drEgz	ğ‘ˆ„
drEk	ğ‘ˆ‚
drEks	ğ”¤´
drEmt	ğ‘ˆ€
drEn	ğ‘ˆˆ
drEnC	ğ‘ˆ‡
drEnCt	ä˜
drEnt	ğ‘ˆ‰
drEr	ğ‘ˆ…
drEs	ãˆˆ
drEst	ãˆ‰
drEsts	ğ’ ¦
drEt	ğ‘†
drEz	è€…
drEzd	ğ‘ˆ
drI	ä˜‰
drIC	ç¢’
drIG	ä˜‡
drIGk	ä˜…
drIGks	ä˜†
drIb	ğ”‚€
drIbd	ğ‘ˆ‘
drIbz	ğ‘ˆ’
drId	åŒ°
drIdz	åŒ±
drIf	ğ‘ˆ“
drIft	çš‚
drIfts	ğ‘ˆ”
drIg	ç¢‡
drIgz	ğ‘ˆ•
drIk	ç¢‘
drIks	ğ³
drIkz	é”§
drIl	ä˜„
drIld	ğ‘ˆ–
drIlz	ğ‘ˆ—
drIn	ä³
drInk	ğ•¡†
drInt	åƒ
drInz	ç¢“
drIp	ä˜ˆ
drIps	ä˜
drIpt	ğ‘ˆ™
drIs	é¦ˆ
drIst	è‚—
drIt	ğ’¡³
drIz	ğ‘ˆ 
drO	ğ—™
drOd	è‚˜
drOdz	è‚™
drOt	çšƒ
drW	ğ‘‰„
drWn	ä˜™
drWnd	ğ‘‰ƒ
drWnz	ğ‘‰…
drWt	ğ‘ˆ¹
drWts	ğ‘‰€
drY	ä˜’
drYd	ä˜ƒ
drYr	ä˜§
drYs	ğ‘ˆ†
drYv	ä˜‘
drYvz	ä˜“
drYz	ä˜¨
dr^	ä˜¤
dr^G	ä˜¦
dr^Gk	ä˜¥
dr^b	ğ‘‰ˆ
dr^bd	ğ‘‰‰
dr^dt	ğ“„ƒ
dr^dts	ğ“„„
dr^f	ğœ„
dr^g	ä˜ 
dr^gd	ğ‘‰’
dr^gz	ä˜¡
dr^k	ğ‘‰‘
dr^l	é ¤
dr^lz	é ¥
dr^m	ä˜¢
dr^md	ğ‘‰“
dr^mz	ä˜£
dr^n	è‘±
dr^nks	ğ‘‰”
dr^ns	ğ’¥‰
dr^nt	ğ”¤³
dr^nts	ğ“„£
dr^nz	é¦‡
dr^p	ğ–µ
dr^s	è€—
dr^t	é™
dr^v	ç¤‰
dr^z	ç¤„
dra	ä–‰
drab	ğ‘ˆ£
drad	ğ’˜‡
drag	çš€
drak	è¡¤
dram	ğ‘ˆ¨
drap	ä˜•
draps	ä˜—
drapt	ä˜–
dras	è„
drast	ğ‘ˆ·
drat	ğ“”±
draz	ğ‘‰†
drazd	ğ‘‰‡
drc	ä–“
drcb	ğ‘ˆ¡
drcf	ğ“§
drck	ğ“„¥
drcks	ğ“„¤
drcl	ğ‘†–
drcld	ğ‘†—
drclz	ğ‘†˜
drcn	ğ‘†”
drcr	ä–”
drcrz	ä–•
drcs	ç…¤
drct	ç±
drcz	ä––
dre	ä‘–
dred	è‚’
dreg	ğ‘†€
drek	ğ‘†„
dreks	ğ‘†…
drel	ğ‘††
drelz	ğ’™¹
dren	ä–‡
drend	ğ‘†‚
dreng	ğ”¹
drenz	ğ‘†ƒ
drep	ä–’
dreps	ğ‘†’
drept	ğ‘†‘
dres	ğ‘…µ
dret	é˜
drets	é 
drevz	ğ‘†•
drez	è‚•
dri	ãŒ¨
drig	ğ•†‡
dril	çš
drim	ä–˜
drimd	ä–™
drimz	ä˜€
drin	ç¤‡
drinz	ç¤ˆ
dris	è‘²
drit	ç¢
driz	è‚–
dro	ç¢—
drob	ğ–“
drobz	ğ–”
drog	ğ‘ˆ¤
drok	ğ‘ˆ§
drol	æŠ˜
drom	æ¤“
dromz	çœ…
dron	éš™
drond	ğ‘ˆ©
dronz	ğ‘ˆ°
dros	ğ’—
drost	ğ‘ˆ¸
drov	ä˜˜
drovz	ğ‘‰‚
droz	ğ™¤
dru	ãŒ°
druf	ğ–¤¸
drul	ä˜”
drum	ã˜—
drumz	è¡¥
drup	ğ‘ˆ±
drups	ğ‘‰•
drupt	ğ‘ˆ²
drus	ğ‘‰
druz	ãŒ±
drx	ä–
drxl	ä ˜
du	ä†•
dub	ğ‘‰¡
dud	ä˜³
dug	ğ”…£
duh	ğ‘Šƒ
duk	è‰™
duks	ä˜µ
dukt	ğ‘Š…
dul	ç¦
dum	ğ‘„¶
dumd	ğ‘„·
dumz	ğ‘„¸
dun	é¦
dunz	ğ‘„¹
dup	ä•¦
dups	ğ‘Š”
dupt	ğ‘Š“
dur	ğ‘„’
dus	æ„·
dust	å‡
dut	ğ‘Š„
duv	ğ‘Œ†
duw	ğ‘Œ‡
duz	ğ¥
dw@	èš“
dw@n	ğ‘‰–
dwE	ğ‘‰µ
dwEk	ğ‘Œ•
dwEl	çœ€
dwEld	ğ‘Œ—
dwElt	ğ‘Œ˜
dwElz	éœ“
dwEr	ğ’³
dwEst	ç˜´
dwEsts	ğ”‚
dwI	é°
dwIC	æ
dwICt	ğ•Š
dwIdt	èš”
dwIg	ğ’¡—
dwIk	é¡·
dwIks	é¡¸
dwIl	é€¤
dwIn	ç¢”
dwInd	ğ‘Œ™
dwIndz	ğ’ ¨
dwInk	ğ“€™
dwInkt	ğ“€ 
dwIr	ğ“™¨
dwIt	ğŠ†
dwIts	ğ’Œ¦
dwR	ğ‘Œ 
dwRd	ğ‘˜
dwRdz	ğ‘ 
dwRk	è ©
dwRm	ğ•ˆ³
dwRmz	ğ•ˆ´
dwRt	é†”
dwUd	é¶
dwUdz	ğ’´
dwY	é–˜
dwYd	ğ–¥†
dwYdz	ğ–¥‡
dwYf	ğ”‚‚
dwYn	é™
dwYr	èœ¤
dwYvz	ğ”‚ƒ
dwYz	ğ•™¢
dw^	èƒ
dw^l	ğ–µ
dw^ld	ğ•˜
dw^n	è™‘
dw^nz	è™’
dw^s	è‚
dw^ts	ğŠ‡
dwa	é©
dwan	ğ‘Œ‰
dwar	ğ‘‰˜
dwc	éœ
dwck	éˆ¶
dwcks	æ”ˆ
dwcld	ğ‘™
dwcr	ğ‘Œ’
dwcrd	ğ‘¡
dwcrf	ğ‘Œ
dwcrfs	ğ‘Œ“
dwcrft	ğ‘Œ‘
dwcrvz	ğ‘Œ”
dwe	é¦
dwen	ğ‘‰—
dwet	ğ’
dwez	é”—
dwi	è’€
dwib	ğ‘Œ–
dwik	çš™
dwil	ğ–”‡
dwiz	è’
dwo	ğ’™
dx	ãˆ‘
dxd	ã¢„
dxkt	æ„¸
dxkts	æ„¹
dxl	ã¤
dxld	å…¶
dxlz	ã¥ 
dxm	ãˆ€
dxmz	ãˆ
dxn	ã‰’
dxns	äŠ‰
dxnt	äŠ˜
dxnts	æ¡–
dxnz	ä¦—
dxs	ä’
dxst	å¨
dxv	æ’’
dxz	ã £
dyEt	ğ”‚„
dyInt	è¡¡
dyIr	ğ’’ƒ
dyIrz	ğ’’…
dyR	ğ…ˆ
dyRd	ğ“œ¨
dyRz	ğ…‰
dyU	ğ‘‘¦
dyUr	ğ‘‘¢
dyUrd	ğ‘‘£
dyUrz	ğ‘‘¥
dyY	ğ”‰’
dy^	è•™
dy^l	ğ”€²
dy^n	ğ“¤„
dy^nt	ğ”‡
dya	ğ”–‚
dyard	ğ–¤¹
dycr	ğ”€
dycrn	ğ”
dyi	ğ”€³
dyir	ğ’’„
dyo	ğ ™
dyu	ğ¡£
dyudz	ğ‘‰³
dyuz	ğ–˜
dyx	ä™†
e	ã€
eC	å…•
eD	ã‘˜
eJ	ãˆ¹
eb	ç§
ed	ã‰‘
edz	ã‰“
eg	ğ‘¤
egd	ç§
ek	ç•©
eks	ç•²
ekt	ç•°
el	ç —
elz	ç ˜
em	ã‰”
emd	ã‰•
emz	ç  
en	ãŒ¥
end	èŒ•
eng	ç ¡
engd	èŒ–
ent	ã‰—
eny	ğ”ˆ…
enz	ã‰–
ep	è†ƒ
eps	è†‡
er	ã‰˜
erz	è•–
es	ç•¢
est	ç•¤
et	ã“
etT	ä™µ
etn	ç¡ˆ
ets	ã”
etts	ğ‘ˆ
ez	ç˜
f	ğ‘¦…
f@	ä·
f@b	ğ‘š”
f@bz	ğ” ¢
f@d	ğ‘š—
f@dz	ğ‘š™
f@f	ğ”˜”
f@g	ğ‘œ€
f@gz	ğ‘œ
f@k	ã†•
f@ks	ğ ³
f@kst	ğ‘”
f@kt	ä„
f@kts	èŒ±
f@l	ç¤‘
f@lk	ğ‘œ’
f@lz	ğ”˜•
f@m	ä˜
f@n	ä™
f@nd	ğ‘œ 
f@nk	ğ‘œ™
f@nt	ğ‘œ¡
f@nz	ä €
f@s	ğ‘œ†
f@st	ä †
f@sts	ğ‘€
f@t	ä ˆ
f@ts	ğ‘ƒ
f@z	ğ‘•
fE	ä‡
fEC	ä ²
fECt	ğ‘œ¦
fEd	ä —
fEdz	éœ™
fEf	ä ³
fEk	ä”¦
fEks	ğ„
fEkt	ä™©
fEkts	çœ¦
fEl	ä §
fElC	ğ‘³
fEld	è¥‘
fEldz	ğ’•¨
fElk	ğ‘·
fElm	ğ‘¹
fElp	ğ”˜¡
fElps	ğ‘€
fElsk	ğ‘
fElt	ä ¨
fElts	ğ‘‚
fElz	ğ‘¸
fEm	ğ¥©
fEn	ä‘’
fEnd	ğ‚
fEndz	ğƒ
fEns	ä ©
fEnsk	ğ‘…
fEnst	ä °
fEnt	ğ‘ƒ
fEr	çˆ´
fErd	ğ‘œ¥
fErt	ğ‘‰
fErz	çœ¥
fEs	ğŠ‰
fEst	ç¦
fEsts	ğ‘—
fEt	ğ‘ €
fEts	ğ‘ 
fEz	ğ‘ ‡
fI	ã¤·
fIC	ğ‘ ‘
fIG	ä€˜
fIS	ä¡˜
fIbz	ğ”˜£
fId	è†‰
fIdz	è†
fIf	ä ´
fIfT	ä µ
fIfs	ğ‘ ¢
fIfts	ğ‘ ¡
fIg	ä ·
fIgz	ä ¹
fIk	ä¡¨
fIks	ä¡§
fIkst	ä¡©
fIkt	å¦™
fIl	ä¡„
fIlC	ğ‘ ¥
fIlCt	ğ‘ ¦
fIld	ä¡…
fIldz	ğ‘ §
fIlm	ä¡†
fIlmd	ğ‘ ²
fIlmz	ğ‘ ±
fIlp	ğ”˜¤
fIlt	çœ§
fIlz	ğ‘ °
fIm	ğ‘ ´
fIn	ä••
fInC	é˜ 
fInd	ğ‘ ¸
fIng	ğ“œ±
fInk	ğ‘ ·
fInks	ğ‘¡€
fInt	äš…
fInts	äš†
fInz	ä•–
fIps	ğ‘¡ƒ
fIr	ğ‘˜
fIrd	ğ‘—
fIrs	ğ‘ —
fIrz	ğ‘™
fIs	å¢€
fIsk	ğ‘
fIsks	ğ‘¡
fIst	ä¡ 
fIsts	ä¡¡
fIt	ä¡¢
fIts	ä¡£
fIz	ğ‘¡—
fIzm	ğ”š•
fO	ğ‘ …
fOd	ğ–˜€
fOkt	ğ‘ ‚
fOl	ç ²
fOld	ğ‘¦†
fOlz	ç ³
fOst	ğ‘¦‡
fOt	ğ’€·
fR	ä„‡
fRd	ä…ƒ
fRdz	ä…„
fRg	ğ‰
fRk	ğ‘†
fRl	ğ–˜¦
fRld	ğ–˜§
fRm	ä¡–
fRmd	çœ²
fRmz	çœ³
fRn	ğ™¶
fRnz	ğ‘“
fRs	ğ’…²
fRst	ä¡—
fRsts	è€³
fRt	äˆ—
fRts	ğˆ¶
fRz	å¡¹
fU	ã•–
fUks	ğ‘¦–
fUl	ä¥¹
fUld	ğ’…™
fUlp	ğ’…¢
fUlts	ğ’…£
fUlz	ä‚
fUr	ğˆ
fUt	ã••
fUts	ä¤ 
fW	ğ‘œ¢
fWC	ğ’€¡
fWks	ğ’€±
fWl	ä¤µ
fWld	ğ’€¢
fWlk	ğ’€£
fWlks	ğ’€¤
fWlz	ğ’€¦
fWn	ä¤·
fWnd	ä¤¶
fWndz	ğŠ•
fWs	ğ’€¨
fWst	ğ‘‘
fWt	ğ’€©
fWts	ğ’€°
fY	ä ¦
fYd	å…
fYdz	é¡¨
fYf	ğ‘  
fYfs	ğ’…´
fYk	ğ‘ £
fYks	ğ‘ ¤
fYl	ç ™
fYld	ğ‘ ¨
fYlz	ğ‘–˜
fYm	ğ‘¨
fYn	ä¡ˆ
fYnd	ä¡‡
fYndz	ä¡‰
fYnz	çœ±
fYr	ä¡”
fYrp	ğ‘¡†
fYrz	ä¡•
fYs	ğ‘°
fYst	ğ‘±
fYt	ä ¸
fYts	ğ‘„–
fYtz	é˜¦
fYv	ä¡¦
fYvz	å‰ˆ
fYz	ç•¶
f^	ä¦ƒ
f^C	ğ’…³
f^G	å™©
f^Gk	ä¦‚
f^d	ğ¥¥
f^g	ğ’…“
f^gd	ğ’…”
f^k	ğ‘š–
f^ks	ğ’…
f^kt	ğ’…‘
f^l	è†ˆ
f^ld	è˜’
f^ldz	ğ•Œ–
f^lk	ğ’… 
f^lks	ğ’…¡
f^lz	è˜“
f^m	ä¦€
f^n	ä¦
f^nd	ğ‰¤
f^ndz	ğ’…§
f^ng	ğ‘œ˜
f^nk	ğ’…¦
f^nks	ğ’…©
f^nkt	ğ–
f^nt	éŠ†
f^nts	ğ‘’
f^nz	ğ‘„¦
f^s	ä¦…
f^st	ä¦‡
f^sts	é±
f^t	é˜‘
f^ts	é˜’
f^z	ä¦
fa	ä•©
fabz	ğ‘¥¶
fad	ğ‘œƒ
fag	é±
fagt	ğ‘¦„
fagz	ğ‘¦‚
fak	ğ’€²
faks	ğ’€³
fakst	ğ”‘²
fakt	ğ‘¥¸
fal	è„ˆ
fals	ğ“™ƒ
falz	ğ‘š’
fam	ğ‘¦“
fan	ç
fand	ğ‘¦”
fans	ç¤’
fant	é¢‰
fants	ğ‘¦•
fanz	ç¥¹
far	ä 
farb	ğ‘œ£
fard	éŒ³
farf	ã
farg	ğ‘œ§
fark	ğ“†„
farm	ä ‚
farmd	ğ‘œ°
farmz	ğ‘œ©
farn	ğ‘œ±
farnz	ğ‘œ²
fars	ğ‘œ¤
fart	ä …
farv	ğ‘œµ
farz	å’
fas	ğ‘œ¶
fast	ğ”˜˜
fat	èˆ¶
fats	èˆ·
fav	ğ“œ©
fay	ğ‘¦ˆ
faz	ğ‘š“
fc	ä”
fcb	ğ‘¥µ
fcg	ğ‘¦
fcgz	ğ‘¦ƒ
fck	ä¥
fcks	ä¥€
fcl	ä“
fclb	ğ‘œ‘
fcldz	ğ‘‡
fcls	ä–
fclt	ä 
fclts	ğ
fclz	ä•
fcn	ä ”
fcnd	ğ“™„
fcns	ç¤“
fcnt	ğ‘ˆ
fcp	ğ’€
fcr	ä¤¡
fcrC	ğ‘¦€
fcrb	ğ’€ƒ
fcrbz	ğ’€‚
fcrd	è¡…
fcrdz	çœµ
fcrg	ğ’€
fcrgd	ğ’€‘
fcrk	ä¤¨
fcrks	ä¤©
fcrkt	ğ’€’
fcrm	å§
fcrmd	ä¤°
fcrmz	å©
fcrn	ã¥ƒ
fcrnz	ğ’€”
fcrs	ç ´
fcrst	ğ‘‘§
fcrt	é’
fcrts	ğ’€—
fcrz	ğ’€§
fcs	ğ‘
fct	ğ‘…
fcts	ğ‘†
fcz	ğ‘‰
fe	äƒ
feI	ä‘
feT	äˆ
fed	ä…
fedz	ğ‘š˜
feg	ğ“¤
fek	ä‰
feks	ä’
fekt	ä
fel	ğ‘œ‡
feld	ğ‘œˆ
felz	ğ‘œ‰
fem	ğ¹
femd	ğ€
fen	é¡”
fend	ğ‘§
fent	ğ‘œ
fenz	ğ‘©
fer	ä†
fes	ä€
fest	ä‚
fet	é–
fets	ä ‰
fev	ğ‘“
fez	é˜“
fezd	ğ‘–
fi	ã‚‰
fiC	ğ”±
fid	ä ™
fidz	ä  
fif	ğ‘ ’
fifs	ğ‘ “
fig	ğ‘¦
fik	ğ‘¥
fil	ä ¡
fild	äŠ„
fildz	ç ±
filz	ä ¢
fim	ğ‘¤
fin	é™„
find	ğ‘ ”
findz	ğ‘ •
finz	ğ“Œ‚
fir	ä •
first	ğ‘ ™
firz	ğ‘ ˜
fis	çœ¹
fist	ä –
fists	ğ‘ 
fit	ä ¤
fits	ä ¥
fiv	ğ”¡¥
fiz	ä £
fl	ä¢™
fl@	ä¡¸
fl@C	ğ‘¡¤
fl@S	ä¡·
fl@b	ğ‘¡¢
fl@d	ğ‘¡¥
fl@g	ä¡°
fl@gd	ğ‘¡¦
fl@gz	ğ‘¡§
fl@k	ğ‘¡£
fl@ks	ğ‘¢™
fl@m	ğ‘¡²
fl@n	ğ‘¡µ
fl@ng	ğ‘¡¶
fl@nk	ğ‘¡·
fl@nks	ğ‘¡¹
fl@nkt	ğ‘¡¸
fl@ns	ğ‘¢€
fl@p	ä¡µ
fl@ps	ä¡¶
fl@pt	ğ‘¢
fl@s	ğ‘¢„
fl@sk	ğ‘¢‰
fl@sks	ğ‘¢
fl@st	ğ‘¢…
fl@t	ä¢€
fl@ts	ğ‘¢‘
flE	ğ‘¢ƒ
flEd	ğ‘¤‚
flEg	ğ‘¤ƒ
flEgd	ğ‘¤„
flEk	æˆ¸
flEks	ğ‘¤
flEkst	ğ‘¤•
flEkt	ğ…
flEkts	ğ†
flEm	ğ”˜¥
flEr	ä¡±
flErd	ğ‘¢‚
flErz	ä¡²
flEs	ğ‘¤’
flEst	ğ‘¤“
flEt	ğ‘¤”
flI	ä¢‰
flIk	å¦
flIks	ğŠ”
flIkt	ä¢…
flIkts	çœ´
flIm	ğ‘¤™
flIn	è˜”
flInC	ğ‘¤ 
flInCt	ğ‘¤¡
flInk	ğ‘¤£
flInt	ğ‘¤¤
flInts	ğ‘¤¥
flInz	ğ‘¤¢
flIp	ä¢†
flIps	ã”ˆ
flIpt	ğ‘¤§
flIr	ğ‘¤ˆ
flIs	ğ‘¤°
flIt	ğ‘¤±
flO	ğ‘¤¹
flOd	ğ‘¥”
flR	ä¢
flRt	ğ‘¤¨
flRts	ğ‘¤©
flRz	ğ”‰
flU	ğ‘„
flUk	ğ‘¥ƒ
flUr	ğ‘¥‰
flW	ã¦™
flWm	ğ”˜–
flWn	ğ‘¥ˆ
flWns	ğ‘¥‡
flWnt	ä¢˜
flWrz	ğ–¢”
flWt	ğ‘¥
flWts	ğ‘¥‘
flY	ä–…
flYd	ğ‘¤–
flYk	ğ“”†
flYn	ğ“‚
flYnz	ğ“ƒ
flYr	ä¤‡
flYs	ğ‘¤‘
flYt	ğ‘¤—
flYts	ğ‘¤˜
flYz	ã¤¤
fl^	ä¤„
fl^S	ä¤†
fl^bz	ğ‘¥•
fl^d	ğ‘¥
fl^dz	ğ‘¥‚
fl^f	ä¤ƒ
fl^fs	ğ‘¥ 
fl^ft	ğ‘¥™
fl^g	ğ“ˆ‚
fl^k	ğ‘¥–
fl^ks	ğ‘£
fl^m	ğ”˜—
fl^n	ğ‘¥§
fl^nd	ğ’¦“
fl^nk	ğ‘¥¨
fl^nks	ğ‘¥°
fl^nkt	ğ‘¥©
fl^s	ğ“œ•
fl^st	è¡‡
fl^t	ğ“œ–
fl^ts	ğ“œ—
fla	ä¢–
flag	ğ‘¤·
flak	ğ‘¤²
flaks	ğ‘¤´
flakt	ğ‘¤³
flam	ğ‘¥€
flap	ä¢‡
flaps	ä¢ˆ
flapt	ğ‘¥…
flar	ğ‘¤¸
flas	ğ‘¥†
flat	çœ‡
flats	çœˆ
flaz	éœ´
flazd	éœµ
flc	ä¢—
flcd	ğ‘¢—
flcm	ğ‘¢’
flcn	ğ‘¢”
flcnt	ğ‘¢“
flcnts	ğ‘¢•
flcnz	ğ••·
flcr	ğ‘¤µ
flcrd	ğ‘¥„
flcz	ğ‘¢˜
fle	ä¢
fled	ğ‘¤€
fleg	ğ‘¡©
flek	ğ‘¡±
fleks	ä¡³
flel	ğ‘¡°
flem	ç€
flemd	ğ‘¡³
flemz	ğ‘¡´
flet	ğŠ’
flets	ğŠ“
fli	é’„
flig	ğ‘¤
flik	ğ‘¤‡
flis	ğ‘¤…
flist	ğ‘¤†
flit	ä¢ƒ
flits	ğ‘¤‰
fliz	ä¢‚
flo	ä¢’
flod	ğ‘¥’
flon	ğ‘¥“
flor	ä¢”
florz	ä¢•
flot	ä¢‘
flots	ä¢“
floz	ä¤‚
flu	ä¢„
flug	ğ‘¥—
fluk	ğ‘¥¡
fluks	ğ‘¥¢
flum	ğ‘¥£
flumz	ğ‘¥¤
flut	ğ‘¥˜
fluts	ğ‘¥²
fluz	ğ‘¥±
flx	ä¡´
fo	ä¤
fob	ğ–¨
fobz	ğ‘¥·
fod	ğ“”¢
fok	ğ£
foks	ä¤”
fol	ä¤“
fold	ä¤’
foldz	ğ‘¦
folk	ğ‘¦‰
fols	ğ‘¦‘
folts	ğ‘¦’
folz	ğ‘¥³
fom	ä¤‰
fomz	ğ‘¥´
fon	åœ²
fond	ğ”˜§
fonz	ä™“
for	ã˜§
forT	ä¤³
forTs	ä¤¹
ford	ãˆ°
forst	ä¤¢
forz	ä¤¸
foz	ğ‡
fr@	ğ’
fr@G	ä¥„
fr@Gk	ä¥ƒ
fr@d	ğ’€
fr@f	ğ’ 
fr@fs	ğ’¡
fr@g	ğ’‚
fr@k	æˆ¹
fr@kt	ğ¥¦
fr@m	ğ¥‰
fr@mb	ğ“™…
fr@mp	ğ’ˆ
fr@n	ğ‘€‰
fr@nd	ğ’”
fr@nk	ğ’‰
fr@nks	ğ’
fr@nkt	ğ’•
fr@ns	ğ’‘
fr@nt	ğ’˜
fr@nts	ğ’—
fr@nz	ğ’–
fr@p	ğ’™
fr@s	ğ’£
fr@t	ğ’¦
fr@tsk	ğ’¥
frE	ä¥ˆ
frES	ä¥‘
frEd	ä¥‡
frEdz	ğ’¹
frEk	ğ’¸
frEl	ğ’‚
frElz	ğ’‚‘
frEmd	ğ’‚’
frEmdz	ğ’‚“
frEn	ä¥™
frEnC	ä¥
frEnd	ä¥—
frEndz	ä¥˜
frEnts	ğ’‚•
frEnz	ğ’‚–
frEr	è¡†
frErz	ğŠ–
frEs	ç„
frEst	ğ•©
frEt	ğ’„
frEts	ğ’„‚
frEz	ğ’„€
frI	ãˆ²
frIC	ğ’„˜
frIJ	ä¥•
frId	ç¤”
frIg	ğ“š˜
frIk	ä¥“
frIks	ğ’„ˆ
frIl	ä¥¢
frIlz	ğ’„’
frIn	ğ¥¤
frIng	ğ’„“
frIngd	ğ“†…
frInk	ğ‘•
frIns	ä’—
frInt	ä’˜
frInz	ğ”¢
frIr	ğ’¶
frIs	ğ’„”
frIsk	ğ’„•
frIskt	ğ’„–
frIst	ğ’„—
frIt	ğ’„ 
frIts	ğ’„¡
frItz	ğ’„¢
frItzs	ğ’„£
frIz	ä¥£
frO	ğ’„…
frOd	ğ’„ƒ
frOdz	ğ’„„
frOnd	ğ’„‡
frR	ğ’‚˜
frW	ğ’§
frWm	ğ’°
frWn	ä¥²
frWnd	ğ’…€
frWnz	ğ’…
frY	ä¥”
frYd	ä¥–
frYnd	ğ’‚‰
frYt	ğ’„‘
frYz	ä¥¡
fr^	ä¥¶
fr^k	ğ’…‚
fr^kt	ğ’…ƒ
fr^l	ğ”–“
fr^lz	ğ”–”
fr^m	ä¥§
fr^mp	ğ’……
fr^n	çœ¶
fr^nk	ğ’
fr^ns	ğ 
fr^nsk	ğ’’
fr^nst	ğ” £
fr^nt	ä¥¨
fr^nts	ä¥©
fr^nz	ğ’…†
fr^s	ğ’…‡
fr^z	ğ•‰¦
fra	ğ”
frad	è…—
frag	ã¢‰
fragz	ğ’„§
frak	ğ‘ ¹
fraks	ğ’„¤
fram	ğ’±
fran	ğ‘
frand	ğ’„³
frandz	ğ’„´
frank	ğ’„µ
frant	è §
frants	è ¨
fras	ğ’¢
frat	ğ’²
fraz	ğ’€¸
frc	ä¥¦
frcd	ğ“
frcdz	ğ’¨
frcg	ä¥¤
frcgd	ğ“œ¡
frcgz	ä¥¥
frcn	ğ’„°
frcnz	ğ•¡
frcs	ä¥±
frcst	ä‘“
frcsts	ğ’„¸
frct	ğ’©
frcts	ğ’„¹
fre	ãŠ€
fred	ãˆ±
freks	ğ’…
frel	ğ’„
frem	ä¥‚
fremd	ğ’‡
fremz	ç µ
fren	ğ
frend	ğ•§
frenz	ğ•¨
fres	ğ’€¹
fret	ç ¶
frets	ğ’¤
frez	æ€
frezd	ğ”˜²
fri	ä¥†
frid	ğ’‚€
fridt	ğ’„
fridz	ğ’‚
frig	ğ’‚ˆ
frih	ğ’‚†
frik	ä¥…
friks	ğ’´
frikt	ğ’³
fril	ğ’‚ƒ
frilz	ğ’‚„
frin	ğ‘Š€
frirz	ğ’·
fris	ğ”
frit	ğ’‚…
frits	ğ’„™
friz	ä¥‰
fro	ä¥´
frog	ğ’„¥
from	ğ’„±
fron	ğ’„¶
fros	ğ’„¦
froz	ä¥³
fru	ä¥¸
frug	ğ’…„
frund	ğ’„†
frut	ä¥°
fruts	ä¥µ
frx	å°
frxns	æˆ·
frxnt	ä”€
fu	ä™°
fud	ä¤–
fudz	ä¤—
fuk	ğ’…˜
ful	ä¤˜
fuld	ä¤™
fulks	ğ’€¥
fulz	ğ‘¦—
fun	é˜”
funz	ğ–˜
fur	ğœ—
fus	ğ‘¦™
fuz	ğ‘¦˜
fx	ãŠ™
fxl	ã’„
fxlz	ã’…
fxn	å¥
fxnt	å¤
fxnts	äš‡
fxst	ã •
fxt	å•
fy@	ğ‘ ˆ
fyE	ğ‘ –
fyEl	ğ‘¡™
fyEld	ğ‘¡˜
fyR	ğ’…°
fyU	ä¦„
fy^n	ğ ´
fyak	ğ’…µ
fycr	ğ”†•
fycrd	ğ‘¡ 
fycrdz	ğ‘¡¡
fyo	ğ’…¶
fyu	ä‰
fyuJ	æ‰€
fyud	ğ‘ ƒ
fyudz	ğ‘ „
fyug	é¡¢
fyugz	ğ’…—
fyuks	ğ’…‰
fyul	ç•
fyulz	ç–
fyum	æ€€
fyumd	ğ’…¤
fyumz	ğ’…¥
fyunz	ğ’…¨
fyur	ğ’…•
fyus	ğ¥§
fyut	ğ•°
fyuts	ğ‘ †
fyuz	äˆ¹
fyuzd	ä‰€
g	å„·
g@	ä¦‘
g@C	ç–
g@b	ğ’…¸
g@bd	ğ“‰„
g@bz	ğ“‰…
g@d	ğ’†‚
g@db	ğ’†ƒ
g@dz	ğ’†„
g@f	ğ’†‡
g@fs	ğ’†ˆ
g@g	ğ’†‰
g@gd	ğ’†
g@gz	ğ’†‘
g@k	ç¡•
g@ks	ç¡”
g@kt	é´
g@l	é²
g@lz	ğ’ˆ€
g@m	ğ‘Œ§
g@md	ğ“‰“
g@mp	ğ’ˆ„
g@mz	é˜
g@n	ã˜©
g@ng	ğ’ˆ‰
g@nk	ğ“‰‰
g@nsk	ğ’ˆ‘
g@nt	ğ’ˆ’
g@nts	ğ’ˆ”
g@nz	çœ¸
g@p	ä¦•
g@ps	ğ’ˆ–
g@r	ğ’ˆ©
g@s	ä¦™
g@sp	ç£
g@sps	ğ’‰
g@spt	å€€
g@st	ç¹
g@t	å€‚
g@ts	ğ’‰„
g@tsk	ğ’‰…
g@v	ğ’‰ 
g@z	ğ’‰¤
g@zd	ğ“‰¥
gE	ãŒ†
gEb	ğ’‰°
gEd	ğ’‰±
gEf	ğ’‰´
gEfs	ğ“‰²
gEg	ğ’‰µ
gEk	ğŒ‚
gEks	ğ‘”
gEkt	ç‘‡
gEkts	ğ‘“
gEl	è„
gElb	ğ’Š„
gEld	ğ“‰´
gElks	ğ“‰³
gElts	ğ’Š†
gElz	ğ’Š…
gEm	ç¡¢
gEmz	ğ’Š‡
gEn	ãˆ·
gEnC	ğ“‰¶
gEnd	ğ’Š‰
gEnk	ğ’Š“
gEnks	ğ“‰µ
gEnsk	ğ’Š•
gEnst	ãˆ¸
gEnt	ğ’Š–
gEnts	ğ’Š—
gEnz	è€·
gEp	ğ’Œ
gEr	ğ  
gErk	ğ’‰¸
gErt	ğ’†…
gErz	ğ’‰¶
gEs	å…€
gEsk	ğ’Œ”
gEst	å…
gEsts	å…‚
gEt	ä¤£
gEth	ğ’Œ–
gEts	ä¤¤
gEv	ğ”Œ†
gEz	é
gI	ã€¦
gIG	ã˜±
gIGz	å•™
gIJ	å™
gIb	ğ’Œ¢
gIbz	ğ’Œ£
gId	ç¨
gIf	ğ’Œ°
gIfs	å€§
gIft	å€¥
gIg	è˜•
gIgd	ğ”ˆ”
gIgz	ğ’Œ±
gIk	ç™’
gIks	é™
gIkt	ğ–ˆ¥
gIkts	ğ–ˆ¦
gIl	å…„
gIlb	ğ’Œ²
gIld	ğ’Œ³
gIldz	ğ’š†
gIlk	ğ‘‘©
gIlks	ğ’Œµ
gIls	ğ’Œ·
gIlt	éŒ•
gIlts	ğ’Œ¹
gIlz	ğ’Œ¶
gIm	ğ‘ ©
gImz	ğ’œ†
gIn	ã˜²
gInd	ğ’ƒ
gInh	ğ‘¶
gInks	ğ’¤³
gIns	ğ’„
gInt	è‰³
gInts	ğ’…
gInz	ã˜³
gIp	ç‚
gIpt	ğ‘´
gIpts	ğ‘¶
gIr	ğ’‰¨
gIrd	ğ’‰©
gIrdz	ğ’‰²
gIrk	ğ’Œ§
gIrs	ğ’Œ¨
gIrts	ğ’‰³
gIrz	ç¤•
gIs	ç¤µ
gIst	å˜•
gIsts	è³
gIt	å€¸
gIts	å¡ 
gIv	ä¤¥
gIvz	å€¹
gIz	ç–‚
gO	ç™”
gOd	ğ”’ˆ
gOl	ğ’ˆ 
gOlz	ğ’ˆ¡
gOn	ç™“
gOnd	ğŒƒ
gOnt	ğ‘€™
gOnts	ğ“Š“
gOnz	ç™•
gOs	ğ“Š‘
gOst	ğ“Š”
gOsts	ğ“Š•
gOz	ğ‘‘¹
gR	ã˜°
gRC	ğ’Œ’
gRd	ç¢
gRdts	ğ’Œ‚
gRdz	ğ’‰
gRk	ğ‘Œ¨
gRks	ğ“‰¹
gRkt	ğ“‰¸
gRl	å€¶
gRlz	å€·
gRm	ğ’Œ…
gRmz	ğ’Œ‡
gRn	ç™–
gRnd	ç™—
gRnz	ç™˜
gRp	ğ–™¤
gRs	ğ’Œˆ
gRst	ğ’Œ
gRt	ç—
gRts	ç˜
gRz	ã˜
gU	å§
gUd	å¦
gUdz	ğ’’‚
gUk	ğ’‘’
gUl	ğ’£
gUld	ğ•
gUlz	ğ•‘
gUn	ğ’šƒ
gUp	ğ’š˜
gUr	ğ’”–
gUrz	é¤ˆ
gUt	ğ’œ
gUz	è¦˜
gW	è™
gWd	ğ’”’
gWg	ğ’”“
gWgd	ğ’””
gWl	ğ“Œˆ
gWlz	ğ“Œ‰
gWn	å·
gWnz	å¸
gWs	ğ’‰˜
gWst	ğ“Œ‡
gWt	ğ‘Š
gWts	ğ‘Š‚
gY	å…‘
gYb	ğ’‰¹
gYbz	ğ’Œ¤
gYd	å…ƒ
gYdz	ğ’š…
gYl	è‰·
gYld	è¢
gYlz	ğ’Œ´
gYn	ğ’€
gYnz	ğ’
gYp	ğ’†
gYr	ğ’
gYs	ğ’Š€
gYst	ğ’Š
gYsts	ğ”‰
gYt	ğ’Š‚
gYts	ğ’Šƒ
gYv	ğ“Š‚
gYz	å…’
gYzd	ä”¡
g^	ã€¢
g^C	é‰—
g^b	ğ’š
g^d	ç¤´
g^dz	ğ“Œ’
g^f	ğ’š„
g^g	ç™™
g^gd	ç™ 
g^gz	ğ“Œ•
g^k	é‰´
g^l	ç”
g^lC	ğ’š
g^ld	è„’
g^lf	ğ‘‘´
g^lfs	ğ’š‘
g^lft	ğ‘‘µ
g^lp	ğ’š’
g^lps	ğ’š”
g^lpt	ğ’š“
g^ls	ğ“††
g^lz	æ€
g^m	å…†
g^md	ğ’š•
g^mp	å…‡
g^mps	ğ’š–
g^mz	å…ˆ
g^n	ã˜´
g^nd	èœ¸
g^ndz	ğ‘œ‚
g^ng	ğ“Œ˜
g^nk	ğŒ„
g^nkt	ç™¡
g^nkts	ç™¢
g^ns	ç°
g^nst	ğ’š—
g^nt	ç±
g^nts	ç²
g^nz	å…‰
g^p	ğ‘·
g^ps	ğ‘–
g^pt	ğ‘³
g^pts	ğ‘µ
g^s	å…
g^st	ä”¢
g^sts	ç™£
g^t	ç¤
g^ts	ç¥
g^v	ğ’”˜
g^z	ç’†
ga	ä¤§
gaC	ğ’”…
gaS	åµ
gab	éˆ‰
gabst	ğ“Š†
gabz	ğ’‘”
gad	å˜
gadz	å™
gaf	ğ’‘¥
gag	ç
gagd	ğ“Š‰
gagz	ğ¡‚
gak	ğ’†
gakn	ğ’‘•
gaks	ğ“Š‡
gal	ç¤–
galf	ğ’‘³
galfs	ğ’‘±
galft	ğ’‘²
galt	ğ’‰•
galz	ğ—
gam	ğ’ˆ‚
gan	å¡´
gand	ğ’’€
gans	ğ’‘¹
ganz	ç 
gap	ğ“Š™
gar	ã‚…
garb	ğ’ˆ—
garbd	ğ’ˆ˜
gard	å„¸
gardz	å„¹
garg	ğ’ˆ™
gark	ğ”©
garks	ğ”°
garl	ğ’ˆ¢
garmz	ğ’ˆ£
garn	ğ’ˆ¤
garnz	ğ’ˆ¥
garp	ğ’ˆ§
garps	ğ’ˆ¨
garsk	ğ’ˆ´
garst	ğ’ˆµ
gart	èˆ‰
gartsk	ğ’ˆ·
garz	è……
gas	ğ’ˆ¸
gast	è‰‰
gat	ä¤¦
gats	å¶
gavz	ğ’”¡
gaz	ğ’‰£
gc	ã¦•
gcC	ğ’‰‰
gcb	ğ’‰†
gcd	ğ“‰¤
gcf	ğ’‰‘
gcg	ğ’‰’
gcgd	ğ”™
gcgz	ğ–Œ™
gck	ğ’‰¢
gcl	ç˜ƒ
gclf	å¤
gclk	ğ’‰“
gclt	ğ’ˆ
gclz	ğ’†–
gcm	ğ””©
gcn	ä•‘
gcns	ğ’‰–
gcnt	ğ’ˆ“
gcnts	ğ“‰£
gcnz	é™¸
gcr	å³
gcrd	ğ’‘‘
gcrdz	ğ’”—
gcrg	ğ‘€•
gcrgd	ğ‘€–
gcrk	ğ’‘™
gcrl	ğ’Œ„
gcrm	ğ’Œ˜
gcrn	ğ’’˜
gcrsk	ğ“¤‘
gcrt	ğ’‘¡
gcrts	ğ’‘ 
gcrz	ğ’’—
gcs	è•©
gct	è¡¹
gcz	ğ’‰—
ge	ãŠ‰
geb	ğ’…¹
ged	é’ˆ
gedz	é’‰
geg	ğ‘€‘
gegd	ğ‘€’
geks	ğ“‰‘
gel	ã„ˆ
geld	ğ“‰
gelz	ä¦’
gem	ã”©
gemz	ä¦”
gen	éŒ´
gend	ä¦“
genz	ğ’†“
gep	ç¡
ges	éŒ–
gesk	ğ’‰‚
get	å€ƒ
gets	å€„
gev	å€†
gez	å€‡
gezd	ğ’‰¥
gi	ã¦
gib	ğ”Š„
gibz	ğ”Š…
gid	é‰˜
gik	ğ’‰§
giks	è¤‘
gil	é¡
gild	ğŠ—
gin	ç€
ginz	éˆ–
gip	ğ’‡
gips	ğ“‰°
gir	å€ˆ
gird	ğ‘„•
girz	å€‰
gis	å€
gisk	ğ’Œ©
git	é’‚
gits	ğ’††
giv	ğ”¦
givz	ğ“‰±
giz	ã” 
gl	ğ’¦
gl@	ä´
gl@b	ğ’”
gl@d	å€
gl@k	ğ’
gl@n	ğ’˜
gl@nd	è¥’
gl@ndz	ğ’¡
gl@ns	ğ’™
gl@nst	ğ’ 
gl@nts	ğ’¢
gl@nz	ğ’£
gl@s	å
gl@st	ğ’³
gl@t	ğ’´
gl@ts	ğ’µ
gl@z	ğ’„
glE	ğ’§
glEd	ğ’‘
glEg	ğ’’
glEk	å ©
glEkt	ğ”Œ‡
glEkts	ğ”Œˆ
glEmp	ğ’“
glEn	ğ’”
glEnz	ğ’–
glEr	ğ’¤
glErd	ğ’¥
glErz	ğ’¦
glEs	ğ’—
glEt	ğ“†ˆ
glEts	æ€–
glEv	ğ“¤
glI	ç†
glIC	ğ’‡
glIG	æ¤¨
glIS	äœ
glIb	ğ’˜
glIf	ğ’¤¦
glIfs	ğ’¤§
glIk	ğ’™
glIm	è„•
glImf	ğ’‘€
glImp	ğ’„
glImps	ğ’‚
glImpst	ğ’ƒ
glIn	è„–
glInd	ğ’‘
glInt	ğ’†
glInz	ğ”‚‡
glIs	ğšˆ
glIt	ğ’ˆ
glIts	æ€—
glOd	ğ’¨
glOn	ğ”€ˆ
glR	ç…
glRz	è„”
glUr	ğ’ 
glW	ğ’¸
glY	è¡¸
glYd	ğ’€
glYdz	ğ’
glYk	ğ‘„˜
glYn	ğ‘†
glYnz	ğ’…
glYz	ğ“¤‰
gl^	è„—
gl^b	å‘
gl^k	ğ’©
gl^ks	ğ’°
gl^m	ğ’³
gl^mp	å“
gl^mz	ğ“‰ˆ
gl^n	è„“
gl^nd	è¥“
gl^ndz	ğ‘‘±
gl^nt	ğ’´
gl^nts	ğ’µ
gl^nz	ğ’¶
gl^s	ç©
gl^t	ğ’·
gl^ts	ğ’¹
gl^v	å‰
gl^vd	ğ’¥
gl^vz	å
gla	ç´
glab	ğ’“
glabz	ğ’“
glad	ğ’•
glak	ğ’”
glam	ğ’˜
glap	ğ’¡
glarz	ğ– ¨
glas	ğ””¨
glat	ğ’£
glats	ğ’¤
glc	åˆ
glcb	ğ’·
glcd	ğ’¹
glcf	ğ‘±
glcn	ğ”€‡
glcr	ğ’¢
glcs	å‡
glcst	ğ’°
glcz	ğ’€
gle	ğ’–
gled	ğ’—
gledz	ğ‘˜‰
gles	ğ’•
glet	ğ’¶
glez	ğ’‚
glezd	ğ’ƒ
gli	æ™‚
glim	ç„
glimd	ğ’…
glimz	ğ’†
glin	ğ’‡
glind	ğ’ˆ
glis	ğ‘°
gliv	ğ’‰
glivz	ğ’
gliz	ğ“†‡
glo	å„
glob	å‚
globz	ğ’’
glod	ğ’—
glok	ğ’–
glom	ğ’‰
glon	ğ”€‰
glos	è„˜
glot	ğ’
glots	ğ’‘
gloz	çˆ
glu	åƒ
glud	å’
gluk	ğ’±
glum	ğ’™
glut	ğ’¸
gluz	ğ’²
glxnd	äœ‰
go	ã‰„
goC	ğ’‘¢
gob	ğ“Š…
gobz	ğ“Š„
god	ğ‘³
gog	ğ’‘¦
gok	ğ’‘—
goks	ğ“Š—
gokt	ğ“Š–
gol	å•
gold	å¡
goldz	ğ’‘¨
golf	ğ‘²
golt	ğ’‰”
golts	ğ’‘´
golz	ğ’‘‰
gom	ğ’‘µ
gon	è‰µ
gonz	ğ’‘
gop	ğ’‘˜
gos	ğ‘‚“
gost	å€¢
gosts	ğ’Œ™
got	å–
gotC	ğ’‘£
gots	å—
gotz	ğ’‘¤
gov	ğ’”™
goz	ã‘
gr	ğ’•“
gr@	ä‰ƒ
gr@b	å¹
gr@bd	å‚€
gr@bz	å‚
gr@d	ğ’”¥
gr@dz	ğ’”¦
gr@f	ã‘³
gr@fs	ç¥…
gr@ft	è”„
gr@fts	ğ’”±
gr@g	ğ’”³
gr@m	å‚†
gr@md	ğ¥ˆ
gr@mps	å‚‡
gr@mz	å‚ˆ
gr@n	å‚
gr@nd	å‚‰
gr@ndz	ğ’•
gr@nt	å‚”
gr@nts	ğ’•‚
gr@s	å‚˜
gr@sp	å‚—
gr@sps	ğ’•†
gr@spt	ğ’•…
gr@st	ğ’•‡
gr@t	æŒ¤
gr@ts	æŒ¥
gr@v	ğ’•˜
gr@z	ğ’•„
grE	ã‰
grEb	ğ’”§
grEbz	ğ—„
grEf	ğ’•´
grEg	å„†
grEgz	ğ’•µ
grEk	ç’
grEl	ğ’–„
grEm	ğ’–…
grEn	ç ‡
grEnz	ğ’–‡
grEs	ç¶
grEst	ğ¥°
grEt	ğ’–ˆ
grEts	ğ’–
grI	å„‰
grIC	ğ’‚
grIb	ğ“™¤
grId	ğ’–’
grIdz	ğ’–“
grIf	ğ‚
grIft	ğ–™“
grIfts	ğ–™”
grIg	ğ’•¶
grIgz	ğ’–˜
grIk	ğ–˜…
grIl	å„
grIld	å„‘
grIlz	ğ’˜‚
grIm	ç ˆ
grImz	ğ’˜…
grIn	å„’
grInC	å„“
grInd	é¢„
grInz	ğ’˜‰
grIp	å„–
grIps	ğ’˜”
grIpt	ğ’˜“
grIr	ğ’•¢
grIs	è€˜
grIst	ğ’Œ 
grIt	å„—
grIts	å„˜
grIz	å„™
grO	ğ’–‰
grOd	ğ”Œ‰
grOn	ğ’˜¦
grOnd	ğ’˜§
grOnz	ğ’˜¨
grU	ğ’™¤
grUn	ğ’™£
grUnd	ğ’™°
grUt	ğ’™¥
grW	å„£
grWC	å„¢
grWl	å„¨
grWld	å„©
grWlks	ğ’™†
grWlz	ğ’™•
grWn	ğ’™‡
grWnd	ã”‰
grWndz	è–„
grWnz	ğ’™ˆ
grWs	ğ’™
grWst	ğ’™‘
grWt	ğ’™’
grY	ğ’”µ
grYf	ğ’•·
grYm	ğ’˜ƒ
grYmz	ğ’˜„
grYn	å„•
grYnd	å„”
grYndz	ğ’˜ˆ
grYp	ğ’˜
grYps	ğ’˜’
grYpt	ğ’˜‘
grYs	ğ’–‘
grYts	ğ’–‚
grYz	ğ’–—
gr^	çµ
gr^b	ğ’™—
gr^bz	ğ’™™
gr^d	ğ’™¡
gr^f	å™‰
gr^ft	ğ”–€
gr^g	è¢€
gr^l	ğ“ˆ€
gr^lk	ğ’™§
gr^m	å„³
gr^mp	ğ’™¨
gr^mz	ğ”™
gr^n	å„´
gr^nd	ğ’™©
gr^ng	ğ’™²
gr^ns	ğ’ƒ
gr^nt	å„µ
gr^nts	å„¶
gr^p	ğ’™³
gr^s	ğŒ€
gr^st	ğ”–
gr^t	ç¢•
gr^ts	ğ”•
gr^v	ğˆ˜
gr^z	ğ‰©
gra	ç˜
grab	ğ’˜˜
grad	è¤’
gradz	è¤”
graf	ğ™
graft	ğ’˜¤
grag	ğ’˜¥
grak	ğ’˜ 
gral	ğ’”´
gram	ğ’˜°
gramz	ğ”
gran	ğ’˜²
grang	ğ ‘
grap	ğ’˜¸
gras	ğ’™
grat	ğ’•¡
grats	ğ’™…
grc	ğ 
grcf	ğ ƒ
grcl	ğ’”¹
grcnk	ğ’•”
grcr	ğ”€’
grcs	ğ’˜¹
grcv	ğ’™”
gre	å‚ƒ
greb	ğ’”£
gred	å‚„
gredz	è¤“
gref	ğ’”°
greg	ğ’”²
grel	ğ’”¶
grem	ğ’”¨
gremz	ğ’•€
gren	å‚…
grend	ğ’”·
greng	ğ €
grenk	ğ’–€
grenz	ğ’”¸
grep	å‚•
greps	å‚–
gres	å‚‚
grest	ğ‘€—
gret	å‚™
grets	å„ƒ
grev	è¤•
grevd	ğ‘‘²
grevz	ğ’••
grez	ğ‘‘ƒ
grezd	ğ’• 
gri	ã‰…
grib	ğ’•¥
grid	ã‰†
grif	å„ˆ
grig	ğ’•¸
grik	å„„
griks	ğ’•¦
gril	ğ”€‘
grim	ğ’•¹
grin	å„…
grind	ğ’•§
grinz	ğ‘˜
grip	ğ’–”
grir	ğ’–•
grirz	ğ’––
gris	å„‚
grist	ğ’•£
grit	ğ’•³
grits	ğ’”©
griv	ç·
grivd	ç¸
grivz	ğ’•¤
griw	ğ’–ƒ
griz	ä‘”
gro	å„ 
groT	å„²
grob	ğ’˜™
grod	ğ’˜¡
grol	ğ’˜©
gromz	ğ’˜±
gron	å„°
grond	ğ’˜–
gronz	ğ’˜—
grop	ğ’˜£
gropt	ğ’˜·
gros	å„¡
grost	ğ‘‘³
grot	ğ ‚
grots	ğ’™–
grov	ğˆ—
grovz	ğ’™“
groz	ğ’™€
gru	å„‡
grub	ğ’™ 
grud	ğ’Œƒ
grulk	ğ’™¦
grum	é‘¸
grumd	ğ’˜³
grumz	é‘¹
grun	ğ’™¢
grunk	ğ’–
grup	å„¥
grups	å„¦
grupt	ğ’™‰
grut	ğ „
gruv	ğ’˜µ
gruvz	ğ’˜¶
gruz	ğ’˜´
grx	ã‰€
gu	å€¨
guC	ğ’’
gub	ğœ‡
gubz	ğœˆ
gud	ğ“Œ“
gudz	ğ“Œ”
guf	å°
gufs	ğ’’‡
guft	ğ’’†
gug	ğ’’ˆ
guk	ğ’š‚
guks	ğ“Š€
gul	ğ‘ˆ¥
guld	ğ’’‰
guldz	ğ’”•
gulh	ğ“Œ…
guls	ğ’’
gulz	ğ‘ˆ¦
gun	é™‡
gunz	ğ’’‘
gup	ğ‘•
gups	ğ‘—
gur	ğ“Œ†
gus	å²
gust	ğ‘œ“
gut	ğ’œ‚
guv	ğ“Œ¢
guz	ğœ…
gwI	ä©
gwIJ	å”¥
gwIn	å¦”
gwa	å‘
gx	ã”µ
gxl	ãŒ¶
gxld	æ™
gxlz	å€©
gxn	ä–ƒ
gxnt	äš„
gxnz	ä–„
gxs	ã‘„
gxst	ã‘²
gxz	å‘£
gyR	ä¡€
gyu	ã‘
gyx	ã”
h	åŒ—
h@	ã€£
h@C	ğ’œ“
h@CllG	å†“
h@Ct	ğ’ „
h@G	å…´
h@Gz	å†€
h@S	å†
h@Ul	ã˜
h@b	ã‰‡
h@bz	ğ’œ‘
h@d	å…–
h@f	å…—
h@fs	å…¦
h@ft	ğ’œ¡
h@fts	ğ’œ¢
h@g	å…˜
h@k	ğ’œ”
h@ks	ğ’œ–
h@kt	ğ’œ•
h@l	ğ’œ¶
h@lf	ğ’ƒ
h@lz	ğ’œ·
h@m	å…¨
h@md	ğ’
h@mp	ğ’’
h@mz	ç‘²
h@n	å…²
h@nd	å…°
h@ndz	å…±
h@nf	ğ’ 
h@nft	ğ’¡
h@nk	ğ’¤
h@nks	ğ’¥
h@ns	ğ‘‘·
h@nst	ğ‘‘¸
h@nt	ğ’§
h@nts	é–‘
h@nz	éœ¢
h@p	ğ’¨
h@ps	æ€
h@r	ğ’‰
h@s	ğ’—
h@sk	ğ’˜
h@st	ğ’™
h@t	å†’
h@ts	å†–
h@v	å†—
h@vd	ğ’ˆ
h@vz	ğ’‰
h@z	å†‰
hE	å…¢
hEJ	åˆ£
hEb	ğ’¡‰
hEd	ã‰ˆ
hEdz	åˆ‰
hEf	ğ’œ˜
hEft	ğ’¡¡
hEg	ğ’¡•
hEgd	ğ’¡–
hEgl	ğ’¡±
hEk	åˆ¢
hEks	ğ’¡”
hEkst	ğ’¤˜
hEkt	ğ’¡’
hEkts	ğ’¡“
hEl	åˆ’
hElT	åˆ‘
hEld	åˆ¥
hEldz	ğ’¡´
hElf	ğ’”ˆ
hElk	ğ’¡µ
hElm	ğ’„‰
hElmk	ğ’¡¸
hElmz	ğ’¡·
hElp	åˆ¨
hElps	åˆ°
hElpt	åˆ©
hElt	ç•“
hElts	ğ’ ²
hElz	ğ’¡¶
hEm	ç¢–
hEmd	ğ’¢€
hEmp	ğ’¢
hEmz	é€
hEn	åˆ±
hEnC	ğ’¢„
hEnd	èˆ•
hEndz	ğ‰¡
hEng	ğ–„°
hEngst	ğ’¢†
hEnk	ğ’¢‡
hEnks	ğ’¢ˆ
hEns	ğ’¢ƒ
hEnt	ğ’¢‘
hEnts	ğ’¢’
hEnz	åˆ²
hEp	ğ’¢“
hEr	å…£
hErd	ğ•˜¦
hErt	ğ’¢—
hErts	ğ’¤†
hErz	å††
hEs	ğ’¤‘
hEst	ç¤¢
hEt	ğ’¡„
hEts	ğ’¤”
hEv	ğ’¤—
hEz	ğ’¤’
hI	åˆ´
hIC	ğ’¥¥
hICt	ğ’¥¦
hIb	ğ’¤¢
hIbz	ğ’¤¡
hId	å‰
hIf	ğ“™‰
hIg	ğ’¤¨
hIgz	ğ’¤©
hIk	ğˆƒ
hIks	ğ’¤£
hIl	å‰
hIlb	ğ’¤¶
hIld	é•²
hIlg	ğ’¤¸
hIlm	ğ–¢•
hIlmz	ğ’¥
hIlt	ğ’¥‚
hIlts	ğ’¥ƒ
hIlz	å‰‘
hIm	å‰’
hImz	ğ“„¦
hIn	ğ‘¸
hInC	ğ’¥…
hInJ	å‰“
hInd	ğ’¥‡
hIndz	ğ’¥ˆ
hIng	ğ–˜¨
hIngd	ğ’¥
hInk	ğ’¥†
hIns	ğ’¥’
hInst	ğ’¥‘
hInt	å‰”
hInts	ğ’¥“
hIntz	ğ’¥”
hInz	ğ’¥•
hIp	å‰•
hIps	å‰–
hIr	ç™†
hIrd	ç™‡
hIrn	ğ’¤€
hIrz	ç™‰
hIs	ğ’Š’
hIst	ğ’¥£
hIt	å‰™
hIts	å‰ 
hIv	ğ‘¡¨
hIz	å‰˜
hO	ğ †
hOl	ğ’¦–
hOn	ğ“±
hOst	è€¹
hOsts	ğ’¦—
hOt	ğ’¦˜
hR	åˆ³
hRb	ğ’¢”
hRbst	ğ’¢–
hRbz	ğ’¢•
hRd	åˆ–
hRdz	ğ’¢™
hRk	ğ’¤
hRl	ğ’ µ
hRld	ğ“„‘
hRm	ğ’¤‚
hRmz	ğ’¤ƒ
hRn	ç …
hRnz	ğ’ ¶
hRrt	ğ’¢˜
hRs	ğ’ ·
hRsk	ğ’¥™
hRst	ç¤¸
hRsts	ğ’ ¸
hRt	åŒ¶
hRts	åŒ·
hRtz	ğ’¤‡
hRv	ğ’¤‰
hRz	åˆµ
hU	åŠˆ
hUbs	ğ“‚
hUd	åŠ…
hUdz	é¦†
hUf	ğ–™•
hUfs	ğ“€¤
hUft	ğ“€¢
hUk	åŠ†
hUks	åŠ‰
hUkt	åŠ‡
hUl	ğ“‚ƒ
hUn	ğ“Œ™
hUt	ğ‘
hUvz	ğ“€°
hW	ã¡
hWb	ğ’ ˆ
hWd	åŒ–
hWg	ğ“‰
hWk	ğ“ˆ
hWl	ğ“‘
hWld	ğ“©
hWlz	ğ“°
hWn	ğ“’
hWnd	åŒ’
hWndz	é†‘
hWnz	é†’
hWpt	ğ’ •
hWr	ğ–œ´
hWs	ä•’
hWsk	ğ“˜
hWt	ğ¥–
hWts	ğ“¡
hWz	åŒ”
hWzd	ğ“•
hY	ä‘•
hYC	ğ“„¢
hYd	å‰‚
hYdt	ğ’¡¢
hYdz	ğ’¤¤
hYk	å‰‰
hYks	ğ’¤µ
hYkt	ğ’¤´
hYl	ğ’
hYlz	ğ’¤·
hYm	è¶
hYmz	ğ‘Œ€
hYn	è™
hYnd	ã˜¸
hYndz	è¢‡
hYnk	ğ’¡¥
hYnt	ğ’¡§
hYnts	ğ’¡¦
hYnz	ğ’¡¤
hYp	ğ’¤°
hYps	ğ“„©
hYpt	ğ“„¨
hYr	å‰‡
hYrd	å‰—
hYrz	ğ’¥˜
hYs	ğ’¡¨
hYst	ğ’¡©
hYt	å€¡
hYts	ğ‘œ„
hYv	è¡°
hYvz	ğ’¥§
hYz	ğ’¤±
h^	å‰¸
h^C	ğ“¸
h^G	åŒ²
h^S	å
h^b	ğ“µ
h^bz	ğ“¶
h^d	ğ‘„
h^dz	ğ“‚€
h^f	åŒ¡
h^fb	ğ“‚„
h^fs	ğ“‚…
h^ft	åŒ¢
h^g	åŒ£
h^gd	åŒ¥
h^gz	åŒ¦
h^k	é‰¤
h^ks	ğ“¹
h^l	è¢ˆ
h^ld	ğ“‚’
h^lg	ğ’•©
h^lk	ğ“‚‰
h^lks	ğ“‚
h^lm	ğ“‚“
h^ls	ğ“‚ˆ
h^lst	ğ“‚”
h^lt	è„£
h^lts	ğ“‚•
h^lz	ğ“‚‘
h^m	åŒ§
h^mf	ğ“‚˜
h^mp	åŒ¨
h^mpt	ğ“‚—
h^mz	ğ“‚™
h^n	åŒ©
h^nC	ğ“„€
h^nCt	ğ“„
h^nd	ğ“„‚
h^nk	ğ“„…
h^nks	ğ“„†
h^ns	ğ“„‡
h^nt	åŒ´
h^nts	ğ“„ˆ
h^nz	èˆ
h^p	ğ“„
h^s	ğ“„’
h^sk	ğ€
h^sks	ğ
h^st	ğ“„“
h^t	å‚
h^ts	ğ“„•
h^v	ğ“¤
h^y	ğ’¦™
h^z	åŒ¸
ha	ã‰‰
haC	é€³
haG	åŠ
hab	æˆ„
habs	ğ’¥¸
habz	ğ’¥·
had	ğ’¥¹
hadz	ğ’¦‚
haf	è¢’
hafb	ğ’¦‘
hafs	ğ“†‰
hag	å‰¥
hagz	åˆ¤
hak	å‰±
haks	ğ“€‚
hal	ç „
hald	ğ’€
halm	ğ’…
ham	è”·
hamz	ğ“€‘
han	æ£
hans	ğ’¦
hant	ğ¥†
hants	ğ“€–
hanz	ğ’•
hap	åŠ“
hapf	ğ“€±
haps	åŠ™
hapt	åŠ—
har	ã¡‰
harb	ğ’±
hard	å†„
hardz	éˆˆ
harf	ğ’µ
harg	ğ”
hark	ğ’²
harks	ğ’¶
harl	ğ’·
harm	å†‡
harmd	ğ’¹
harmz	ğ’¸
harn	ğ’€
harnd	ğ’
harp	ğ’‚
harps	ğ’‡
harpst	ğ’ˆ
harpt	ğ’ƒ
hars	ğ’‘
hart	åˆ˜
harts	åˆ™
harv	ğ’”
harz	ğ•–‘
has	åŒ†
hat	åŒ‰
hats	åŒ‘
hav	ğ’ ˜
hay	ğ’œ²
haz	ğ …
hc	å‰¤
hcC	ğ’ ‰
hcG	åŠ‚
hcGk	åŠ€
hcb	ğ’ ‡
hcf	ç¦’
hcfp	ğ’¦’
hcfs	ğ’‚‚
hcg	å„¤
hcgz	ğ•Š‰
hck	å†™
hcks	é„€
hckt	ğ’ ¢
hcl	ã‰²
hcld	ğ’œ¹
hclt	ğ‘€
hclts	ğ’‡
hclz	ğ’„
hcn	åˆ€
hcnks	ğ“€•
hcnt	ğ’ ‘
hcnts	ğ’ ’
hcp	ğ’¥–
hcpt	ğ’ ”
hcr	åŒ‚
hcrd	ç¹
hcrdz	ğ’¥µ
hcrk	ğ“€´
hcrn	åŒ
hcrnd	ğ“€·
hcrnz	åŒƒ
hcrs	åŒ„
hcrsp	ğ“€¸
hcrst	è€
hcrt	ğˆ„
hcrts	ğˆ…
hcrz	ç‘
hcs	ğ“‚
hct	ğ’ 
hcv	ğ“£
hcz	ğ’ ¡
he	ã˜¶
heG	å…¹
hed	ğ’œ—
hedt	ğ’¤™
hef	ğ’œ 
heg	ğ’œ£
hegz	ğ’œ¤
hek	ğ’œ¥
heks	ğ’œµ
hel	ğ’œ¦
held	ğ’œ§
helt	ğ’†
helz	ğ’œ¨
hem	ğ’œ©
hemz	ğ’œ°
hen	ğ˜†
henz	ğ’œ±
hep	ğ’°
her	å…™
herd	å…¡
herz	å… 
hes	ğ’¤ 
hesk	ğ’ 
hest	ğ’ ‚
het	å†”
hets	å†•
hev	è¢‚
hevd	ã˜µ
hevz	è¢ƒ
hez	ğ ¡
hi	åˆ„
hib	ğ’¡
hid	åˆ…
hidz	ğ’¡˜
hif	ğ’ ©
hig	ğ’ °
hik	ğ’¡™
hil	åˆ†
hild	ğ’ ±
hilz	åˆ
him	ğ’¡ 
himz	ğ’¤¥
hin	ğ’‘§
hinz	ğ’¢…
hip	åˆ“
hips	ğ’ ´
hipt	åˆ”
hir	åˆ•
hirz	åˆ—
his	ğ’œ™
hit	åˆ 
hits	ğ’¡ƒ
hiv	ğ’¡†
hivd	ğ’¡‡
hivz	ğ’¡ˆ
hiz	åˆ‡
ho	å‰£
hoI	ã‰
hod	ğ’¥±
hodz	ğ’¦€
hof	ğ’¦…
hofs	ğ’¦†
hoft	ğ’¦‡
hog	ğ’¥²
hogst	ğ’¦”
hok	ğ’¥³
hoks	ğ’¥¶
hokst	ğ’¦ƒ
hoksts	ğ’¦„
hol	ã¤¨
hold	å‰§
holdz	å‰¨
holk	ğ“€€
holm	ğ¡ 
holmz	ğ“€ƒ
hols	ğ“€„
holst	ğ“€†
holt	ç™…
holts	é–†
holz	å‰°
holzh	ğ“€‡
hom	å‰³
homd	ğ“€ˆ
homz	å‰µ
hon	ğ’¥´
hond	ğ“€’
honz	ğ“€“
hop	åŠ”
hopf	ğ’¦ˆ
hopk	ğ“€²
hops	åŠ–
hopt	åŠ•
hos	ğ’¦‰
host	è€´
hosts	åŒˆ
hot	ğ’ —
hotz	ğ“‡
hov	ğ’¦
hovd	ğ“¢
hoz	åŒ…
hozd	ğ“ƒ
hu	åŠ„
huC	ğ“€—
hud	è™§
huf	ğ“€¡
hufs	ğ“€¥
huft	ğ“€£
hug	ğ“€¦
huk	ğ“€˜
hul	ğ“€¨
hum	ç‰¦
hun	éœ‡
hup	åŠ
hups	åŠ‘
hupt	ğ““
hus	ğ“€©
hut	åŠ’
huts	éœˆ
huv	è¢“
huvz	è¢”
huw	ğ“„–
huz	ç‰¤
hx	å…¤
hxm	å‰¡
hyElm	ğ’¥¨
hyR	ğ“¤–
hyRp	ğ’¥©
hyU	ğ’¤–
hy^n	ğ“„°
hyo	ğ“„§
hyu	åŒ 
hyuJ	åŒ¤
hyub	ğ“·
hyud	ğ“‚‚
hyum	ğ‘™„
hyumd	ğ‘™…
hyumz	ğ‘™†
hyun	ğ’¤•
hyup	ğ“„‰
hyuz	ğ‘„µ
i	ã€¨
iC	ä™ˆ
id	é™ƒ
idz	ğ‘Œ±
if	ğ•‰°
ig	ğ‘¢
ik	ğ‘™
iks	ğ‘Œ²
ikt	ğ‘€
il	ä™§
ilz	ğ‘Œ³
im	ğ“†
imz	ğ‘Œ´
in	ä™¨
ind	é¨
inz	éœ‚
ip	ğ‘Œµ
ips	ğ‘”¢
ir	ä™‰
irz	ä™•
is	å˜³
ist	ä™ 
ists	ğ‘„
it	ä™¡
its	ä™¢
iv	äœ²
ivd	è¥‡
ivz	ğ‘‰
iz	ã–
izd	ğ‘ƒ
jR	å™£
jU	æ¡•
ja	å¥‚
jc	å™¤
ju	ç„´
k	äŒ‘
k0	ğ±
k@	ã„±
k@C	ã¦”
k@G	å‘¢
k@T	å‘¨
k@b	éš„
k@bz	éš…
k@d	éš–
k@ds	éœ€
k@dz	ğ™‰
k@f	ã¥‚
k@fs	éœ—
k@ft	éœ˜
k@g	éœ…
k@k	ã¤µ
k@ks	éš“
k@l	ã¥€
k@lb	ğ ‰
k@lf	ğ”€©
k@lk	ğ“Œ±
k@lm	ğ“Œ²
k@lp	ğ“Œ³
k@lt	ğ“Œµ
k@lz	ç ¦
k@m	ã¥“
k@mp	ã¥’
k@mpf	ğ“Œ¸
k@mps	ã¥–
k@mpt	ã¥•
k@mz	éœ±
k@n	ã¥˜
k@nd	ç†’
k@ng	ğ“
k@nk	ğ–¤°
k@ns	ğ”€€
k@nt	ã¥™
k@nts	ğ“‚
k@nz	ã¥£
k@p	ã¥¥
k@ps	éˆ
k@pt	å…³
k@r	é°
k@rz	ğ—‚†
k@s	éš”
k@sk	é ‚
k@sks	é „
k@sp	ğ“”
k@st	è€¨
k@sts	ã¦‡
k@t	ã¦ˆ
k@ts	ã¦‰
k@tz	é‰
k@v	é¡
k@vz	éœ°
k@z	ç‘‰
kE	ã¦€
kEC	ğ“–
kEd	ğ“²
kEdz	ğ“¨
kEg	ğ“±
kEgz	ğ“²
kEk	ğ“¦
kEkst	ğ“µ
kEl	å‘´
kElC	ğ“¶
kEld	ğ•…™
kElk	ğ“·
kElm	ğ“¹
kEln	ğ“€
kElp	ğ“
kElps	ğ“‚
kEls	ğ“ƒ
kElt	é¡•
kElts	é¡—
kElz	ğ“¸
kEm	é–
kEmd	é¥‰
kEmp	ğ“„
kEmpf	ğ“†
kEmpk	ğ“‡
kEmps	ğ“…
kEmpt	ğ–˜°
kEmz	ğ”€°
kEn	å‘µ
kEnd	çˆ©
kEndz	è–ƒ
kEnt	ğ“
kEnts	ğ“‘
kEnz	ğ“ˆ
kEp	ğ“’
kEpt	å‘¶
kEr	ä¶
kErd	é§
kErn	éœ
kErnz	éœ‘
kErt	è¤…
kErz	è€±
kEs	é¥˜
kEsk	ğ“•
kEst	ğ“Œ§
kEt	æŠ™
kEts	ğ“—
kEv	ğ“€
kEz	ğ’¢
kI	ãœ
kIC	ğ“‘
kIG	ã‘¦
kIGz	å’’
kIJ	å¤±
kIb	ğ“†
kId	å’ƒ
kIdz	å’„
kIf	ğ“—
kIg	é…¹
kIgd	ğ”””
kIk	å’€
kIks	å’‚
kIkt	å’
kIl	å’…
kIld	å’†
kIln	ğ“™
kIlnz	ğ“ 
kIlt	éŒ‘
kIlts	ğ“£
kIlz	å’‡
kIm	å’ˆ
kImp	ğ“¦
kImz	ğ“Šƒ
kIn	ã‚„
kInC	ğ“¨
kInd	ğ‘˜
kIngz	ğ“±
kInks	ğ“³
kInst	ğ“´
kInt	ğ“©
kInts	ğ“µ
kInz	ä©
kIp	ğ“¸
kIps	ğ“¹
kIr	é¦™
kIrn	ğ“³
kIrst	ğ““
kIs	å’“
kIst	å’”
kIsts	è‚‚
kIt	ã•µ
kIts	ãœ‚
kIz	ğ“‘‰
kO	ğˆ
kOGk	å¢†
kOd	ğ”™¨
kOg	ğ”€„
kOk	ğ“”£
kOl	ğˆˆ
kOld	ğˆ‰
kOlz	ğˆ‘
kOm	ğ‘
kOn	è‘¢
kOnd	ğˆ’
kOnz	ä†˜
kOt	ğˆ“
kOts	ğˆ”
kOz	ğ°
kR	ã€ˆ
kRC	ğ“‘
kRb	ä„
kRbd	ğ˜”
kRbz	ğ˜•
kRd	å¡³
kRdz	ä…
kRf	ğ˜˜
kRk	ğ‘Š
kRks	ğ“‘‚
kRl	ä‡
kRld	äˆ
kRlz	ğ˜™
kRm	ğ“‘ƒ
kRn	ç•µ
kRnz	ğ“£
kRs	ä‰
kRst	ğ˜ 
kRt	ç•¹
kRts	ğ˜¡
kRv	ğ˜£
kRvd	ğ˜¤
kRvz	ğ˜¥
kRz	ã††
kU	ä‰©
kUd	äŠ—
kUk	ä‰§
kUks	ä‰°
kUkt	ä‰¨
kUl	ğ“˜
kUm	ğ“˜–
kUn	ğ“˜‘
kUnz	ğ“˜’
kUr	ç•—
kUrs	ğ“˜¹
kUrz	ğ“”¸
kUs	ğ˜§
kUt	ğ”‘
kUtsk	ğ“ˆ¥
kW	äŠ•
kWC	äŠ”
kWCt	ğ”
kWb	ğ–¥©
kWd	ğ‘€
kWf	ğ“—
kWl	ğ–
kWn	ã…¤
kWns	ğ—
kWnt	ã…¢
kWnts	ã…£
kWnz	ğ“•”
kWr	ğ”˜³
kWs	ğ³
kWt	ä‰
kWts	é„‚
kWz	äŒ
kY	ä¦
kYd	ğ†ˆ
kYl	å”“
kYlz	å””
kYm	ğ“¤
kYmz	ğ“¥
kYn	å’
kYnd	å’‰
kYndz	å’‘
kYnz	ğ“°
kYr	ç¤¨
kYrnz	ğ“´
kYs	ğ“•
kYt	å’•
kYts	ğ“‘‘
kYv	è‰¥
kYvz	è‰¦
kYz	é–
k^	ã…¦
k^C	ğ“Œ¦
k^G	å”‘
k^b	ä´
k^bz	ğ˜€
k^d	ä¸
k^dz	ğ“ˆ
k^f	ç˜“
k^fs	ğ˜ƒ
k^ft	ğ˜‚
k^g	ğ“œ˜
k^gd	ğ” ©
k^k	è••
k^ks	ğ“¡©
k^l	ä€
k^ld	è¦
k^lf	ğ”¡
k^lp	ğ˜ˆ
k^lt	ğ˜
k^lts	ğ˜‘
k^lz	ç–
k^m	ã˜’
k^md	ğ–ˆ±
k^mf	ğ–˜—
k^mp	ç•
k^mpf	ğ“˜—
k^mpt	ğ“œ¦
k^mz	ã˜“
k^n	äŒ€
k^nd	è‰”
k^ndz	ğ”‚˜
k^nk	ğ“˜“
k^ns	ğ“†“
k^nst	ğ’œ€
k^nt	èˆ‘
k^nts	èˆ’
k^ntz	ğ“˜ 
k^nz	ç…
k^p	ä
k^ps	äƒ
k^r	é¢
k^s	ä”™
k^sk	ğ˜©
k^sp	ğ˜±
k^st	ä¤‘
k^sts	ğ“ ¡
k^t	ä“
k^tn	ğ
k^ts	ç•¨
k^v	ğ–¥³
k^z	ä
k^zn	ğ“˜¡
ka	ã…“
kaC	ğ“Œ¥
kab	ä†
kabz	ğ†€
kad	ğ†“
kaf	ğ“Œ¨
kag	éœ†
kak	ä†”
kaks	ç˜°
kakt	ğ††
kal	ç ¥
kald	ğ•¡„
kalm	éœ¦
kalmd	éœ¥
kalmz	éœ§
kalz	éœ¡
kam	ã…•
kamd	è¡
kamp	è°
kamt	ğ“œ§
kamz	éšˆ
kan	äˆ¨
kanC	ğ‰³
kand	ğ‰¹
kank	ğ‰´
kant	ğ•™…
kanz	ç†
kap	åˆ¦
kapf	ğ‘œ…
kaps	ä‰·
kapt	ğ©
kar	ã¥¨
karC	ğ“…
karb	ç¢ˆ
kard	ã¥±
kardz	ã¥³
karg	ğ“‡
kark	éµ
karl	ã¥·
karls	é¸
karlz	é¶
karn	é
karnz	é‚
karp	é…
karpf	ğ“ˆ
kars	éˆ
karst	ğ“‰
kart	ã¦ƒ
karts	ã¦†
karv	èŒ§
karvd	èŒ¨
karvz	é”
karz	ã¥©
kas	é–
kast	ğ‡
kat	ã˜
kats	ã™
kav	è¥
kavz	è¦
kaw	ç¡–
kaz	ç‘ˆ
kc	ã¥†
kcC	ğ“”™
kcf	äŠ–
kcfs	è˜·
kcft	ğ•
kcg	ç–†
kck	è•´
kcks	ğ’ˆƒ
kckt	ğ†‡
kcl	ã¥„
kcld	ã¥…
kclm	ã¥ˆ
kclt	ğ“Œ´
kclz	ã¥‡
kcm	ğ‘–
kcn	ç’•
kcng	ğ“”²
kcngz	ğ“”³
kcnt	ğŒ¨
kcnz	è—
kcp	ğ“˜
kcpf	ğ“•
kcr	ã…‘
kcrb	ğ“•ƒ
kcrd	ã… 
kcrdts	ğ³
kcrdz	ä‰¸
kcrf	ğ“•„
kcrk	äŠ
kcrks	ğ´
kcrkt	äŠ‚
kcrl	ğµ
kcrm	ğ¶
kcrn	äŠƒ
kcrnfl	ğ¹
kcrnz	ç–‡
kcrp	è€²
kcrps	èš
kcrs	ç“
kcrt	ç
kcrts	ğ©
kcrz	è¡—
kcs	ğ
kcst	äŠ
kcsts	äŠ‘
kct	ã¦˜
kcts	ğ“™
kcv	ğ‘ˆ¢
kcz	ã˜‘
kczd	é ²
ke	ã¤´
keJ	ã¤¹
keZ	å¡²
keb	éš†
ked	è‰’
kedz	è‰“
keg	è¡
kegd	éœ„
kek	ã”€
keks	ã”
kekt	éœ’
kel	éœ‰
kelz	éœ–
kem	ã˜
ken	ã¥¡
kend	é„
kenz	ä†“
kep	ã¥¦
keps	é
kept	é‰
ker	ã¥´
kerz	ã¥¶
kes	ã 
kest	ğ‘‘”
ket	äˆ™
kets	ç 
kev	ä€‚
kevd	é ·
kevz	ä€ƒ
kez	å‘°
ki	ã”
kiC	ğ“¢
kiT	å‘³
kid	ğ“
kif	ğ“©
kifs	ğ”ƒ
kift	ğ“
kig	ğ”€”
kik	ç”¸
kil	ğ‘¡
kilb	ğ“‘
kilz	ğ“°
kim	ğ’œ³
kimz	ğ’œ´
kin	ç¤¦
kind	ğ”€•
kints	ğ“’
kinz	ç¤§
kip	å‘±
kips	å‘²
kir	ğ“¤
kis	ğ“–
kist	èœ€
kit	ğ‘²
kits	ğ“¥
kiz	ãšƒ
kl	æ †
kl@	ä„¦
kl@d	è
kl@dz	ğ™
kl@f	ğ–˜‚
kl@g	ğ±
kl@k	ğ°
kl@m	ğ²
kl@md	ğ³
kl@mp	ä„¤
kl@mps	ğµ
kl@mpt	ğ´
kl@mz	ğ¶
kl@n	ğ·
kl@nd	ğ¦—
kl@nk	ğ¸
kl@nz	ğ¹
kl@p	ä„¥
kl@ps	ğ‚
kl@pt	ğ‚€
kl@r	ğ“‘˜
kl@s	ä„¨
kl@sp	ğ‚…
kl@spt	ğ‚†
kl@st	ğ‚„
kl@t	ğ“‘™
klE	ä…€
klEb	ğ“…
klEf	ğ„†
klEft	ğ„‡
klEg	é„
klEk	ğ„ƒ
klEl	ğ„ˆ
klEm	ğ„‰
klEmp	ğ“‘¥
klEmz	ğ“‘¦
klEn	ğ‚”
klEnC	ğ„’
klEnCt	ğ„“
klEng	ğ“‘§
klEnk	ğ“‘¨
klEns	ğ“‘©
klEnz	ğ‚•
klEnzd	ğ‚–
klEp	ğ“‘°
klEr	ä„£
klErd	ä‘ˆ
klErz	ä‘‰
klEs	ğ“‘±
klEt	ğ“‘²
klEz	ğ“‘³
klI	ä…‚
klIC	ğ“‘´
klIG	ã¡¶
klIGk	ä…‘
klIGz	ä˜±
klId	ğ‘–•
klIf	é‘±
klIfs	ğ„˜
klIft	èœ¨
klIfts	ğ’€“
klIg	ğ“‘¶
klIk	ä…
klIks	ğ„—
klIkt	ğ„–
klIm	ğ„™
klIn	ã¡“
klInC	ğ„¡
klInCt	ğ„¢
klIng	ğ“‘¸
klInk	ğ„¤
klInt	ğ„¦
klInz	é‘µ
klIp	ä…’
klIps	ä…•
klIpst	ğ‘•
klIpt	ä…“
klIr	ä„¹
klIrz	ğ‚—
klIs	é€¢
klIst	è–ˆ
klIsts	é€¡
klIt	è„¨
klIts	éŠ–
klIz	é –
klO	ğ„¶
klOd	ğ…–
klR	æœ¸
klRg	ğ”€ƒ
klRk	ğ„”
klRks	ğ„•
klRz	ğ€²
klU	ğ“’‡
klUn	ğ“’†
klW	ä…±
klWd	ä…°
klWdz	ä…²
klWn	ä…³
klWnz	ä…´
klWs	ä„°
klWt	ğ…“
klWz	ğ…•
klY	ä…‡
klYd	ğ…±
klYdz	ğ…²
klYk	è ²
klYm	ä……
klYmd	ä…†
klYmz	ä…ˆ
klYn	è…“
klYnd	ğ©
klYnk	ğ“‘¡
klYnz	ğ„£
klYs	ğ“‘£
klYst	ğ“‘¤
klYt	è–†
klYts	è–‡
klYv	ğ„§
klYz	ğ“‘¢
kl^	ä†„
kl^C	ğ…¨
kl^Ct	ğ…©
kl^G	ä†ƒ
kl^Gk	ä†‚
kl^b	ä…µ
kl^bd	ğ…˜
kl^bz	ğ…—
kl^dt	ğ“’…
kl^f	ğ…¡
kl^g	ğ…¢
kl^k	ä…¶
kl^ks	ğ…™
kl^m	ä†€
kl^mp	ğ…¤
kl^mps	ä…¹
kl^n	ğ…¦
kl^nd	ç–€
kl^ndz	ğ‘„„
kl^nk	ğ“’‰
kl^nks	ğ…§
kl^nt	ğ“’ˆ
kl^nz	é•‡
kl^s	è–…
kl^t	ğ€‰
kl^ts	è„©
kl^v	ğ–™‘
kl^z	èŠ†
kla	å¡¤
klaT	ä
klad	ğ„³
klag	è–‰
klagd	è–‘
klagz	ğ„µ
klak	ä…˜
klaks	å¡¥
klakt	ğ„°
klamp	ğ“’
klan	ğ“’‚
klanC	ğ„·
klants	ğ„¹
klap	ä… 
klapf	ğ“’ƒ
klar	ğ©
klark	ğ‚‚
klarks	ğ‚ƒ
klas	ğ…
klat	ğ…„
klats	ğ…‘
klav	ğ–™„
klc	ä…—
klcT	ä…¥
klcTs	çˆ
klcd	ğ‚
klcg	è–
klcgd	ğ„´
klcgz	è–’
klcm	ğ“’€
klcn	ğ– ¢
klcnC	ğ‚‘
klcp	ğ™’
klcps	ğ™‘
klcr	ç•§
klcrz	ğ…€
klcs	ğ‚“
klct	ğ“ ¥
klcts	ğ…
klcz	ğ‚’
kle	ä„±
klem	ç”µ
klemd	ç”·
klemz	ç”¶
klen	ğ“¤€
klenz	ğ”€–
kler	ä‘‡
kles	ğ”‘—
klet	ğ”†‘
klev	è”‚
klevz	ğ‘‘–
klez	èœ§
kli	ã„´
klib	ğ“‘ 
klid	ğ“˜·
klif	ğ”€
klig	ğ“‘µ
klik	ğ„„
klin	ä„²
klind	ä„³
klinz	ä„µ
klir	ä„·
klird	ä„¸
klis	ğ„…
klit	ğ‚˜
klits	ğ‚™
kliv	ğ„
klivz	ğ„‚
kliz	èœ¦
klo	ä…™
kloDz	ä…¦
klod	ğ……
klodd	ğ…†
klodz	ğ…‡
klok	ğ„¨
kloks	ä…–
klokt	ğ„©
klon	è…”
klond	ğ„¸
klonz	è…•
klop	ğ“‘¹
klos	ä…¡
klovz	ğ…”
kloz	ä…§
klozd	ä…¢
klu	ä…·
klud	ğ… 
kludz	ğ‰·
klug	ğ…£
klun	ğ…¥
klur	ğ”€‚
klus	ğ•“
klut	ğ…°
kluz	ä…¸
klx	æˆ¶
ko	ã€†
koC	ä†…
koCt	ğ…µ
kob	ğ†
kobz	ğ“”˜
kod	ä†—
kodz	éš‚
kof	ğ“‘€
kog	ğˆ
kok	ä†™
koks	ğ…¸
kokst	ğ…¹
kol	äˆƒ
kolb	ğ“”¥
kold	äˆ
koldz	äˆ‚
kolm	ğˆ£
kolp	ğ“”¨
kols	ğ“” 
kolt	ğˆ¨
kolts	äˆˆ
kolz	é–‡
kom	äˆ“
komd	äˆ”
komz	äˆ•
kon	äˆ¸
konfl	ğŠˆ
konz	æ€¦
kop	ğ¤
kopk	ğ“”¡
kops	ğ¨
kopt	ğ¥
kor	äŒ†
kors	äŒ…
kos	ä††
kost	ğ…¶
kosts	ğ…·
kot	ä†ˆ
kots	ä†‰
kov	ç¢…
kovz	ç¢†
koz	åš…
kozm	ğ„
kr	ğ“˜‚
kr@	äŒ”
kr@C	ğ“•¡
kr@G	äŒ¢
kr@Gk	äŒ¡
kr@S	äŒ¥
kr@St	äŒ¦
kr@b	äŒ“
kr@bd	ğ‘ƒ
kr@bz	ğ‘„
kr@f	ğ‘ˆ
kr@fs	ğ‘‰
kr@ft	ç §
kr@fts	ç ¨
kr@g	ğ‘
kr@gt	ğ“•¢
kr@gz	ğ‘‘
kr@k	äŒ•
kr@ks	ğ‘†
kr@kt	äŒ–
kr@l	ğ“•¤
kr@m	ğ‘—
kr@md	ğ‘™
kr@mp	ğ‘ 
kr@mps	ğ‘¢
kr@mpt	äŒ˜
kr@mz	ğ‘£
kr@n	äŒ™
kr@nk	ğ‘¨
kr@nks	ğ‘§
kr@nkt	ğ‘¦
kr@ns	ğ‘¤
kr@nts	ğ‘
kr@nz	ğ‘°
kr@p	äŒ¤
kr@pf	ğ“•¥
kr@ps	ğ‘±
kr@s	ğ‘´
kr@t	èŠ‚
kr@ts	èŠƒ
kr@z	ğ‘³
krE	äŒ·
krEC	ğ“–…
krEb	ğ“•´
krEbz	ğ“•³
krEf	ğ’—
krEfs	ğ’˜
krEft	ğ“•µ
krEg	ğ’™
krEk	ğ”‡
krEl	ğ“•¹
krEm	ğ“–€
krEn	ğ”€
krEnk	ğ“–
krEnts	ğ“–‚
krEnz	ğ“–ƒ
krEps	ğ”…
krEpt	ğ”†
krEr	ğ“•¶
krEs	ğ’
krEst	è–•
krEsts	è––
krEt	ğ’‰
krEts	ğ“–†
krEv	ğ”‘
krI	ä„„
krIC	ğ”“
krIG	ä†
krIb	äƒ
krIbz	ğ”’
krId	ç–˜
krIg	ç–—
krIk	ğ””
krIl	ğ”–
krIm	ğ”—
krImp	ğ”™
krImps	ğ”¡
krImpt	ğ” 
krIn	ğ”¤
krIng	ğ”¢
krIngd	ğ”£
krInk	ğ“–“
krInz	ğ“–’
krIp	æ„˜
krIps	ğ”¦
krIpt	ğ––
krIpts	ğ–—
krIr	ğ’‡
krIs	ä„€
krIsp	ğ€¢
krIst	ä„‚
krIt	æ‰
krIts	æ
krIz	ğ€¡
krO	ğ•
krOd	ç–ƒ
krOdz	ç–„
krOl	ğ–ƒ
krOt	ğ•€
krOts	é‘
krOz	ğ•‚
krU	ä”
krUk	ğ•ˆ
krUks	ä–
krUt	ğ”ˆ
krW	ä 
krWC	ğ•³
krWCt	ğ•´
krWd	ä™
krWdz	ğ•¹
krWl	ğ–€
krWn	ä¢
krWnd	ğ–‚
krWns	ğ•µ
krWnz	ğ–
krWr	ğ“•¨
krWs	ğ•·
krWt	ğ•¸
krWz	ğ“•©
krY	ä²
krYd	ä„
krYm	ä…
krYmz	ğ”˜
krYn	ğ‘‘ 
krYp	ğ”¥
krYs	ğ“•·
krYst	ä„
krYsts	ğ€£
krYt	èŠ‡
krYts	ğ”²
krYz	ğ”•
kr^	ç–™
kr^C	ğ–“
kr^S	ä©
kr^d	ä£
kr^ft	ğ†‘
kr^g	ğ“˜„
kr^k	è–€
kr^ks	ğ–•
kr^l	ğ†‰
kr^m	ä¥
kr^mp	ğ–ˆ
kr^mz	ä¦
kr^n	ä¨
kr^nC	ä§
kr^nCt	ğ–‰
kr^nk	ğ–
kr^nz	ğ†…
kr^p	èœ†
kr^ps	ğ“˜…
kr^pt	èœ…
kr^s	ä±
kr^sk	ğ“˜†
kr^st	ä°
kr^sts	ğ–’
kr^t	ğ‘“
kr^ts	ğ“˜‡
kra	ä‘
kraC	ğ•°
krab	ğ“–”
kraf	ğ”·
kraft	ğ“–˜
krag	ğ“–™
krak	ä
kraks	ğ“–•
kral	ğ“•£
kram	ç²
kramp	ğ•ƒ
kran	ğ‘©
krank	ğ•‡
krans	ğ•…
krants	ğ“˜€
kranz	ğ”²
krap	ğ•“
krapf	ğ“˜
kraps	ğ•”
krapt	ğ•–
kras	ä˜
krat	ä‘¡
krats	ğ•±
krav	ğ“•°
krc	äŒ©
krcf	ğ”¶
krcft	èš‚
krcfts	èšƒ
krcl	äŒ§
krcld	äŒ¨
krclz	äŒ°
krcn	ğ‘¶
krcs	ã†‡
krcst	ä—
krct	ğ‘”
krcz	ğ•—
kre	äŒ—
kreb	ğ‘’
kred	ğ‘‡
kreg	ğ‘“
kregz	ğ‘”
krek	ğ”‰„
krel	ğ‘•
kremz	ğ‘˜
kren	äŒ 
krend	ğ‘¥
krenz	ğ‘–
krep	ğ”ƒ
kreps	ğ”„
kres	ğ‘…
kret	ğŒ‘
krets	ğ‘µ
krev	ğ‘·
krevd	ğ‘¸
krevz	ğ‘¹
krez	ğ‘²
krezd	äŒ³
kri	äŒµ
kriC	ğ’€
krid	ğ’“
kridz	ğ’”
krif	ğ”†‡
krig	ğ’
krik	ä€
kriks	ğ’•
krikt	ğ’‚
kril	ğ’ƒ
krim	äŒ´
krimd	ğ’„
krimz	ğ’…
krin	ğ’†
krink	ğ“–ˆ
krip	ä
krips	ğ’–
kris	å¢
krist	ğ±
krit	ğ‰¸
krits	ğ“•¸
kriz	ğ’ˆ
kro	ä‰
kroC	ğ†
kroCt	ğ‘‘˜
krob	ğ”©
krobz	ğ”°
krod	ä¡
krok	ğ”´
krol	èœ‚
krold	èœƒ
krolz	èœ„
krom	ğ€¨
kron	ğ•†
kronk	ğ“––
kros	ğ“–—
krot	ğ•²
kroz	ğ•˜
kru	ä‚
krud	ç•’
krudz	ğ–…
krul	ğ–†
krum	çŒˆ
krumz	è–—
krun	ğ•‘
krunz	ğ•’
krup	ğ•¶
krus	ğ–„
krut	ğ–”
kruts	ğ“–‡
kruz	ä¤
kruzd	ğ–‡
krx	åœ±
ks	ğ“˜ˆ
kt	æšƒ
ku	ã†„
kuC	ğ“˜‰
kub	ğ“”µ
kud	ğ“‡
kudz	ğ“‰
kuk	ğ“”¶
kuks	ğ“”·
kul	ä‰±
kuld	ä‰²
kulz	ğ”
kum	ğ–
kumb	ğ•
kumbz	ğ—
kumz	ğ˜
kun	ä†–
kuns	ğ™
kunt	ğ“˜¸
kunts	ğ 
kunz	æ†˜
kup	ä‰³
kups	ğ¤
kupt	ğ¡
kur	ğ†˜
kurz	ğ¢
kus	ğ£
kut	ä–
kuts	èšˆ
kuz	ğ¨
kw@	æ…¸
kw@g	ğ”¤¶
kw@k	æ…·
kw@ks	ğ”¤±
kw@m	ğ”¥‚
kw@n	éŒ¸
kw@nt	ğ”¥„
kwE	ãƒ
kwEk	ğ”¥˜
kwEl	è˜¹
kwEld	ğ”¥™
kwElz	ğ†’
kwEn	æ£
kwEnC	ğ”¥ 
kwEnt	ğŒ”
kwEnts	ğ’‚—
kwEr	è˜¸
kwEs	æ†‡
kwEst	è¥…
kwEsts	è¥†
kwEz	é‰°
kwI	ã…¶
kwId	å–”
kwIdz	å–•
kwIg	ğ”€™
kwIk	æ†ˆ
kwIl	ğ“¤‚
kwIlmz	ğ”¥¤
kwIlt	æ†
kwIlts	æ†‘
kwIm	ğ”¥¥
kwIn	æ†’
kwInd	ğ”¥§
kwIns	ğ”¥¦
kwInt	ğ”¥©
kwInts	ğ”¥°
kwInz	ğ”¥¨
kwIp	äœ¤
kwIps	ğ‘•€
kwIpt	ğ‘”¹
kwIr	ğ“‰ƒ
kwIrz	ğ”¥—
kwIs	ğ“‰˜
kwIst	ç ‰
kwIsts	ç 
kwIt	æ†“
kwIts	ç–”
kwIz	æ†•
kwIzd	æ†–
kwO	ğ“ˆ§
kwOz	ğ–•µ
kwR	èˆ°
kwRd	ã’†
kwRdz	ã”•
kwRk	ğ„²
kwRks	ğ”¥±
kwRld	ğ²
kwRm	éŠ™
kwRmz	ğ“€§
kwRnz	ğ”¥¡
kwRt	è¡•
kwRts	è¡–
kwUd	é„ƒ
kwUdz	è˜…
kwWn	ğ”€ 
kwY	æ†‰
kwYd	ğ“ „
kwYn	ğ‘ˆ˜
kwYr	ğ“†‘
kwYrd	ğ•€¸
kwYrz	æ‰•
kwYt	æ†”
kwYz	ğ„±
kw^	ç–“
kw^d	ğ“ ƒ
kw^l	éŠ˜
kw^ld	ğ‘”¶
kw^lz	ğ‘”·
kw^m	ğ—€µ
kw^n	é¤¦
kw^nd	ğ“¥’
kw^ns	ğŒ’
kw^nt	ğŒ“
kw^nts	ğ £
kw^nz	é¤§
kw^s	ğ“…¶
kw^t	ç™ƒ
kw^ts	èœ
kw^z	ğ“˜£
kwa	æ†
kwaC	ğ”¤°
kwaS	ã”–
kwad	ğ”¤²
kwadz	ğ”¤µ
kwaf	ğˆ†
kwaft	ğˆ‡
kwak	ğ“˜¥
kwal	ğ”¤·
kwalmz	ğ”¥€
kwalz	ğ”¤¸
kwam	ğ”¥
kwamz	ğ”¤¹
kwan	å”’
kwar	ğ‘œ³
kward	ğ“¥“
kwark	ğ”¥‡
kwarks	ğ”¥ˆ
kwart	ğ“¥”
kwas	è˜„
kwast	ğ”¥”
kwat	ğ“˜˜
kwaz	ğ“˜¤
kwc	æ†‚
kwck	ğ“˜¦
kwcl	ğ‘‰°
kwcld	é–ˆ
kwcn	ğ˜“
kwcndt	ğ”¥ƒ
kwcr	æ†ƒ
kwcrlz	ğ”¥‰
kwcrm	ğ“¡±
kwcrn	ğ”¥
kwcrt	ğ“¥ˆ
kwcrts	ğ”¥‘
kwcs	ğ”¥’
kwcst	ğ”¥“
kwe	ç–
kwed	ğ”€—
kweg	ğ”€˜
kwek	ä™—
kweks	ğ‘‚
kwel	æ…¹
kwelz	æ†€
kwen	ç–‰
kwent	ç–ˆ
kwet	ç™„
kwets	ğ‘”¸
kwev	ğ”¥•
kwevz	ğ•˜ 
kwez	é”£
kwi	æ†„
kwid	ğ‘‰±
kwik	æ†…
kwiks	ğ–¥…
kwil	ğ”¥£
kwin	æ††
kwinz	ğ”¥–
kwirt	ğ™ƒ
kwis	ğ“¥•
kwit	è¥ƒ
kwitt	è¥„
kwo	ğ˜’
kwot	æ†—
kwots	ğ”¥²
kwoz	èœ‘
kwu	èœˆ
kwx	æ‘
kx	ã‚’
kxb	å
kxbz	å‘
kxd	ä•
kxg	æˆ´
kxl	ã
kxld	ã¡µ
kxlt	ä”
kxlz	ã‚
kxm	ä„–
kxmp	äˆ§
kxn	ãˆ³
kxnd	æ‡
kxndz	æˆ
kxnz	ãŒ™
kxp	åˆ¹
kxps	å‰€
kxs	ä„˜
kxt	ä¦†
kxz	çƒ
kyE	é™´
kyEl	ğ“‘”
kyEn	ğ“‘•
kyI	ğ“˜•
kyR	ç•–
kyRd	ğ“¤µ
kyRz	ğ‘„ƒ
kyU	ä†
kyUr	æ‘
kyUrd	ğ˜–
kyUrz	ğ˜—
ky^	ç•˜
ky^n	ğ“”
kya	ç¡˜
kyar	ğ“‘“
kyard	ã”—
kyardz	è˜†
kycn	ğ“˜¨
kycr	ğ”•¦
kycrz	ğ”•§
kycs	ğ“‘–
kyet	ãˆ’
kyo	ğ“˜§
kyu	ã†€
kyub	äµ
kyubd	ğ–™
kyubz	ä¶
kyud	æ‰–
kyul	ğ”„’
kyuld	ğ•…”
kyulz	ğ”…¹
kyum	ç…”
kyumd	ç…•
kyumz	ç…–
kyun	ğ“˜
kyunz	ğ“˜™
kyus	ä‡
kyut	ä”
kyuts	ğ‘˜©
kyuv	ğ™‚
kyuz	æ‰—
kyuzd	ã…¥
kyx	ãš„
l	ğ“˜°
l@	ã‰§
l@C	å”²
l@Ct	ğ“š“
l@G	å”¤
l@Z	å˜‚
l@b	ğˆ•
l@bz	ğ’Š
l@d	ç”˜
l@dz	ğ“™‚
l@f	å”³
l@fs	å”µ
l@ft	å”´
l@g	ğ–
l@gd	ğ“™‡
l@gz	ğ“™ˆ
l@k	å”—
l@kd	ğ•˜…
l@ks	æ‰†
l@kst	æ‰‡
l@kt	ğ“˜¶
l@l	ğ‘ƒ
l@m	å”˜
l@mp	å”¡
l@mpf	ğ“™˜
l@mps	ğ“™¡
l@mz	å”™
l@n	å”¢
l@nC	è”’
l@nd	ãµ
l@ndz	è˜‰
l@ng	ğ“™±
l@nk	ğ“™£
l@nks	ğ”˜™
l@ns	å”¦
l@nt	ğ“™§
l@nts	ğ“™³
l@nz	ğ“™©
l@p	å”¨
l@ps	äˆ„
l@pst	ğˆ™
l@pt	é™ˆ
l@s	ä³
l@sk	ğ“š‡
l@st	å”°
l@sts	ğ“š
l@t	é™‰
l@ts	ğ“š”
l@z	ğ“š‘
lE	ã€¶
lEC	ğ“§
lEJ	å•”
lEb	é¡‘
lEbz	éœ£
lEd	å•“
lEf	å•–
lEfs	ğ“œ°
lEft	å••
lEfts	ğ“œ²
lEg	å•—
lEgd	ç¤³
lEgz	å• 
lEh	ğ•‰·
lEk	äˆ†
lEks	è¥ 
lEkst	ğ–´
lEkt	äˆ…
lEktrp	äš€
lEkts	ğˆ¢
lEl	ğ’¤¹
lEld	ğ””¶
lElz	ğ””·
lEm	ç¢™
lEmb	ğ“ƒ
lEmbk	ğ“„
lEmp	ğ“†
lEmpk	ğ“‡
lEn	ã¤
lEnC	ğ“–
lEnd	ğ“ˆ
lEndz	ğ“‰
lEnk	ğ“’
lEnkt	ğ“
lEnkts	ğ““
lEnsk	ğ•†
lEnt	ğ“‘
lEnts	ğ“”
lEnz	ğ“•
lEp	ğ‘”£
lEpt	ğ“œ¢
lEr	ç¡¤
lErd	ğ“™’
lErk	ğ“œ¸
lErn	ğ•‚†
lErz	ğ‘––
lEs	ä‚‘
lEsk	é™
lEst	é¡’
lEsts	ğ”†
lEt	å•£
lEts	å•¤
lEv	ğ“–‰
lEvz	ğ“–
lEz	è”‡
lI	ã€ 
lIC	ğ‘¥¹
lICt	ğ“¹
lIG	ã”°
lIGks	å–‘
lIGz	ä€…
lIJ	ã…´
lIJG	æ‰ˆ
lIJd	ã…µ
lIS	æ´
lISt	æµ
lIb	ç˜–
lIbd	ğ“´
lId	å•©
lIdz	å•°
lIf	å•µ
lIfs	è˜¥
lIft	å•´
lIfts	å•¶
lIg	ã‰·
lIgd	ğ”™ƒ
lIgz	ğ••£
lIh	ğ“”¦
lIk	ã¦—
lIks	ã‰³
lIkt	å•¨
lIkts	ğ¢ƒ
lIl	å–‚
lIlt	ğ“
lIlz	éœ 
lIm	ğš€
lImd	ğ“‘
lImf	ğ“¢‡
lImp	ğ“”
lImps	ğ“–
lImpt	ğ“•
lImz	å–„
lIn	ãŠˆ
lInC	ğ“—
lInCt	ğ“¢ˆ
lInJ	ä€§
lInd	å–‡
lIndz	ğ“¢‰
lIng	é€
lIngd	ğ–˜–
lIngz	ğ“€
lInh	ğ”†‚
lInk	ç ·
lInks	ç ¸
lInkt	ğ“ˆ„
lIns	æ”“
lInsk	ğ•‰´
lInt	ä„
lInts	ğ“ €
lInz	è¥¡
lIp	å–’
lIpk	ğ“ 
lIps	å–“
lIpt	ğ“ ‚
lIr	èš‰
lIrz	èš
lIs	ãŠ‚
lIsk	ğ“ …
lIsp	ğ“ †
lIss	ğ”©
lIst	å––
lIsts	å–—
lIt	ã ‚
lIts	è
lIv	å–˜
lIvd	å–™
lIvz	å˜€
lIz	å˜
lIzm	ğ“…¸
lO	ç¤¤
lOd	ç¤£
lOdz	ç¤¥
lOn	ğ“ ¤
lOnd	ğ“¡’
lOr	ğ“ ¦
lOs	ç¥²
lOt	è¤™
lOz	ç¥•
lR	ã¡±
lRC	ğ“™
lRCt	ğ“¡¸
lRb	ğ‘™
lRd	äˆ‡
lRdz	ä”„
lRk	ğ“˜
lRks	ğ“¢€
lRkt	ğ“¡¹
lRn	å•ˆ
lRnd	å•‰
lRnt	ğ“œ¤
lRnz	å•
lRs	ğ“ 
lRt	ç¤‚
lRts	ç¤ƒ
lRz	ã‡
lU	å˜—
lUd	ğ“¡¡
lUg	ğ“¤²
lUk	å˜–
lUks	å˜™
lUkt	å˜˜
lUn	ğ“ ²
lUr	å™†
lUrd	ç¥¡
lUrt	ğ”¶
lUrz	ğ“¡¢
lUs	çœ‚
lUt	ğ“¡¥
lW	ãŠ‘
lWb	ğ‘†
lWd	ãŠ’
lWf	ğ–˜
lWk	ğ“¡…
lWks	ğ“¡†
lWm	ğ’š‡
lWn	ğ“¡‰
lWng	ğ“¡ˆ
lWns	ğ“¡
lWr	ğ“œ
lWs	ğ“™´
lWt	ç¤©
lWts	è˜¦
lWz	ç¥”
lWzd	ğ ±
lY	ãŠ“
lYb	ğ“œ¹
lYd	å•±
lYdz	ç¥
lYf	å•³
lYfs	ğ“
lYk	ãŠ„
lYks	å–
lYkt	å–€
lYl	é·
lYlz	é¹
lYm	å–…
lYmz	ğ“’
lYn	ã‰ 
lYnd	å–‰
lYnz	å–ˆ
lYp	ğ“€
lYr	ğ“¢
lYs	ğ‘±
lYst	ğ“
lYt	ä¡¹
lYts	äš
lYv	ãŠ…
lYvd	ğ•˜§
lYvz	ç‘
lYz	å•²
lYzd	ä„¢
l^	å˜¶
l^b	éœ”
l^bk	ğ“¡–
l^bz	éœ•
l^d	è™¡
l^dz	è™£
l^f	ç¤€
l^fs	ğ“¦™
l^ft	ğ“¡¦
l^g	ç¤†
l^gz	ğ“¡¨
l^k	å˜¹
l^kr	ğ 
l^ks	ä‘™
l^kt	ğ“¡˜
l^l	ğš‡
l^ld	ğ“¡²
l^lz	ğ“¡³
l^m	äˆ‰
l^md	ğˆ±
l^mp	å™ƒ
l^mps	ğ“¡µ
l^mpt	ğ“¡´
l^ms	ğ“¡¶
l^mz	äˆ’
l^n	å˜“
l^nC	å™„
l^nCt	ğ“¡·
l^nd	ç¡§
l^ndz	éŒ˜
l^ng	ç¥³
l^ngd	é¢’
l^nk	ğ”
l^nks	ğ”‚
l^nkt	ğ•¤ˆ
l^nl	ğ“™°
l^ns	è€ 
l^nst	è™
l^nt	è€¡
l^nts	è“
l^nz	ç¡¦
l^p	éˆ
l^ps	é‰
l^pt	ğ¤¥
l^s	ç˜‚
l^sk	ğ“¢ƒ
l^sks	ğ”†ƒ
l^st	ç”
l^sts	è…‘
l^t	è¥
l^ts	è¦
l^tz	ğ“¢„
l^v	å˜´
l^vd	å˜µ
l^vz	å˜·
l^z	ç‘…
la	äˆ€
laC	ğ“˜²
lab	å˜ˆ
labd	ğ“ —
labz	ğ“˜±
lad	è™¢
laf	é€¥
laft	ğ—‚
lag	ç¡£
lagd	ğ“ ¢
lagz	ğ“ £
lak	å˜‰
lakd	ğ“ˆ…
laks	å£
lakt	å˜
lal	ğ“˜©
lam	é¤‡
lan	å•€
lang	ğ“ ¨
lans	ğ“ °
lant	ğ”™
lanz	è”“
lap	å˜¦
lapt	ğ“ ¶
lar	ç˜µ
larC	ğ“š€
larJ	å”©
lard	ç¡©
lardz	ğ¥µ
larg	ğ‘’€
largd	ğ‘’
lark	ğ“š
larks	ğ“š‚
larm	ã‰±
larmd	ç¡±
larmz	ç¡°
larnd	ğ“šƒ
lars	ğ“š…
lart	è™„
larz	ğ“š„
las	ğ’†™
lat	ãŠ˜
lats	å˜²
latz	ğ“¡ƒ
lav	è¤¡
lavsk	ğ–‰’
laz	è•”
lc	å”¸
lcG	ãŠ—
lcGd	å˜”
lcGz	ã™
lcb	ğ“š•
lcd	ğ“š–
lcdz	ğ“š—
lcf	è„‘
lcfs	ğ”²
lcft	ç¥±
lcfts	ğ’ ¤
lcg	ã¦‘
lcgd	é —
lcgz	ã¦
lck	ç ¹
lcks	ç¡€
lcl	ğ“™“
lcm	ğ”ˆ‰
lcn	å”¶
lcnC	ğ“š™
lcnCt	ğ“œ€
lcnd	è¤ 
lcnt	ğ”¤¨
lcnz	ç¥´
lcr	å˜©
lcrd	å˜§
lcrdz	å˜¨
lcrg	ğ“ ¹
lcrk	ğ“ ·
lcrn	é‰
lcrts	ğ“¡
lcrz	èš–
lcs	ğ“œˆ
lcst	å˜±
lct	ğ’šˆ
lcv	ğ‘Œ©
lcvs	ğ”‘‘
lcz	å”¹
le	ã€°
leC	ğ“™
leb	ğ“˜³
led	å•‚
ledz	ç”¹
leg	ğ“™†
legd	ğ”µ
lek	ã‰´
leks	ğ“ˆƒ
lel	ğ“™‘
lem	å” 
len	å”£
leng	ğ ’
lenz	è‰²
lep	ğ“™µ
ler	ğ‘„
les	å”•
lesk	ğ“šˆ
lest	å”–
let	ä‰„
lets	ç••
lev	ğ“œƒ
lez	å•ƒ
li	ã¨
liC	ğ“œ‘
liCt	ğ“œ’
liS	å•‘
lib	ğ€¤
libz	ğ’”‰
lid	è€ˆ
lidz	ğ“œ“
lif	ã™ƒ
lifs	ã™„
lift	ğ“œ”
lig	ğˆ 
ligz	ğˆ¡
lik	è„‰
liks	ğ“œ 
likt	ğ“œ™
lil	ğ“Œ°
lim	ğ€§
lin	å‘©
lind	å•„
lint	è™•
linz	èŠ‰
lip	å•…
lips	å•‡
lipt	å•†
lir	é ´
lirz	ğ“œ£
lis	äš
lisk	ğ“œ¥
list	å•’
lit	ä‘—
lits	è¶
liv	ã™…
livd	ã™†
livz	ã™‡
liz	ã¶
lk	ğ“¢…
lo	ã€¹
loC	ğ ¨
lob	ğ“ ˜
lobd	ğ“ ™
lobz	ğ“  
lod	ã™‰
lodd	ğ“ –
lodz	å˜„
lof	å˜…
lofs	ğ“ “
log	ğ“„·
lom	ğˆ¤
lon	ãŠ–
lond	ğ“ ”
londz	ğ“¡‘
long	ğ“ §
lonz	å˜†
lop	ã¥¤
lops	äœ£
los	ã¥¸
lot	ğ“ •
lotz	ğ“¡„
lovz	å˜‡
loz	ä¤•
lri	ä€
lrod	æˆ…
lu	ã”´
lub	ğ’†—
lubk	ğ“¡ 
lubz	ğ’†˜
lud	ç¥™
ludz	ç¥ 
luf	ç¥µ
lug	ğ“¡§
luk	å™‚
luks	ğ“¡°
lul	ğ“¡£
lum	å˜ 
lumd	ğ“ ±
lumz	ğ’–
lun	ã”±
lund	è™¤
lunz	ã”²
lup	å˜¡
lups	å˜£
lupt	å˜¢
lur	ğ“¡¤
lus	å˜¤
lust	å˜¥
lut	ã„˜
luts	ç’˜
luz	å˜°
lwInd	ç‰ 
lwez	ãŒˆ
lx	ã‚ƒ
lxdz	æƒ
lxk	ä™¹
lxm	äˆ‘
lxn	ã€µ
lxnd	ä¦˜
lxndz	å˜
lxns	ãŒ–
lxnz	ä‚…
lxs	ä¹
lxts	æ‘‡
lxz	ã™€
lyIn	åƒ
lyInt	ã ¶
lyR	ä—
m	ğ“¢‘
m@	ã€´
m@C	åš™
m@Ct	ğ“¢™
m@G	å™¹
m@S	åš•
m@St	åš–
m@T	åœ‚
m@b	ğ“¢“
m@d	å™’
m@dz	ğ”“
m@g	å™“
m@gz	å™—
m@h	ğ“¤”
m@k	ã†–
m@ks	åœ…
m@kst	ğ„ 
m@l	å™¨
m@lm	ğ“¤§
m@lt	ğ“¤©
m@lts	ğ“¤±
m@lz	ğ“¤£
m@m	å™ˆ
m@n	ã€²
m@nd	ä‘ 
m@ndz	ğˆ·
m@nk	ğ“¤“
m@nks	ğ“¤¹
m@np	ğ“¤¶
m@ns	ç¡¥
m@nsk	ğ“¤·
m@nt	èŠ‘
m@nts	ğ“¤¸
m@nz	åš
m@p	åš‚
m@ps	ğ“¥…
m@pt	ğ“¥„
m@r	ğ”†–
m@s	åš—
m@sk	ğ“¥¢
m@sks	ğ“¥¦
m@skt	ğ“¥¥
m@sl	ğ“¥¨
m@st	è€•
m@sts	ğ“¥²
m@t	å”·
m@ts	ç–…
m@tz	ğ“¥¶
m@z	ğ“¥§
mE	ãŒ—
mEC	ğ”€¨
mES	åœ£
mEZ	åœ”
mEd	ç‘†
mEdz	é¡
mEg	åœ–
mEgz	ğ”€
mEk	ç˜¡
mEks	ã”³
mEl	åœ™
mEld	ğ”…
mElt	åœ˜
mElts	åœ 
mElz	ğ”„
mEm	åœ¡
mEmp	ğ”ˆ
mEn	ã€¡
mEnC	ğ‘‘
mEnd	è€©
mEndz	è€°
mEng	ğ”‰
mEnk	ğ”
mEnks	ğ”‘
mEns	ğ‰€
mEnst	ğ‰
mEnt	ä€
mEnts	åˆ
mEnz	éˆ¹
mEr	å¡ƒ
mErsk	ğ“¤…
mErts	ğ“¤†
mErz	ğ“¤‡
mEs	ä•˜
mEsk	ğ”—
mEst	åœ¥
mEt	åœ¦
mEts	åœ¨
mEtz	ğ”£
mEv	è€µ
mEz	è€¶
mI	ã„³
mIC	æ‡
mICk	ğ”…
mIG	ã˜”
mIJ	ä”
mIb	ğ”¥
mId	åœ´
mIdst	è€
mIdz	é²
mIf	ğ”‚†
mIft	ğ”‚…
mIg	ç
mIgd	ğš“
mIgz	ğ”‚‰
mIk	å€²
mIks	ã„µ
mIkst	å”
mIkt	ğ”„„
mIl	å‚
mIlC	ğ”‚’
mIlb	ğ”‚‘
mIld	ğ”‚–
mIlk	å
mIlks	ğ”‚”
mIlkt	ğ”‚“
mIln	ğ”‚™
mIlnz	ğ”„
mIls	ğ’¥„
mIlt	ğ’„²
mIlz	ğ”‚•
mIm	ğ”‚
mImz	ğ”„‚
mIn	ã™™
mInC	ğ”„‰
mInd	ä’„
mIng	ğ”„‘
mInk	ğ”„…
mInks	ğ”„
mIns	ğ”„†
mInsk	ğ”„“
mInst	ğ”„‡
mInt	ãŒ’
mInts	å€
mInz	ç…¸
mIps	ğ”„•
mIr	è
mIrd	ğ” ¦
mIrz	è‚
mIs	å‰
mIsk	ğ”„™
mIst	å
mIsts	ç™
mIt	åˆ§
mIts	å–†
mIz	å’
mO	å—
mOd	ğ•™¤
mOl	ğ‘
mOn	ğ“…
mOnz	ğ¤•
mOr	ğ”…²
mOs	ğ”…µ
mOst	ğ”…´
mOz	ğ”…³
mR	ã¢’
mRC	ğ“”©
mRd	æ””
mRf	ğ”‰¥
mRg	ğ‘‘€
mRgd	ğ‘‘
mRk	ç—
mRks	ğ”“
mRkt	ğ””
mRl	ğ’¡£
mRnz	ğ”€¦
mRrz	ğ•¡•
mRs	ğ‰‚
mRst	è€¸
mRt	è ’
mRts	ğ”•
mRv	ğ”–
mRz	ä ƒ
mU	ç¦ˆ
mUd	ğ“¤’
mUk	ğ“¤¡
mUl	ğ•Šˆ
mUlz	ğ”‰“
mUm	ğ”‰ 
mUnd	ğ•ˆ•
mUr	ğš™
mUrd	ğ”ˆ€
mUrg	ğ”‰¦
mUrz	ğ”†™
mUt	ğ– €
mW	å‚
mWC	ğ•Œ±
mWT	åƒ
mWTs	å…
mWdd	ğ”ˆ¸
mWdz	ğ’„©
mWl	ğ“¦€
mWn	å€
mWnd	ğ”ˆ©
mWndz	ğ”ˆ°
mWns	ğ”ˆ¨
mWnt	ãŒ¡
mWnts	è’
mWs	å
mWt	ğ’
mWts	ğ’„¨
mWw	ğ”‰€
mWz	ğ“¥€
mY	ã¡
mYd	é”·
mYdz	é”¸
mYk	åœ©
mYks	åœ·
mYl	åœ¹
mYld	åœ¸
mYlz	å€
mYm	ğ”„ƒ
mYn	å†
mYnd	å…
mYndz	æ‰
mYnts	ğ”ƒ
mYnz	ç¥€
mYr	ç™¦
mYrd	ğ”„–
mYrz	ç™§
mYs	åœ°
mYt	åœ¶
mYts	ğ‘„¥
mYz	ğ‰¢
mYzd	ğ‰£
m^	å 
m^C	å“
m^G	ãŒ 
m^Gks	ä‚‚
m^S	å ƒ
m^St	å „
m^d	å”
m^dz	ğ”‰…
m^f	ğ‘Œ¸
m^fs	ğ‘Œ¹
m^g	å–
m^gd	ğš’
m^gz	å—
m^k	åœˆ
m^kd	ğ“¢•
m^kg	ğ”€
m^ks	ğ’‘
m^l	å˜
m^lC	ğ”‰”
m^lCt	ğ”‰•
m^ld	ğ‘‘’
m^lkt	ğ”‰–
m^lt	ğ–•±
m^lv	ğ”‰™
m^lz	è„¥
m^m	å €
m^mps	ğ”‰¡
m^mz	ğ€³
m^n	å 
m^nC	å 
m^nCt	ğ”‰¢
m^nT	å£
m^nTs	å¤
m^nd	ç¤¶
m^ndz	ç¥¨
m^nk	èŠ—
m^nks	ğ”†
m^ns	ğ„
m^nst	è‡
m^nt	ç‡
m^nts	çˆ
m^nz	ç¡
m^nzd	ğ–ˆ¸
m^p	éŒ©
m^s	å ‘
m^sk	ğš”
m^sks	ğš•
m^st	å ˆ
m^sts	è„§
m^t	ç€
m^ts	è„¦
m^z	ç‘§
ma	ã€
maC	ğ“¤ƒ
mab	ğ”…”
mabd	ğ”…–
mabz	ğ”…•
mad	ç ’
maf	ğ”…©
mag	ç¥¤
mak	é€
maks	ğ”…™
makt	ğ”…˜
mal	å™´
malm	ğ“¤¦
malt	å™³
malz	è€’
mam	å˜
mamz	å™
man	äˆ–
mand	ç¥„
mandz	ğ”†ˆ
mang	ğ”†‰
mank	ğ”…±
mans	å¢
manst	å¡
mant	è’‰
mants	ğ‘•ƒ
manz	ğˆ´
map	å²
maps	åµ
mapt	å³
mar	åšƒ
marC	åš„
marCt	ğ“¥†
marS	åš“
mard	ğ“¥–
marg	ğ“¥‡
mark	åšˆ
marks	åš
markt	åš‰
marl	ğ“¥‰
mars	ğ¡ƒ
marsk	ğ“¥˜
mart	é‚‰
marts	éœ¤
marv	ğ“¥ 
marz	åš’
mas	ğ¡
mask	ğ”ˆ˜
masks	ğ”ˆ 
mat	ğ¡‘
mats	ğ”ˆ¦
mav	è°
mavz	è±
maz	å‚‘
mc	åœ„
mcC	ğ“¥¹
mcDz	å¹
mcd	ğ“™–
mcg	ğ”…¤
mck	è”
mcks	ğ‘¥¥
mckst	ğ‘¥¦
mcl	å™²
mcld	ğ“¦
mcls	ğ“¦‚
mclt	ğ“¤¨
mclts	ğ“¤°
mclz	ğ“¤¥
mcn	è†
mcnd	ğ“¦ƒ
mcnt	ç¦‡
mcr	ã”¶
mcrb	ğ”…§
mcrd	ğ”ˆ†
mcrf	ç¥†
mcrfs	ç¥‡
mcrft	ğ”ˆ‘
mcrg	ğ”ˆ‡
mcrgz	ğ”ˆˆ
mcrk	ğ”…¨
mcrn	ğ”ˆ
mcrnd	ğ”ˆ²
mcrnz	ğ”ˆ³
mcrs	ğ”ˆ’
mcrt	ğ”ˆ“
mcrts	ğ–œ¨
mcrz	è™¶
mcs	å·
mcsk	ğ”ˆ—
mcsks	ğ”ˆ¡
mcst	ğ“¦†
mct	ğ“™—
mcts	ğ“¦‡
mcv	ğ“¦ˆ
mcz	ğ“¦„
me	ã‚
meC	ğ”¤
meSn	å¨
meb	ğ“¢”
med	å‰´
medz	å™˜
mefl	ğ“¦–
mek	å™¥
meks	å™§
mekt	å™¦
mel	äš˜
meld	å™™
melz	å™ 
mem	ğ“¤—
memd	ğ“¤˜
memz	ğ“¤™
men	å™¡
mend	ğ“¤³
meng	ğ“¤´
menz	ğ‘„§
meps	ğ“¥ƒ
mer	ğ“¦—
mes	ğ“¢–
mesk	ğ“¥¤
met	åœ€
mets	åœ
mev	ğ“¦‰
mevz	ğ“¦’
mez	ãŒ‘
mezd	ãŒ
mi	ã„¶
miC	ğ”€µ
mid	ğ’ˆ•
midz	ğ”€£
mig	ğ’Šˆ
mik	ç “
miks	ğ”€¶
mil	ã¥‰
milz	ğ”€¤
mim	ğ”†
mimz	ğ”‡
min	åœ‰
mind	åœ
mink	ğ”‚
mint	ğ¡„
mints	ğ”€·
minz	åœ‘
mip	é˜©
mir	ãŒ£
mirt	ğ”€¸
mirz	ğ”€¥
mis	ğ“¤ˆ
mit	å™…
mits	åœ•
mitz	ğ”€¹
miv	ğ”€§
miz	ã¢“
mo	äš“
mob	ğ”…—
mod	å–
modz	ğ”…¢
mog	ğ•¡–
mok	ğ”…’
moks	ğ”…¶
mol	ğ”…¥
mold	èŠ–
moldz	ğ”…¸
molt	ğ”†„
molts	ğ”†…
molz	ğ”†€
mon	ç€¤
mond	è¤§
monk	ğ”…¦
mont	ğ §
monz	è¤¨
mop	ğ”ˆ‚
mopt	ğ”ˆƒ
mor	ã¢
mos	å¸
most	ãŠ•
mot	äœ
mots	ğ”…“
moz	äš”
mu	å™¶
muS	å¨
mud	å¥
mudz	ğ”†—
mug	ğ”†˜
muk	ğ”‰†
mul	èˆ
mulb	ğ”‰‘
mun	å¦
mund	ğ’ˆ…
mundz	ğ’ˆ†
mung	ğ”‰£
munt	ğ”ˆ±
munz	ğ“€”
mur	è“
mus	å§
mut	ğœ‚
muts	ğ”ˆ
muv	å†
muvd	å‡
muvz	å‰
muz	ğ“€¶
mw^n	æ™—
mwat	æ™™
mwer	æ™ 
mx	ã€©
mxJd	ä•
mxk	å…©
mxl	ãŒ¸
mxlz	ãŒ¹
mxm	åœ†
mxn	ã€·
mxnd	ãŠ”
mxndz	ä’‘
mxnt	ã†ƒ
mxnts	ãˆ—
mxnz	å•¡
mxr	åš‡
mxs	äœ•
mxt	å‘¡
mxz	å™µ
my@n	ğ¡ˆ
myR	ğ”‰¤
myU	æˆ
myUr	ğ¡•
my^	ç•”
my^l	ğ•™°
my^m	ç³
my^mz	ç´
my^n	ğ¡–
myan	ğ¡†
myat	ğ”„”
myc	ğ”‰¶
mye	ğ’‚”
myo	ğ”‰µ
myu	ã†
myudz	è¥¤
myuk	ğ‘€±
myuks	ğ‘€²
myul	ğ”‰‡
myulb	ğ”‰ˆ
myulz	å™
myun	è”…
myunk	ğ”‰‰
myunz	ğ‰…
myur	ğ–‰
myut	ğ‰†
myuts	ğ‰‡
myuz	è§
myuzd	ãŒ¢
myx	ä¤±
n	å¡™
n@	ã”¸
n@C	å ¡
n@U	å¡•
n@b	ğ“’‘
n@bd	ğ”‰¸
n@bz	ğ”‰¹
n@d	ğ’‘¶
n@dz	ğ’‘·
n@f	ğ“‰
n@g	é ¶
n@gd	ğ”Š€
n@gz	ğ“’”
n@k	å’—
n@ks	é”•
n@kt	ğ‘‘
n@kts	ğ‘‘‘
n@l	é
n@lp	ç‘±
n@lz	é‚
n@m	ğ‘¦
n@n	å •
n@nd	ğ‘‡
n@ns	ğ‘ µ
n@nst	ğ‘ ¶
n@nts	ğ”Š‡
n@nz	å –
n@p	å’˜
n@ps	å —
n@pt	ğ“‰
n@r	ğ“’—
n@rz	ğ”Š‰
n@s	å ™
n@st	ğ”Š
n@sts	ğ’œ‡
n@t	å”
n@ts	ğ’‘…
n@v	ğ”Š˜
n@z	ğ“…¨
n@zm	ğ”š–
nE	ä’’
nEC	ğ“‰•
nEJ	å™¸
nEd	å ¦
nEdz	ğ”Œƒ
nEf	é‘§
nEfs	é‘©
nEft	ğ“”°
nEg	ğ˜¹
nEgz	ğ”Œ
nEk	ä‰†
nEks	å£
nEkst	å ¸
nEksts	ğ”Œ©
nEkt	ä‰…
nEkts	ğŒ…
nEl	æ€„
nElmz	ğ”Œ”
nElt	ğ“”„
nElz	èŒ„
nEm	ğ“€
nEn	è„†
nEnt	ğ”––
nEnz	ğ…³
nEp	ğ“†ƒ
nEps	ğ–™¢
nEpt	ğ“†‚
nEr	é„
nErn	ğ”Šƒ
nErz	é…
nEs	äŒ£
nEsk	ğ•€¹
nEst	å‰·
nEsts	å ³
nEt	ã€…
nEts	è‡
nEv	ğ•–”
nEz	è…°
nI	ãŒ·
nIC	æœ…
nICk	ğ”‚
nIG	ã’
nIJ	ä–ˆ
nIJd	å™·
nIS	äŠ…
nISt	ä¡“
nIT	æˆ‡
nIb	ğ”Œ°
nIbz	ğ”Œ±
nId	ç–‘
nIdz	èˆµ
nIf	é€
nIfs	é
nIft	ğ•ˆ 
nIg	å¡ˆ
nIgd	ğ¦
nIgz	ğ¦‘
nIh	ğ””ˆ
nIk	ä…‰
nIks	ä…
nIkst	è„¤
nIkt	å¥…
nIkz	ğ‘‰¥
nIl	è´
nIlz	ğ”Œ¶
nIm	ç˜€
nImf	ğ”˜
nImfs	ğ”™
nImts	ğ”Œ·
nImz	ç˜
nIn	å–
nInC	ğ“¦˜
nIndz	ğ’¤„
nInk	è¤·
nIns	å™¢
nInt	æ„”
nInts	ğ¢‰
nInz	èœ‰
nIp	åš€
nIps	ğ”€
nIpt	ğ”Œ¹
nIr	è‘¤
nIrd	é˜
nIrz	è‘¥
nIs	ã‰ƒ
nIst	ä„´
nIsts	ç‘¤
nIt	ã”
nIts	ã¤³
nItzs	ğ”ƒ
nIv	ğ¡—
nIvz	ğ“…³
nIz	ç¡¨
nIzm	ğ“¡
nO	ã…
nOd	å¥
nOdz	ç˜¹
nOl	ğ’¥¢
nOn	è„¸
nOnt	è„·
nOr	ğ”‰
nOrz	ğ”
nOs	ğ”†
nOst	è¤¸
nOt	è¤¹
nOz	å¡‡
nR	ã•
nRd	è˜°
nRdz	è„
nRl	ğ”Œ—
nRn	ğ””
nRnd	ğ–˜¤
nRrz	ğ‘€‚
nRs	å¡£
nRst	ğ”•
nRt	é‰¥
nRtt	ğ–˜¥
nRv	å °
nRvd	ğ–˜±
nRvz	å ±
nRz	ã‚‡
nU	å¡‰
nUk	é¦•
nUks	é¦–
nUl	ğ“…‰
nUr	ğ†„
nUs	ğ“‰—
nW	å¡˜
nWlt	ğ’¢‚
nWn	è„³
nWnd	ğ•‚–
nWns	è„±
nWnst	è„²
nWnz	ğ”¹
nWr	ç˜¸
nWrz	ğ•…°
nWs	ğ“”–
nWt	é•—
nWts	é•˜
nWz	ğ”ƒ
nY	ä‘¥
nYC	ğ”
nYJl	å¡
nYb	ğ”Œ‘
nYd	ç˜„
nYf	å”
nYfs	å”‚
nYft	ğ“”…
nYk	ğ’™±
nYks	ğ”Œµ
nYl	ğ“Œ£
nYlz	ğ“Œ¤
nYn	å¡…
nYnT	å¡†
nYnts	ğ”Œ¸
nYnz	é…
nYp	ğ“”‡
nYr	ğ’•
nYrz	ğ”—
nYs	å ¹
nYt	å©
nYts	å¡‚
nYv	ğŒ†
nYvz	ğ’‘¸
nYz	å¤†
nYzd	å¤‡
n^	ã€¤
n^b	è¥¥
n^d	èˆ´
n^dz	ğ–Œ 
n^f	äœ–
n^fs	ğ‘’ƒ
n^g	é“
n^gd	ğ”
n^gz	ğ“€
n^k	èš€
n^ks	é‡
n^l	ç¢
n^ld	è„µ
n^ldz	èŒ…
n^lf	ğ’ˆ‡
n^lz	ç¥‚
n^m	å¡¢
n^md	ğ”“
n^mz	è€
n^n	åŒ³
n^nd	è‚€
n^nk	ğ‘¡‚
n^ns	ç”’
n^nst	ğ™
n^nt	ç”“
n^nts	ğ‰–
n^nz	èŠ„
n^p	ä„¶
n^ps	å„±
n^s	ç‘ 
n^st	ç‘˜
n^sts	ç‘™
n^t	ã¤¦
n^ts	ä•³
n^v	é‘¦
n^vz	é‘¨
n^z	çœ¤
na	ã…³
naC	ğ“”‰
naCt	ğ”·
nab	å”ƒ
nabz	å”„
nad	ğ‘•²
nadz	ğ”†
naf	ğ“„±
nafk	ğ”‡
nag	èµ
nak	å”…
naks	å”‡
nakt	å”†
nal	èŒƒ
nald	ğ‘‘
naldz	ğ’˜†
nalf	ğ”˜¢
nalz	ğ“ˆ†
nam	ç…¶
namz	ğ–œƒ
nan	ç˜
nand	ğ‘’
nanh	ğ”–
nans	ğ”˜
nanz	ç™
nap	ğ“”“
napf	ğ“””
nar	è‚
narT	å¡“
nard	è‚
nardz	èƒ
nark	ğ“§
narks	ğ”††
narl	ğ’‘‚
narld	ğ’‘ƒ
narlz	ğ’‘„
narm	ğ–˜“
narmd	ğ–˜”
nars	ğ–™ˆ
nart	ğ˜„
narts	ğ˜…
narz	è¡¢
nas	ğ‘‘“
nast	è‚„
nat	ã¥¢
nats	èˆ¨
nav	éŒ“
navsk	é–™
navz	ğ—„’
naz	å ˜
nc	å ¢
ncb	ğ“’˜
ncd	ğ’‘†
ncf	èŒ‰
ncfs	ğ•¤¥
ncft	ğ”ˆ
ncg	ğ‘¦
ncgz	ğ‘§
ncl	ç„¤
ncldz	ã‚
nclt	é¥“
nclts	ğ•‚“
nclz	ğ”Š†
ncn	ğ„
ncnz	ğ‘‘
ncp	çœ 
ncr	äœ”
ncrT	å¡’
ncrd	ğ“…
ncrg	ğ” 
ncrk	ğ”¢
ncrm	ğ”£
ncrmz	ğ”¤
ncrs	ğ”¥
ncrsk	ğ”¦
ncrt	ğ“ˆ‡
ncrts	ğ”§
ncrz	åŠƒ
ncs	ğ“’™
nct	è‰
ncts	è‰´
ncv	ğ‘˜‚
ncvs	ğ—„†
ncz	ğ’‘‡
ne	ã¥°
neb	ğ“’’
ned	ğˆ¥
nedz	ğ’–†
neg	ğ–±
negd	ğ–²
nek	ğ”Š
nel	ä¡
neld	ğ”Š‚
nelz	ä¡‘
nem	å ’
nemd	å ”
nemz	å “
nen	ğ˜‡
nep	ğ“’•
nepk	ğ“’–
nes	ğ‘‚”
net	ä‰µ
nets	ç¤™
nev	ğ“”€
nevz	ğ“”
nez	åœ‡
ni	ã¹
niC	ğ“”´
niT	ã™—
nib	ğ”Œ„
nid	å §
nidz	å ¨
nif	ğ“”‚
nig	è¤¶
nik	ç„¸
niks	é¢•
nil	å”€
nild	ğ”Œ…
nildz	ğ”Œ²
nilz	ğ‚
nim	ğ”Œ³
nimz	ğ”Œ•
nin	ãœ¹
ninz	ã‡
nip	ğ“”ƒ
nir	å £
nird	ğ‘‘°
nirz	é–ƒ
nis	å¡€
nisk	ğ–‘§
nist	ğ–‘¤
nit	å ¤
nits	ğ”Œ“
niv	ğ’Š‘
nivz	ğ”Œ‚
niz	ãƒ
no	ãˆ
nod	è„°
nodz	è„¶
nof	ğ“”•
nog	ğ”‚ˆ
nok	ğ“”
noks	ğ”…
nol	ç™
nold	ğœ™
nolf	ğ”‘
nolt	ğ”’
nolz	ğ“”‘
nom	ğ’Š”
nomz	ğ’‘ˆ
non	å”ˆ
nonst	ğ–˜•
nonz	ğ“”—
nop	å¡
nops	å¡‘
nor	å
nos	ç‰
nost	ğ¥‡
not	å¡–
nots	ä‰‡
nov	é¡ƒ
noz	å”‰
nozd	å¡”
nu	ã‘¶
nub	ğ”Œ™
nud	æ‰‘
nudz	ğ”‰
nuf	ğ“•†
nuk	ğ”‘
nuks	ğ”’
nul	ğ‘²
num	èµ
nun	ãˆµ
nunz	ç’
nup	ğ“”’
nus	ğ”Œ£
nut	å‡
nuts	ğ”Œ¦
nuv	ğ–œ‰
nuz	å ·
nx	ã©
nxl	ãˆ‡
nxld	ä•¡
nxldz	ä•¢
nxlz	ã¥²
nxm	æ‚
nxns	ã„£
nxt	ä•¥
nxz	ã•
nyIn	å¢˜
nyIns	ä‰¦
nyR	å‘—
nyu	ä‰˜
nyxn	å¢“
nyxs	å€”
o	ã£
oC	é„
ob	è±
obz	è²
od	ğ”
odz	ğ•
og	ğ”‚
ok	è‰
oks	ğ”…
ol	å¢‰
old	å¢ˆ
oldz	ğ”¨
olf	ğ‘˜
olk	ğ”¡
olm	ğ”±
olt	ğ‘˜“
olz	å¤‰
om	é 
omf	ğ–”´
omz	é¢
on	å¢”
ond	å¤¨
ont	ğ”™–
onz	èˆ
os	ç™‘
ost	ğ”‘¤
ot	å¡¦
ots	å¡§
oz	ä—
p	æ…“
p@	ã‘ƒ
p@C	å¥¥
p@Ct	å¥¦
p@T	å¥§
p@bst	ğ””“
p@d	å–ƒ
p@dz	å¤´
p@f	ğ””•
p@g	ğ’©
p@k	ã”’
p@ks	å¤³
p@kt	å¤²
p@kts	ğ‰ˆ
p@l	å¥ƒ
p@lm	ğ””¢
p@lz	ğ””˜
p@m	å¥„
p@mz	ğ””§
p@n	ä¸
p@nd	ğ””°
p@nt	å¥‡
p@nts	å¥ˆ
p@nz	å¥†
p@p	ğ””±
p@r	ğ–€¨
p@s	å¥™
p@sk	ğ”•‡
p@st	å¥ 
p@sts	ğ”•’
p@t	å¥¤
p@ts	å¥³
p@v	ğ”•—
p@z	ğ¡¥
pE	ä˜
pEC	ğ“…•
pEG	å¦“
pEGg	å¦•
pEd	è–“
pEdz	ğ”ˆ„
pEg	å¦‘
pEgd	ğ”•³
pEgz	å¦’
pEk	è†„
pEks	ç¥¸
pEkt	ä“
pEl	ç¡“
pEld	ğ‰
pElk	ğ”•µ
pElt	ğ”•¶
pElts	ğ”•·
pElz	ğ‰‘
pEm	ğ”•¸
pEn	ä‘§
pEnd	ä‘¦
pEndz	ä‘¨
pEns	ğ”•¹
pEnt	ğ”–†
pEnts	ğ”–‡
pEnz	å¦—
pEp	å¦˜
pEr	æ„•
pErd	äˆ¡
pErz	ğ‰‰
pEs	æ€†
pEsk	ğ”˜„
pEst	é–“
pEsts	é–”
pEt	æ€‡
pEts	æ€‰
pEz	ğ“ µ
pI	ã€
pI9	æ€¨
pIC	ğ‘”³
pICt	æ€³
pIG	ã¢–
pIGk	æ€§
pIGz	å„§
pId	æ‚€
pIdz	é¡‰
pIg	æ€”
pIgz	æ€˜
pIk	æ€‘
pIks	æ€“
pIkt	æ€’
pIkts	ğ¡¦
pIl	èˆ€
pIlC	ğ”™€
pIlt	èˆ‚
pIlts	ğ”™„
pIlz	ğ”™‚
pIm	ğ”™…
pImp	ğ”™‡
pImps	ğ”™‰
pImz	ğ”™†
pIn	ä…¨
pInC	æ€£
pInCt	æ€¤
pInd	ğ”™‘
pIng	ğ“…–
pIngd	ğ“…—
pInk	ğ”™
pInks	ğ”™’
pInt	æ¦
pInz	ä…©
pIp	æ€°
pIps	ğ”™ 
pIr	è†—
pIrd	ğ”•°
pIrs	ğ”•¢
pIrst	ğ”˜¶
pIrz	å¦
pIs	éœ¨
pIsk	ğ”™¢
pIst	ä‘‘
pIsts	ğ’„
pIt	ã¥¹
pIts	å ‚
pIz	æ‚
pO	æ§
pOn	ä”“
pOnt	ã
pOnts	æ¦
pOt	ğ”…
pOz	æ¨
pOzd	ğ”ƒ
pR	ã˜¢
pRC	ğ”–
pRCt	ğ”–‘
pRb	ğ–‰€
pRd	å•¢
pRdz	ğ“—
pRfl	ğ–‰
pRg	ğ”¤¢
pRgd	ğ”¤£
pRk	ğ”–‰
pRks	ğ”–’
pRkt	ğ”–•
pRl	å¦„
pRlz	ğ”•£
pRn	ç¥¶
pRp	ğ–‰‚
pRs	æ€…
pRst	ğ”¤¤
pRt	ç¥·
pRvz	ğ”¤¥
pRz	ä…”
pSIs	æ™
pU	æ‚”
pUC	ğ”¤§
pUS	æ…²
pUSt	æ…³
pUl	æ… 
pUld	æ…¡
pUlts	ğ”¤•
pUlz	æ…¢
pUn	ğ”¤ 
pUr	æ‚ƒ
pUrz	è€”
pUs	ğ”š„
pUt	å²
pUts	æ…µ
pW	æ‚˜
pWC	æ‚—
pWl	ğ”•“
pWlz	æ„†
pWn	æ„
pWnd	æ„€
pWndz	æ„‚
pWns	ğ”ƒ
pWnst	ğ”„
pWnt	æ‚™
pWnz	ğ”…
pWr	ğœ¦
pWrz	ğ–‰ƒ
pWs	ğ‘´
pWst	ğ”†
pWt	çŠ‰
pWts	ğ‘ˆ¶
pWz	ğ”’
pY	ä—
pYd	ğ”—
pYdz	ğ“™¶
pYk	æ€™
pYks	ğ”˜¹
pYl	æ€ 
pYld	ğ‰•
pYlz	æ€¡
pYn	æ€¥
pYnd	ğ”‘
pYnt	ğ”™”
pYnts	ğ”™•
pYnz	ğ”‘‚
pYp	æ€©
pYps	è˜˜
pYpt	ğ”™—
pYr	ç…¢
pYrz	ğ”™¡
pYt	ğ”˜¦
pYz	ä‘·
p^	æ…•
p^C	ğ“”¹
p^G	æ…¨
p^b	æ…—
p^bz	ğ”¤ˆ
p^d	ğ“†”
p^dz	ğ•€•
p^f	æ…˜
p^fs	ğ”¤‘
p^ft	æ…™
p^g	ğ’•ƒ
p^k	ğ²
p^ks	ğ‘”°
p^l	è–
p^ld	ğ¥
p^lp	ğ”¤”
p^ls	ğ“…¦
p^lst	ğ•„
p^lt	é ˜
p^lts	é ™
p^lz	èˆ‡
p^m	æ…¥
p^mp	æ…¤
p^mps	ğ”¤—
p^mpt	ğ”¤–
p^n	ç¡¡
p^nC	æ…§
p^nCt	ğ”¤˜
p^nd	é¤´
p^ndz	ğ–„”
p^nk	ç˜”
p^nks	ğ”¤™
p^ns	ğˆµ
p^nt	ğ‘¤¦
p^nts	ğ”–
p^nz	é¤µ
p^p	æ‚†
p^ps	æ…©
p^s	ç¤°
p^st	é¤¶
p^t	é†
p^ts	é‡
p^v	ğ”•™
p^z	ç¤ 
pa	ã²
paC	ğ”œ·
pabst	ğ”œ¶
pad	æ¥
padz	èŒ©
pag	ğ’¦
pagz	ğ”‚
pak	ğ‘”±
paks	ğ”œ¹
pakt	ğ”œ¸
pal	é€—
palm	ğ”” 
palmz	ğ””¤
pam	ğ”Šˆ
pamp	ğ”’
pamz	ğ””£
pan	äŒƒ
pand	æ¶
pandz	ğ””
pans	æ‰¡
pant	ğš…
pants	ğ‘Š•
panz	äŒ„
pap	å˜‘
paps	å˜’
papt	æ‚„
par	ã°
parC	ğ””¹
parCt	ğ”•€
pard	ğ”•
park	å¥“
parks	è™¥
parkt	å¥”
parm	ğ”•ƒ
parnz	ğ”•„
pars	ğ”•…
parst	ğ”•†
part	ã©
parts	å¥˜
parz	ğ””µ
pas	ğ””’
pat	æ‚“
pats	æ‚•
pav	è„€
paz	å‚’
pc	å¥·
pcd	ğ“ˆ 
pcdz	ğ“ˆ¡
pcf	ğ‘ˆ³
pcfs	ğ‘ˆ´
pcg	ğ’ “
pck	ğ–•³
pcl	å¥µ
pcld	è†–
pclk	ğ”•”
pclm	ğ””¥
pclt	ğ’†•
pclts	ğ””¦
pclz	å¥¶
pcm	ğ”‘
pcn	ç……
pcnd	ğ”• 
pcnz	ğ‘¡
pcp	è†’
pcr	å•
pcrd	ğ”°
pcrh	ğ”œµ
pcrk	ğ”±
pcrn	ğ™…
pcrs	ğ”²
pcrt	æ¡¹
pcrts	ç¡‚
pcrz	ğ‘…§
pcs	ğ”´
pcst	ğ–¸
pcsts	ğ•…¦
pct	ğ“†
pcts	ğ”••
pcz	å¥¸
pczd	å¥¹
pe	ã³
peJ	å¤µ
peJd	å¤¶
ped	å¤·
pedz	ğ‘•˜
peg	é€‚
pegd	ğ”¦™
pek	ğ”¹
pel	å¤¸
peld	ğ“…‘
pelz	ğ“…’
pen	ã¥”
pend	éœ·
pent	å¤¹
pents	ğ””–
penz	éœ¶
pep	ğ””²
pepk	ğ””³
per	å¥€
perz	å¥
pes	å¥£
pesk	ğ”•ˆ
pest	å¥¢
pests	ğ”•‰
pet	å¥—
pets	è…’
pev	å¦€
pevd	ğ”•–
pevz	ğ”•˜
pez	ğ””—
pi	ã·
piC	å¦ƒ
piCt	ğ“…“
pid	ä€”
pidz	ğ“…”
pig	ğ”˜¸
pik	å¦…
piks	å¦†
pikt	ğ”•¡
pil	ãµ
pild	å¦‡
pilz	ã¶
pin	æ€¢
pinz	ğ”•¨
pip	å¦ˆ
pips	ğ”•©
pipt	å¦‰
pir	ä”’
pird	ã¹
pirs	ğ”•´
pirz	è†˜
pis	å„
pist	ğ”˜µ
pit	æ€ˆ
pits	ğ‰”
piv	ğ”•¥
pivd	ğ”•±
pivz	ğ”•²
piz	åˆ¸
pizd	è†™
pkIn	æ…¦
pl	ğ”œ˜
pl@	æ€¶
pl@d	ğ”™³
pl@g	ğ”™©
pl@k	ğ”™¦
pl@ks	ğ”™§
pl@m	ğ”™¸
pl@n	æ€µ
pl@nd	ğ••
pl@nk	ğ’ˆ
pl@nks	ğ”š€
pl@nt	æ€·
pl@nts	æ€¸
pl@nz	ğ”™¹
pl@s	æ€¹
pl@st	ğ€…
pl@sts	ğ€†
pl@t	ğ”š‚
pl@ts	ğ”šƒ
pl@v	ğ”šˆ
pl@z	ğ™˜
plE	æˆ
plEZ	æ‘
plEd	ğ”š‘
plEf	ğ™™
plEg	ğ”š’
plEgd	ğ”š“
plEk	è†“
plEks	ç˜¦
plEkst	ğ”–—
plEn	ã±
plEr	ğ”™¶
plEs	ğ”š—
plEt	ğ”š˜
plEts	ğ”š™
plI	ã…˜
plIC	ğ”œ
plIG	ä˜¹
plIS	ã…–
plISt	ã…—
plIf	ğ•˜£
plIft	ğ•˜¢
plIfts	ğ•˜¤
plImp	ğ”œƒ
plIn	ä”–
plInd	ğ–˜£
plInk	ğ”œ„
plInkd	ğ–˜¸
plInks	ğ–˜¹
plInt	ğ”œ…
plInz	é¤…
plIs	ç•‚
plIst	ç•ƒ
plIt	ğ™ 
plO	ğ¡°
plOd	ğ¡±
plOz	ğ¡²
plR	ğ¦
plRz	ğ§
plU	ğ”œ€
plW	æ”
plWd	ğ”œ–
plWz	ğ”œ—
plY	ãˆ
plYd	ã†
plYk	è†…
plYn	ğ”™˜
plYnz	ğ”™™
plYt	ğ”œ‚
plYts	ğ–…€
plYz	ã‡
pl^	ç„¹
pl^f	ğ”œ£
pl^g	æ•
pl^gd	æ–
pl^gz	æ—
pl^k	ğ”œ™
pl^ks	ğ”œ 
pl^kt	ğ”œ¡
pl^m	æ˜
pl^md	ğ”œ¤
pl^mp	ğ”œ¦
pl^mpt	ğ”œ§
pl^mz	æ™
pl^n	é‘
pl^nJd	æ 
pl^nd	ğ¦
pl^ndz	ğ§
pl^ng	ğ”œ¨
pl^nk	ğ”œ©
pl^nkt	ğ”œ°
pl^nz	é¤„
pl^p	ğ”™ˆ
pl^s	æ¡
pl^st	ğ””
pl^t	èˆ
pl^ts	ğ‘ˆµ
pla	ç¦”
plad	ğ”œ†
plaf	ğ”¨
plag	ğ”œˆ
plak	ç„
plam	è†‘
plan	ğ“™¸
plap	æ’
plaps	æ“
plapt	ğ”œ‘
plar	ğ‘˜°
plarz	ğ‘˜±
plas	ğ”š
plat	ğ”œ“
plats	ğ”œ”
plc	èˆ„
plcC	ğ”š…
plcd	èˆƒ
plcdz	èˆ…
plcnt	ğ“™·
plcr	ğ¡§
plcrd	ğ¡¨
plcrz	ğ¡©
plcs	ğ”œ’
plct	ğ”š†
plcts	ğ”š‡
plcz	èˆ†
ple	äˆ£
pled	æƒ
pleg	ğ”™°
plegd	ğ”™±
plegz	ğ”™²
plek	ğ”™·
plen	ã‰¡
plend	äˆ¢
plent	ğ‰—
plents	ğ‰˜
plenz	ã‰£
ples	äœ·
plest	æ€´
plet	æ€
plets	æ
plez	æ†
pli	äˆ¥
plid	ğ”š‰
plidz	ğ”š
plig	ğ’¡¹
plin	ğ”š”
plinz	èˆˆ
plit	äˆ¤
plits	ğ‰™
pliz	æ‰
plizd	æ
plo	ä™€
plod	ğ“…˜
plodz	ğ“…™
plof	ğ”œ•
plog	ğ–™–
plon	ğ”œ‰
plor	ä¢
plots	ğ”œ‡
plu	æ¢
plud	ğ”œ¢
pluf	ğ”œ
plum	ğ“™¹
plumz	ğ”œ¥
plut	ğ”œ±
plx	ä 
po	ã‚‘
poC	ğ”œ²
poCt	ğ”œ³
pog	ğ”œ´
pok	æ©
poks	æ±
pokt	æ°
pol	æ²
pold	ğ¦†
polk	ğ”‡
polks	ğ”ˆ
pols	ğ”†
polt	ğ–Œ¡
polz	æ³
pom	ğ”“
pon	é’
pond	ğ”¶
pont	è‚”
ponz	ğ”·
pop	ğ”¥
pops	ğ”¦
popz	ğ”§
por	æ„ƒ
porC	æ‚‡
pord	æ„„
port	å ¶
porz	æ„…
pos	æ‚‘
post	æ‚‰
posts	æ‚’
pot	é“
pots	é”
poz	ä”±
pozd	å¢™
pr	ğ”¢“
pr@	ğ¡µ
pr@b	ğ”‰
pr@g	ğ”‘
pr@k	æ„‡
pr@kt	ğ”
pr@n	ğ”˜
pr@nk	ğ” ‚
pr@nks	ğ” ƒ
pr@ns	ğ”™
pr@t	ğ“†
pr@ts	ğ” „
pr@v	ğ” ‡
prE	ä§
prEd	ğ”  
prEg	æ„“
prEk	ğ” –
prEkt	ğ” •
prEl	ğ” ¤
prEm	ğ” ¥
prEn	èˆ–
prEnt	ğ” §
prEp	ğ” ¨
prEpt	ğ” °
prEr	ğ” 
prEs	ä¥
prEst	å—
prEt	æ„£
prEz	ğ¡¶
prI	ã—
prId	ğ”¡„
prIg	ğ”–ˆ
prIk	æ„§
prIks	é‚‚
prIkt	æ„¨
prIl	ğ”¡‡
prIm	ğ”¡ˆ
prImp	ğ”¡‘
prIn	æ„²
prIns	æ„±
prInt	éˆ™
prInts	ä¡’
prInz	ğ”¡“
prIs	æ„—
prIsk	ğ”¡”
prIt	åƒ
prIts	ğ˜‰
prIv	ğ–˜¢
prIz	ğ”¡•
prO	ğ”¡€
prU	ğ”¤€
prW	ğ”¢†
prWd	æ…†
prWl	æ…‰
prWlks	ğ”¢‡
prWs	ğ”¢ˆ
prWst	ğ”¢‰
prWt	ğ”¢‘
prWz	ğ”¢–
prY	æ„©
prYd	ğ”¡‚
prYdz	ğ”¡ƒ
prYm	æ„°
prYmd	ğ”¡
prYmz	ğ”¡‰
prYn	ğ”¡’
prYs	æ„¦
prYst	ğ”¸
prYt	ğ•˜’
prYts	ğ•˜“
prYv	ä‘©
prYvd	ä‘°
prYvz	ğ¡¸
prYz	æ„´
prYzd	æ¢
pr^	ç¡‘
pr^d	ğ”¢™
pr^l	èˆ£
pr^lz	èˆ¤
pr^m	ğ‘”´
pr^mz	ğ‘”µ
pr^n	é•
pr^ns	ğ–µ
pr^nz	èˆ¦
pr^s	ğ™—
pr^st	ğ”¤„
pr^t	ğ…
pr^ts	ğ“ˆˆ
pr^z	ğ”‘€
pra	å˜
prab	æ„µ
prabst	ğ”¡™
prad	ğ”¡¡
pradz	ğ”¡¢
prafs	ğ”¡¤
prag	ğ”’
pragz	ğ”“
prak	èˆ¡
pral	ğ””
pram	ğ’‰¦
pramp	ğ“…¢
pramps	ğ”¡©
prampt	ğ”¡§
prampts	ğ”¡¨
pramz	ğ”¡°
pran	ğ”—
prap	ğ“¤¤
praps	ğ”¡·
prapst	ğ”¡¸
prapt	ğ”¡¶
prast	ğ”¢ƒ
prat	ğ”¢…
prats	ğ”¢„
prav	ğ“…£
praz	ğ‘Š–
prc	èˆ¥
prcf	ğ“•‚
prck	ğ”¡ 
prcl	ğ”•
prcn	ğ” …
prcnd	ğ”¡²
prcnz	ğ” ˆ
prcp	çƒ
prcr	ğ–™€
prcs	ğ”¡¹
prcz	ğ” †
pre	æ„ˆ
pred	ğ” ‰
prel	ğ”–
pren	ğ” 
preng	ğ” €
prer	æ„‘
prerz	æ„’
prev	ğ¡³
prevd	ğ¡´
prez	æ„‰
prezd	æ„
pri	ã‘
priC	ğ” ‘
priCt	ğ” ’
prib	ğ” ”
prik	ğ” “
prim	ğ”¡…
primz	ğ–‰„
prin	ğ€‡
prind	ğ” ¡
pris	èˆ”
prist	ğ¡·
prists	ğ”¡†
prit	ğ µ
priv	ğ•„€
priz	ã¥§
pro	å™
proC	èˆ—
proCt	ã•
prob	ğ”Œ–
probd	ğ”¡˜
probz	ğ”¡—
prol	ğ”¡£
pron	ğ”¡±
prop	ã–
props	ğ”¡µ
pros	ğ”¢€
prosk	ğ”¢‚
prot	ğ””´
proz	ğ“™ 
pru	æ…ˆ
prud	ğ”¢˜
pruf	æ…‚
prufs	ğ”¡´
pruft	ğ”¡³
prun	ğ”¤‚
prund	ğ”¤ƒ
prunz	æ…
prus	ğ” ¸
prust	ğ”¢
prut	ğ”¤
pruv	æ…‡
pruvd	èˆ™
pruvz	èˆ 
pruz	ğ”¢—
prx	æ„¤
prxl	ã€
prxn	ã
pti	äœƒ
pu	å¥‰
puC	ğ”˜
pud	ğ” 
puf	ğ”™
pug	ğ”¤“
pul	æ¸
puld	ğ”¢
pulz	ğ”¡
pum	æ…£
pun	æ¥“
pund	ğ“™™
punt	ğ”¤‰
punz	ğ’…
pup	æ¹
pups	æ‚‚
pupt	ğ”£
pur	ğ“ƒ
purz	ğ”¤
put	ğ’†
puts	ğ”¤
puz	æ·
px	ã´
pxl	ãƒ
pxld	ç‚‘
pxlz	ã„
pxn	å†
pxnd	å†‚
pxnz	å†ƒ
pxs	ã¥—
pxt	å´
pyU	æ…±
pyu	äˆ¦
pyx	æ‚…
r	ğ•€¨
r@	ã¤„
r@C	ğ”¦
r@G	ã£
r@S	æˆ™
r@b	ğ”¥·
r@d	è”ˆ
r@dz	è”‰
r@f	å€´
r@fs	å€µ
r@ft	ğ”¦…
r@fts	ğ”¦†
r@g	æˆ‚
r@gz	æˆƒ
r@k	èˆ³
r@ks	éŒ‰
r@kt	ğ”¦‚
r@l	äŠ†
r@lf	ğ”¦”
r@lfs	ğ”¦•
r@m	æˆ‘
r@md	ğ”¦—
r@mk	ğ•€
r@ml	ğ”¦–
r@mp	ğ”¦˜
r@mps	ğ•€€
r@ms	ğ•€‚
r@mz	ğ‘†‰
r@n	åˆ
r@nC	æˆ“
r@nd	ç˜¨
r@ndz	ğ•€…
r@nft	ğ•€†
r@nk	ğ•€„
r@nks	ğ•€ˆ
r@nkt	ğ•€‡
r@ns	ğ•€ƒ
r@nt	ğ‘Œ
r@nts	ğ•€
r@nz	ğ“ˆ¢
r@p	æˆ”
r@ps	æˆ•
r@pt	æˆ–
r@s	æˆ˜
r@sk	ğ•€—
r@sp	ğ•€™
r@sps	ğ•€¡
r@spt	ğ•€ 
r@st	ğ•€£
r@t	æˆ¡
r@ts	æˆ¢
r@tz	ğ•€¥
r@v	è„
r@z	æˆ 
rE	ã‚€
rEC	ğ–¥”
rEb	ğ•ˆ
rEd	æˆ¥
rEdz	ğ•—
rEf	ğ•¦
rEg	æ‰‚
rEgz	ğ“…§
rEk	ã‡
rEks	æ‰´
rEkt	äŠ‡
rEkts	ğ¦ˆ
rEl	è‰±
rElf	ğ•‚‡
rElm	ğ•€
rElmz	ğ•
rElz	ğ’ˆ±
rEm	æ‰‰
rEmp	ğ•‚
rEms	ğ•‚‘
rEn	ä’™
rEnC	ğ•‚”
rEnCt	ğ–¥“
rEnd	è¢•
rEndz	è¢–
rEnk	ğ•‚•
rEns	ğ•‚—
rEnt	å¥‘
rEnts	æ‰’
rEnz	ğ“ ’
rEp	æ‰”
rEps	ğ•‚˜
rEr	æˆ—
rEs	ä™
rEsk	ğ•„‚
rEst	æ‰¢
rEsts	èŠ˜
rEt	ã•£
rEts	ã•¤
rEtz	ğ•„¤
rEv	ğ•„§
rEvd	ğ•…
rEvz	ğ•„¹
rEz	ç¥¥
rI	ãŒ˜
rIC	æŠ‚
rICt	ğ‘’…
rIG	ã‰™
rIGz	ä™”
rIJ	ã™°
rIS	å€¤
rIb	ğ’
rIbd	ğ•…’
rIbz	æŠ€
rId	æŠ„
rIdz	ğ•…•
rIf	æ‘©
rIfs	ğ•…—
rIft	ğ•…–
rIfts	ğ•…˜
rIg	ç––
rIgd	ğ‘€´
rIgz	ğ’‰·
rIk	ä€´
rIks	è‘
rIkts	ğ•…“
rIl	é”¹
rIld	ğ’
rIlsk	ğ”¡
rIlts	ğ’ˆ²
rIlz	ğ‘œ´
rIm	ğš‘
rImd	ğ•…¡
rImp	æ”ƒ
rImz	ğ•…¢
rIn	ã
rInC	ğ‘ˆ
rInJ	å¤‚
rInd	è¥‰
rIng	ğ–Œ¢
rInk	ğ“ ¸
rInks	ğ“š†
rIns	ã¸
rInst	æŠˆ
rInt	ã´
rInts	å¥’
rInz	ç ”
rIp	æŠ‰
rIpk	ğ•…¥
rIps	æŠ’
rIpt	æŠ‘
rIr	ğ’…ˆ
rIrd	ğ•…
rIrz	ğ•†
rIs	ä ±
rIsk	ğ•…§
rIsks	ğ•…¨
rIskt	ğ•…©
rIst	äš™
rIsts	èˆ©
rIt	ã†‚
rIts	ã¦
rItz	ğ’ˆ³
rIv	ğ“²
rIz	é™†
rIzk	ğ•…´
rIzm	è„‡
rO	ä‰¹
rOd	ğ™
rOdz	ğ€
rOg	ğ•†•
rOl	ğ•†–
rOld	ğ•†—
rOs	ğ•„¥
rOt	è ¢
rOz	äŠ€
rR	ã¥µ
rRd	ğ’ˆ°
rRl	ğ–¦‡
rRz	äœ‚
rU	æŒ‡
rUf	æŒ†
rUg	ğ•‰
rUk	ğ•ˆ…
rUks	ğ•ˆ†
rUl	ğ•‰‚
rUm	ğ•˜°
rUr	ğ•ˆ‡
rUs	è¤‡
rUt	æŒ
rUts	ğ•ˆ·
rW	æŒ–
rWC	ğ•ˆ¨
rWk	ğ– ¹
rWl	ğ•€©
rWlt	èƒ
rWn	æ¢‚
rWnd	ã¡
rWndz	ğ•ˆ±
rWnz	ğ•ˆ²
rWs	ğ•€²
rWt	ğ•€³
rWts	ğ•ˆ¶
rWz	ğ•€‘
rWzd	ğ•ˆµ
rY	ãŒƒ
rYd	æŠ…
rYdz	æŠ†
rYf	ğ•·
rYg	ğ•¸
rYk	ğ‘‚
rYks	ğ•µ
rYl	ğ•¹
rYld	ğ•… 
rYlz	ğ•…
rYm	æ‰µ
rYmd	ğ•…‰
rYmz	æ‰¶
rYn	è˜
rYnd	ğ•…£
rYndz	ğ•…¤
rYns	ğ•‚
rYnts	ğ•‚„
rYnz	ğ•‚‚
rYp	æŠ
rYr	ğ•‰•
rYs	æŠ
rYt	ãŒ‚
rYts	æŠ‡
rYv	ğ•…±
rYvd	ã¦
rYvz	ğ¢„
rYz	ã•
rYzd	ğ–
r^	æŒ•
r^C	ğ“„
r^S	æŒ²
r^St	æŒ³
r^b	æŒ™
r^bd	æŒ 
r^bz	æŒ¡
r^d	è‰¸
r^dz	ğ’’™
r^f	æŒ”
r^fs	ğ•ˆ©
r^ft	ğ•ˆ°
r^g	æŒ£
r^gz	æŒ¦
r^k	èœ˜
r^ks	è‘
r^l	ç¡¸
r^ld	è“
r^ldz	ğ‘¸
r^lf	ğ“”
r^lz	è™°
r^m	æŒ©
r^mf	ğ•‰ˆ
r^mp	ğ•‰†
r^mpf	ğ•‰‡
r^mz	ğ’€ 
r^n	æŒ°
r^nd	è’†
r^ndz	ğ‘•
r^ng	ğ”‘„
r^nk	ğ•‰„
r^ns	ç‘€
r^nt	ç¶
r^nts	ç™ˆ
r^nz	æŒ±
r^p	è”ƒ
r^ps	ğ‘–—
r^pt	å„
r^pts	ğ‘•–
r^rz	ğ–‚
r^s	ç™
r^sk	ğ•‰
r^sks	ğ•‰‘
r^sp	ğ•€¢
r^st	è•˜
r^sts	ğ’€…
r^t	èœ 
r^ts	è¥
r^v	ğ•…€
r^z	ç™¤
ra	å‘¥
raC	ğ”‰ƒ
raZ	ä¦–
rab	ğ”¥³
rabd	ğ•†
rabz	ğ”¥´
rad	è•‰
radz	ğ”–…
raf	èœ™
rag	ğ¡…
rak	æ€ƒ
raks	æŒ€
rakst	ğ–¥¤
rakt	ğ•††
ral	èˆ¸
ralf	ğ”¦“
ram	æŒ„
ramp	ğ•†™
ramz	é¡„
ran	æŒ…
rand	ğ‘Š—
rank	ğ•ˆ
rant	æ‰£
ranz	ğ‘’†
rap	ğ”¥µ
raps	ğ•ˆ’
rar	ğ’ˆ
rard	è¥©
rarm	ğ‘¡„
rarmz	ğ‘¡…
ras	ğ‘•ˆ
rast	ğ•ˆ¡
rat	è‰€
rats	ğ”¥¶
rav	ğ““
raz	ç¢
rc	åš‘
rcC	ğ•€§
rcG	çŒ™
rcb	ğ•€¦
rcd	ğ“„¸
rcf	éŒ™
rcg	ğ––ƒ
rck	ğ“…
rcl	ä‚’
rclp	ğ‘•
rclt	ğ”–˜
rclz	ğ’ˆ¦
rcm	ğ•€°
rcn	ç¤
rcnd	ğ–¥–
rcnt	ğ–ˆ™
rcnz	ğ–¥—
rcp	ğ•€±
rcr	ğ’…±
rcrd	ğ•…¸
rcrk	ğ”„
rcrz	ğ•…¹
rcs	æŒ’
rct	ğ‘’
rctb	ğ•ˆ£
rcts	ğ•ˆ¤
rcv	ğ•‰³
rcz	ğ•ˆ˜
re	ãˆ
reC	ğ”¦ˆ
reI	åŒµ
reb	ğ”¥¸
red	å€…
redz	ğŒ‡
ref	ğ”¦„
reg	èŒ˜
regd	ğ‘’„
rek	ä™‘
reks	ğ”¦‰
rekt	ğ”¦’
rel	ã‚•
reld	ğ¢€
relz	ğŒˆ
rem	ğ•…†
remz	ğ•…‡
ren	ã¤
renJ	ã¢
renJd	ã£
rend	æˆ†
reng	ğ¢
rengd	ğ¢‚
renk	ğ•‚€
renz	æˆˆ
rep	ğ•€’
reps	ğ•€”
rept	ğ•€“
res	æ†™
resk	ğ•€˜
rest	æˆ€
ret	ã‘‡
rets	ã‘‰
rev	ğ•€µ
revd	ğ•€¶
revz	ğ•€·
rey	ğ“€µ
rez	æˆ‰
rezd	æˆ
ri	ã·
riC	æˆ£
riCt	æˆ¤
riT	çŒ—
rib	é³
ribz	ğ•™
rid	ã¤†
ridt	ğ•¶
ridz	æˆ¦
rif	ğ• 
rifs	ğ•¡
rig	ğ•¢
rik	ğ’¢‰
riks	ğ•£
rikt	ğ–¥’
ril	å™
rild	ğ•¤
rilz	ğ”Œ¥
rim	é°
rimz	é±
rin	å‘
rints	ğ•¥
rinz	æ¤§
rip	ğ•‚
rips	ğ•„
ript	ğ•ƒ
rir	æˆ§
ris	ç„§
rit	è”€
rits	ğ”¦ƒ
riv	ğ“¢’
rivz	ğ•‡
riz	ã–‰
ro	ã·
roC	ğ•…µ
rob	ğ•†‚
robd	ğ•†ƒ
robk	ğ•†ˆ
robz	ğ•†„
rod	ã¶
rodz	æŠ“
rog	ğ•†‰
rogz	ğ•†“
rok	ğ•ˆ“
rol	æŒ
rold	æŒ‚
rolf	ğ¥™
rolfs	ğ•†”
rolk	ğ•†
rolt	ğ“¥
rolz	æŒƒ
rom	å°
romd	ğ•…¶
romz	ğ•…·
ron	ğ¢
ronz	èŒ
rop	æŒ‘
ropk	ğ•†‘
rops	ğ•ˆ‘
ropt	ğ•ˆ
ror	æŠ”
ros	éœ²
rosk	ğ•†’
rost	æŠ•
rosts	ğ•†€
rot	æŒ“
rov	æŒ˜
roz	åˆ¶
ru	ã 
rub	è¥¸
rud	æŒ¢
ruf	ğ•ˆ„
rufs	ğ•ˆƒ
ruft	ğ•ˆ‚
rug	è €
ruh	ğ•‰ƒ
ruk	è¤
rul	æŒ§
ruld	ğ”’
rulz	æŒ¨
rum	æ…
rumz	å †
run	ã•¥
runz	ã•¦
rup	èŒ£
rus	æŒ‰
rust	ğ•„¦
rut	èŒ¡
ruts	è¤„
ruw	ğ•‰”
ruz	å‘¤
ruzd	ğ•‰‰
rx	ãˆ™
rxk	ä€³
rxl	ã•¡
rxld	ä¡¤
rxlz	ã•¢
rxm	ä¤´
rxn	ã‚™
rxnt	ã„†
rxnts	å‚“
rxnz	å‘¦
rxp	äœ°
rxs	ä¢
rxz	ã¥‘
s	ğ“³
s@	æ‚
s@C	ğ•‰¡
s@Cs	ğ•‰¢
s@G	æ‘
s@b	ğ•‰™
s@bz	ğ•‰˜
s@d	æŒµ
s@dz	ğ•–
s@f	è’
s@fl	ğ•‰¥
s@ft	éœ¹
s@fts	é€
s@g	ğ” ¹
s@gd	ğ•‰§
s@gz	ğ•‰¨
s@k	å’™
s@ks	ğ†
s@kt	ğ•€‰
s@l	ã€“
s@ls	ğ•Š€
s@lt	ğ•–•
s@lts	ğ•Š
s@lz	ğ•‰µ
s@m	æ…
s@mp	ğ•Š‡
s@mt	ğ’Œ“
s@mz	ğ•Š„
s@n	ã‰¶
s@nd	æ‰
s@ndz	ğ”¥¢
s@ng	ğ•Š‘
s@nk	ğ•‰
s@nks	ğ•
s@nkt	ğ•‰£
s@ns	ğ•Š’
s@nt	æ€²
s@nts	ğ•
s@nz	ğ’¢
s@p	è†
s@ps	ğ”„€
s@pt	ğ•Š”
s@r	ğ•‰©
s@s	ç¦‚
s@t	æ’
s@ts	ğ‰§
s@tz	ğ•…
s@v	ğ•Œ‰
sE	ã…†
sET	æ±
sEb	ğ¦ƒ
sEd	æŒ·
sEdz	ğ•˜ƒ
sEf	è–
sEfs	é¥ƒ
sEg	æ—
sEk	æ†
sEks	æ¸
sEkst	ğ•–…
sEkt	ğ‘¦
sEkts	ğ‘§
sEl	ä€ˆ
sElb	ğ••¨
sEld	é¡“
sElf	åˆ·
sElfs	ğ••©
sElk	ğ••°
sElm	è…„
sElp	ğ•˜‡
sElt	æ˜
sElts	é¡–
sElv	ğ•˜ˆ
sElvd	ğ•˜‰
sElvz	æ¥¸
sElz	ä€‰
sEm	ã‘‘
sEmf	ğ••
sEmp	é¡˜
sEmz	ğ••±
sEn	ä€’
sEnd	æ™
sEndz	æ 
sEnf	ğ••²
sEnft	ğ••³
sEnk	ğ•–
sEns	æ¡
sEnsk	ğ••µ
sEnst	ğ“…²
sEnt	ä€‘
sEnts	ä€•
sEnz	ğ••´
sEp	ã…
sEpC	ğ‰²
sEps	é€˜
sEpt	ã…€
sEpts	ç”°
sEr	ç•¥
sErz	èš„
sEs	ã……
sEsC	ğ“…´
sEst	å¡±
sEt	æ°
sEts	è€
sEv	ğ“’„
sEvz	ğ—‡
sEz	æ—
sI	ã€„
sIC	ğ“’
sIG	ã„°
sIGk	æ”•
sIGz	ãœ”
sIJ	åœ¤
sIZ	ä‘„
sIb	æ”†
sId	ãœ“
sIdz	ç¢„
sIf	å‘…
sIfb	ğ•¢
sIfs	ğ“Œƒ
sIft	ğ“¤ 
sIfts	ğ•™£
sIg	æ”
sIgd	ğ” ±
sIgn	ğ“†’
sIh	è´
sIk	ãˆ
sIks	ã•±
sIksT	æ”¡
sIkst	ğ•™¸
sIksts	ğ•š
sIl	å™€
sIld	ğ–‚’
sIlf	ğ–Œ˜
sIlk	ğ•£
sIlks	ğ•™§
sIlm	ğ–Œ€
sIls	ğ•™¨
sIlt	ğ’ –
sIlts	ğ•¤
sIlz	ğ˜
sIm	ä˜
sImp	è¨
sImpf	ğ•¦
sImz	ğ‘™’
sIn	ä„”
sInC	ğ—
sInCt	ğ˜
sInd	ä„…
sIndz	ğ•„„
sIng	ğ•™±
sIngd	ğ•™²
sInk	ğ™
sInks	ğ” ™
sInkt	ğ” —
sInkts	ğ” ˜
sIns	å¡¡
sInt	ä‘‚
sInts	ğ“„˜
sInz	ä ‡
sIp	æ”–
sIps	æ”˜
sIpt	æ”—
sIr	ç•¸
sIrd	é €
sIrl	ğ• 
sIrn	ğ•˜
sIrz	èƒ
sIs	ã‘’
sIsk	ğ•™´
sIst	å³
sIsts	åµ
sIt	ã”„
sIts	æ”™
sItz	ğ•™¶
sIv	ã€‰
sIvz	ç’
sIz	ã„©
sIzm	è·
sO	é‰·
sOd	ğ‘ 
sOdz	ğ‘¡
sOk	ğ–™¥
sOl	ğ•¡ˆ
sOld	æ™’
sOlz	ğ•¡‰
sOn	ğ•˜
sOr	ğ•¡
sOz	é‰¸
sR	ã
sRC	æ‰˜
sRCt	æƒ
sRb	ğ•—
sRbz	ğ••¸
sRd	ã‘
sRf	é¡¦
sRfs	ğ••¹
sRft	ğ–‰…
sRg	ğ•–€
sRgd	ğ–‰†
sRk	è¥°
sRkt	ğ•˜”
sRl	ğ••™
sRlz	ğ•• 
sRm	ğ•¨
sRn	é¡§
sRnd	äˆ²
sRnz	äˆ³
sRp	ğ‘˜¤
sRps	ğ–™ƒ
sRpt	ğ‘˜£
sRpts	ğ‘˜¥
sRrz	ğ•™³
sRs	ğ“•‰
sRst	è¨
sRt	äˆ´
sRts	äˆµ
sRv	æ§
sRvd	æ¨
sRvz	æ©
sRz	ã’
sU	è
sUd	ğ•‘”
sUf	è¥€
sUk	ğ’€•
sUl	ğ“Œ¹
sUlt	ğ•‘•
sUlts	ğ•‘–
sUr	æ¤´
sUrd	è‘
sUrz	è’
sUt	ğ•¡ 
sUts	ğ•¡£
sW	æ™´
sWT	æ™¶
sWd	ğ•¡¨
sWf	ğ•‡
sWl	ğ•Œ
sWm	ğ•ˆ
sWn	æ™°
sWnd	æ™©
sWndz	æ™±
sWpt	ğ–¡‚
sWr	ğ¤‘
sWrz	ğ•¡§
sWt	è 
sWts	è¤˜
sY	ä‘ƒ
sYb	ğ™„
sYd	ã™¤
sYdz	ã™¥
sYf	ğ•‰±
sYk	ğ”¤…
sYks	ğ•™¥
sYkt	ğ”¤†
sYl	ğ‘™‡
sYld	ğ‘™‰
sYldz	ğ•˜„
sYlz	ğ‘™‘
sYm	ğ‘¤¶
sYmz	ğ•™©
sYn	æ”‰
sYnd	æ”‘
sYnz	æ”’
sYp	ğ•˜
sYps	ğ•˜‘
sYr	ç’—
sYrz	è¥˜
sYs	ğ‰¶
sYt	ä…
sYts	éœ¸
sYv	ğ•˜•
sYvz	ğ•˜–
sYz	ä‰
sYzd	æ”£
s^	å‰¹
s^C	æ¡¦
s^Dn	æ™·
s^b	æ¡¡
s^bd	ğ–ˆ¤
s^bz	ğ–ˆ£
s^d	æ¡±
s^dz	æ¡°
s^f	é·
s^g	ğ‘…‡
s^gz	ğ–ˆ²
s^k	æ¡§
s^ks	æ¡©
s^kt	æ¡¨
s^l	æ¡µ
s^ld	éˆ˜
s^lk	ğ–ˆµ
s^lkt	ğ–ˆ¶
s^lt	ğŒ¥
s^lts	ğŒ¦
s^ltz	ğ•‘—
s^lz	è†”
s^m	æ™–
s^md	ğ–ˆ·
s^mp	è‰
s^mpC	ğ–ˆ¹
s^mps	ğ¢
s^mz	é†™
s^n	ãµ
s^nd	ç‚
s^nh	ğ“„µ
s^nk	ğ“•‡
s^ns	ç’–
s^nst	ğ“¸
s^nt	ç‘¢
s^nts	ç‘£
s^nz	æ™¡
s^p	æ¡¸
s^ps	é‚
s^pt	ğ–¥ˆ
s^s	ç•·
s^st	ğ€
s^sts	ğ‘™
s^t	é™
s^ts	è…‚
s^tz	ğ•‘˜
s^v	èŒ¦
s^vz	ğ•˜©
s^w	ğ– …
s^z	ç’ƒ
sa	æ™†
saC	ğ•ˆ”
saI	ç„µ
saZ	åš˜
sab	ğŒ•
sabd	ğ•¡‚
sabz	ğ•‰—
sad	è
sadz	è‘
saf	è…
saft	ğ”‡
sag	è‰
sak	æ™‡
saks	æ™ˆ
sakt	ğ•˜†
sal	çœ‘
salt	ğ“œ‰
salv	ğ•¡’
salvd	ğ•¡“
salvz	ğ•¡”
salz	çœ’
sam	æ…‘
samp	è¡„
samps	ğ‘‰©
samz	æ…’
san	ç¡
sand	ğ•¡—
sank	ğ•–‰
sans	ğ•‚’
sant	ğ”¸
sants	ğ”¹
sanz	è•’
sap	çœ˜
sapf	ğ•—
saps	çœ™
sapt	æ™¦
sar	æ¤
sard	è‰—
sardt	éŒ
sardz	ğ•–—
sarf	ğ•Š•
sarg	éŒ¤
sark	ğ•Š–
sarks	ğ•–˜
sarlz	ğ•Š—
sarm	ğ¦’
sarmd	ğ¦“
sarn	ğ•‚
sarp	ğ•ƒ
sarpf	ğ•„
sarps	ğ•–™
sart	é€„
sarts	ğ”‰‚
sarz	é¡©
sas	ç¦
sat	é‰ˆ
sats	ğ‘•‘
sav	ğ“Œ·
savz	ğ•Š‚
saz	èŠ…
sazd	ğ“¥©
sc	ä
scG	æ™¢
scGz	æ™¤
scb	ğ•†
scd	ğ”–™
scf	æ™
scfs	ğ”´
scft	æ™‰
scfts	ğ”³
sck	ğ“¥—
scks	ğ•‰¸
scl	å™‡
scls	ğ•Œ‚
sclt	æ„
sclts	æ™˜
sclz	ğ•‰¹
scm	ğ•Œƒ
scn	èˆ±
scng	ğ•¡˜
scnt	ğ”„
scnz	èˆ²
scr	ä”†
scrb	ğ•˜¥
scrd	é”–
scrdz	ğ–Œ“
scrg	ğ”ˆµ
scrk	ğ•˜
scrn	ğ’”
scrp	ç”‡
scrs	ç‘
scrst	ğ”’€
scrt	ã‘”
scrts	æ™¨
scrz	ä”‡
scs	ã‚
sct	ğ—
scv	ğ•Œ…
scy	æ™¸
scz	è–˜
se	äˆ¶
sebz	ğ•€
sed	è„¹
sedz	ğ–‘
sef	æŒ¶
sefs	ğ•‰¤
seg	ğ”‘˜
sek	ä¤²
seks	æ
sel	æŒ¸
seld	æŒ¹
sels	ğ•‰¶
selz	è”
sem	æ†
semd	ğ•––
semz	ğ•Š†
sen	è¡ƒ
sens	ğ•‰²
sent	æ€
sentp	ğ–ˆ 
sents	ğ“Š˜
seny	ğ“š‰
senz	ğ“„”
sep	ğ‘¨
sept	ğ‘©
ser	é˜…
serz	ğ”µ
set	ğ‰’
sets	ğ‰“
sev	æ”
sevd	æ•
sevz	æ–
sez	éš•
sf@	ğ”˜°
sf@k	ğ‘¤
sf@m	ğ””ƒ
sf@mz	ğ””„
sfE	è‘€
sfEd	ğ•–†
sfEld	ğ”‰
sfElt	ğ”
sfI	é¤
sfIg	ğ‘€”
sfIk	è„
sfIks	ğ–’‘
sfIkst	ğ–’’
sfIlm	ğ“¡—
sfIlt	ğ”„¡
sfInk	ğ“‘…
sfInks	ğ•¤•
sfIr	è¹
sfIrz	é£
sfIs	ğ’’’
sfIt	ğ”„¢
sfIts	ğ”„£
sfR	ğ”•
sfRd	è—
sfRdz	ğ””…
sfRt	ğ•†…
sfRz	ğ–’
sfUt	ğˆ°
sfY	é¡…
sfYd	ğ‘¥
sfYr	é•¹
sfYrz	é–€
sfYz	æ“
sf^	é„±
sf^l	é…¨
sf^lz	ğ–™‚
sf^nk	ğ‘Œ¢
sf^s	ğ–„¨
sfar	ğ“¦”
sfc	ğ‘Œ¥
sfclt	èƒ
sfcr	é µ
sfcrd	è•
sfcrg	ğ–
sfcrm	ğ–’“
sfcrmd	ğ–’”
sfcrmz	ğ–’•
sfcrt	ğ˜·
sfcrts	ğœ
sfcrz	ğ”˜±
sfe	ğ‘€“
sfet	ğ”˜¨
sfets	ğ”˜©
sfi	ğ–‘
sfild	é‡
sfildz	ğ’•ˆ
sfir	é†„
sfo	ğ‘˜µ
sfold	ğ•™¹
sfon	é™¥
sfonz	é™¦
sfut	ğ•–‡
sfxl	æ¡¥
sh@	ğ‘¡‘
sh@b	ğ•¡±
sh@k	ğ“‰€
sh@n	ğ”„¤
sh@nd	ğ‘¡‡
sh@p	ğ”„¥
sh@ps	ğ”„¦
shE	ğ‘¡’
shEd	çˆ
shElm	ğ–Œ
shEn	ğ‘¡“
shRd	ğ”„©
shRn	ğ’¥ 
shUd	ğ‘œ”
shUdz	ğ‘œ•
shUnd	ğ™´
shUnts	ğ™µ
shW	ğ“€…
shWnd	ğ’€´
shWr	ğ•Šƒ
shWs	ç¥˜
shY	è€€
shYm	ğ’¥€
sh^	æ’™
sh^z	ğ‘˜•
sha	ğ’•‰
shar	ğ‘€˜
shart	éŒ§
shcf	é‚€
shck	ğ’”€
shcl	ğ–š‰
shcr	è²
shcrn	ğ’“
shcrs	ğ”¥¹
she	ğ“‘’
shel	ğ‘˜¶
sheld	ğ‘˜·
shir	ğ”„¨
sho	ğ’µ
shol	èŒ¤
shold	ğ“–
sholdz	ğ“—
sholz	è
si	ã„
siC	è¦ƒ
siCt	è¦„
sib	ğ••¦
sid	æ’
sidd	ğ•˜‚
sidz	æ“
sif	ğ•
sig	è¦‡
sigd	è¦…
sik	å‰„
siks	ğ••¢
sil	ä€„
sild	ğ‰±
sildz	ğ¢”
silk	ğ•™
silz	æ
sim	æ”
simd	æ•
simz	æ–
sin	ä„•
sind	ğ“¢˜
sinz	æ¥
sip	ğ••˜
sips	ğ••¥
sipt	ğ••¤
sir	éˆ
sirz	è¦†
sis	è˜
sist	é¡†
sit	ã¦‚
sits	æˆ°
siv	æˆ±
sivd	æˆ²
sivz	æˆ³
sixm	ã¥
siz	ã€‡
sizd	ğ••§
sk	ğ•”‰
sk@	æ¤
sk@G	æ”¤
sk@b	ğ•Œ‘
sk@bz	ğ•Œ’
sk@d	ğ•Œ“
sk@dz	ğ•Œ”
sk@f	ğ•Œ•
sk@gz	ğ•Œ—
sk@l	ç 
sk@lf	ğ•Œ¢
sk@lp	ğ•Œ£
sk@lps	ğ•Œ¥
sk@lpt	ğ•Œ¤
sk@m	æ™
sk@md	ğ•Œ¦
sk@mp	ğ’ˆ¹
sk@mz	ğ•Œ§
sk@n	ç™€
sk@nd	ğ•Œ¨
sk@ns	è²
sk@nt	ğ•Œ°
sk@nz	ğ•Œ©
sk@p	èˆ
sk@r	ğ•Œ´
sk@st	ğ”„—
sk@t	ğ”‰¨
skE	æ…”
skEC	ğ•š‰
skECt	ğ•š
skEl	æ”¨
skEn	ğ•š‡
skEnt	ğ–‰
skEp	ğ•Œ¹
skEr	ğ•Œ³
skErs	ğ•Œ²
skErz	ğ•Œµ
skEt	è¸
skEts	ğ‘€ 
skEz	ğ–š‚
skI	æ”³
skIG	ã¹
skIb	ğ•š‘
skId	ğ•š’
skIdz	ğ•š“
skIf	ğ•š–
skIfs	ğ•š—
skIl	æ”°
skIld	ğ•š™
skIlz	æ”±
skIm	ğ•œ€
skImd	ğ•œ
skImk	ğ•¥
skImp	ğ•œ‚
skIn	æ”²
skInd	ğ’¥—
skInk	ğ•§
skInks	ğ•œƒ
skInz	è³
skIp	æ”´
skIps	æ”¶
skIpt	æ”µ
skIt	ã•·
skIts	ã•¶
skO	ğ•‰’
skOz	ğ•‰“
skR	å¤
skRd	ğ–¡¸
skRg	ğ•”
skRgd	ğ•”‘
skRk	é™©
skRn	ğ‘–”
skRt	æ”·
skRts	æ”¸
skRz	å¤‘
skU	ğ•œ“
skW	ğ‘€
skWl	ğ•”“
skWld	ğ•””
skWn	ğ‘€€
skWnt	ğ¦™
skWnts	ğ‘€ƒ
skWr	ğ”¢
skWs	ğ•‰
skWt	é‡
skWts	ğ•”’
skWz	ğ”ˆ–
skY	æ•
skYk	ğ–™¦
skYl	ğ” ³
skYlz	ğ•š˜
skYn	ğ‘•“
skYp	ğ•œ”
skYr	ğ•š•
skYz	æ”©
sk^	ä”—
sk^Gk	æ•€
sk^d	ğ••‘
sk^dz	ğ••’
sk^f	ğ••“
sk^ft	ğ••”
sk^g	ğ“˜
sk^k	ğ’¨
sk^l	æ”¹
sk^lk	ğ•œ‰
sk^lks	ğ•œ
sk^lp	ğ••–
sk^lpt	ğ•••
sk^lpts	ğ••—
sk^ls	ğ•œ‘
sk^lz	ğ•€–
sk^m	è°
sk^n	ç¡³
sk^nks	ğ•œ’
sk^nz	ç¡´
sk^p	é‚ƒ
sk^s	èŠˆ
sk^st	ä” 
sk^t	è·
sk^ts	é ƒ
sk^z	ç¡²
ska	æ·
skaC	åŒ€
skaCt	ğ“€³
skag	è‰‚
skak	ğ’²
skaks	ğ’¥¡
skal	ğ“¡‚
skam	ç•£
skan	ç’’
skand	ç’‘
skandz	ç’”
skans	ğ‘’‡
skanst	ğ‘’ˆ
skanz	ğ”§
skap	ğ•œ…
skar	éµ
skard	ğ¦”
skardz	ğ¦•
skarf	æ¢
skarfs	ğ•Œ¶
skarp	ğ‘•¡
skart	ğ””‚
skarvz	ğ•Œ·
skarz	æ´
skat	æ¶
skats	ğ“¥£
skav	ğ•œ‡
skc	é¹
skcf	ğ’™ƒ
skcfs	ğ•‘¹
skcft	ğ•’–
skcl	é…¦
skcld	ğ•Œ™
skcldz	ğ•Œ 
skcm	ğ–˜³
skcp	ğ•œ†
skcpf	ğ’™‚
skcpfs	ğ•‘¸
skcr	æµ
skcrC	ğ•”„
skcrCt	ğ•”…
skcrd	ğ¦˜
skcrn	ğ•”†
skcrnd	ğ•”‡
skcrnz	ğ•”ˆ
skcrs	ğ‘€…
skcrt	ğ‘•¢
skcrts	ğ‘•£
skcrz	ğ”‘¶
skcs	ğ”‘ 
ske	æ£
sked	é†
skedd	ğ–˜²
skedz	é•
skef	ğ•Œ˜
skeg	è
skegz	è‘
skel	æ˜
skeld	ğ•Œ¡
skelz	ğ„¥
sken	é¶
skenz	ğ•š‚
skep	ğ‘•™
skeps	ğ‘• 
skept	äœ¦
sker	æ 
skerd	æ¡
sket	æ”¥
skets	æ”§
skez	ğ“¢
ski	å°
skid	ğ•š”
skil	ğ•šƒ
skilz	ğ•š„
skim	ğ•’
skimd	ğ•“
skimz	ğ•”
skin	ğ”„°
skinz	ğ•š…
skis	ğ–§
skit	ğ”˜
skits	ğ•š†
skiz	é‰”
sko	ã ¹
skod	ğ’‚™
skol	è´
skold	ğ•’—
skoldz	ğ•’˜
skolz	ğ•“
skom	ğ“¢
skon	ğ•’™
skonz	ğ•”€
skop	è…©
skops	ğ’œˆ
skord	æ³
skot	åŒ•
skoz	ã¡€
skr@	æ…
skr@C	æƒ
skr@Ct	æ„
skr@ft	è”
skr@fts	ğ•¡©
skr@g	ğ•”•
skr@m	æ¹
skr@mz	ğ•”–
skr@n	ğ•”—
skr@p	ğ•”˜
skr@ps	ğ•”¡
skr@pt	ğ•” 
skr@t	ğ”‰³
skr@ts	å ‡
skrE	ğ‘€†
skrI	æ”
skrIC	ğ•”´
skrIb	ğ•”°
skrIg	ğ‘•¦
skrIm	ğ•”±
skrImp	ğ•”²
skrInz	æ¡·
skrIp	æ„™
skrIps	ğ•”³
skrIpt	ğŒ‰
skrIpts	ğŒ
skrIt	ğ•Š“
skrIv	ğ•”µ
skrO	ğ•–ˆ
skrWn	ğ••†
skrWng	ğ••„
skrWngd	ğ••…
skrY	ğ¢‘
skrYb	è‘
skrYbd	è’
skrYbz	è“
skr^	æ—
skr^b	æ•
skr^bd	æ–
skr^gz	ğ••‡
skr^m	æ˜
skr^nC	ğ••ˆ
skr^nCt	ğ••‰
skra	ğ•”·
skrad	ğ•”¶
skrag	ğ•”¹
skragz	ğ•”¸
skrak	ğ•œˆ
skrans	ğ••‚
skrc	ğ”±
skrcft	è–
skrcl	ğ•”¢
skrcld	ğ•”£
skrcs	äˆ
skrcst	ğ”°
skre	æ‚
skrep	æ€
skreps	ğ•”™
skrept	æ
skri	æ‡
skriC	æ‰
skriCt	ğ•”¥
skrid	ğ•”¦
skrig	é…³
skrik	è•
skrim	æ†
skrimd	ğ•”¤
skrimz	æˆ
skrin	æ‘
skrind	ğ•”§
skrinz	ğ•”¨
skrit	ğ‘€‡
skro	ğ‘•¤
skrod	ğ‘•¥
skrol	ğ••€
skrolz	ğ••
skru	æ’
skrud	æ“
skrug	ğ••ƒ
skrup	ğ••
skruz	ğ•”©
sku	ã¸
skug	ğ•œ„
skul	æ„–
skuld	ğ••
skulz	æ©
skun	ğ•–
skup	æ±
skups	ğ•”‚
skupt	ğ•”
skut	æ²
skuts	ğ•”ƒ
skw	æ 
skwE	ğ”ˆ™
skwEl	ğ–€‘
skwElC	ğ–€‰
skwElCt	ğ–€
skwEr	æ…
skwErd	ğ–€ƒ
skwEs	ğ–š
skwEz	è‚
skwI	æ¥
skwIS	æ£
skwISt	æ¤
skwIb	ğ–€’
skwIbz	ğ–€“
skwId	æ–
skwIn	æ—
skwInt	ğ–€”
skwIt	è‰
skwR	æ™
skwRm	æ˜
skwRmz	ğ–€•
skwRt	æ¢
skwRts	ğ–€–
skwY	ğ‘—
skwYr	ğ‘–„
skwYrz	ğ‘–…
skw^	ğ‘š
skw^s	ğ”¡¦
skwa	ğ¡¤
skwaS	æ†
skwaSt	æ‡
skwad	ğ•¦™
skwadz	ğ–€€
skwan	è‚ƒ
skwat	ğ–€„
skwats	ğ–€…
skwc	æˆ
skwck	ğ–€†
skwcks	ğ–€‡
skwcl	ğ–€
skwclz	ğ–€‚
skwe	ğ‘–ƒ
skwer	æƒ
skwerz	æ„
skwi	æ
skwik	æ€±
skwiks	æ‘
skwikt	æ‰
skwil	æ’
skwild	æ“
skwilz	ğ–€ˆ
skwiz	æ”
skwizd	æ•
skwo	ğ”§
skwot	èœ”
skwots	ğ”…ƒ
skx	æ¹
sl@	æ•„
sl@S	æ•‡
sl@b	ğ•œ•
sl@bz	ğ•œ–
sl@d	ğ•œ™
sl@g	ğ•°
sl@k	ğ•©
sl@ks	ğ•œ˜
sl@kt	ğ•œ—
sl@m	æ•‚
sl@md	æ•ƒ
sl@mz	æ•…
sl@n	ğ“„´
sl@nd	é™¢
sl@ndz	ğ‘…
sl@nt	ğ•œ¡
sl@p	è–™
sl@ps	ğ•œ£
sl@pt	æ•†
sl@s	è˜€
sl@st	ğ•œ¤
sl@t	ğ¢˜
sl@ts	ğ•œ¥
sl@vz	ğ—€·
slE	ğ‘•—
slEC	ğ•œ¨
slEd	é‰„
slEdz	ğ•œ°
slEg	ğ•œ©
slEk	ğ‘Œ£
slEkt	ğ•´
slEmp	ğ•œ³
slEn	ğ‘˜¢
slEnts	ğ•œ´
slEp	ğ•¶
slEpt	æ••
slEt	ğ’•±
slI	æ•©
slIG	æ•¦
slIGk	æ•¥
slId	æ•™
slIf	ğ•œ¹
slIft	ğ‘š•
slIk	æ•˜
slIks	ğ•œ¸
slIkt	ğ•·
slIm	ğ•€
slImd	ğ•
slImp	ğ•‚
slImz	ğ•ƒ
slIn	ç¡‡
slInk	ğ•¸
slInz	ğ“Œ
slIp	æ•§
slIps	æ•°
slIpt	æ•¨
slIs	ç…‘
slIt	ğƒ
slIts	é¡
slIv	ğ•„
slO	ğ‘€¥
slR	æ–‚
slRd	ğ•¥
slRp	ğ•¤
slRz	ğ€´
slU	ğ•
slW	æ•¶
slWC	æ•µ
slWk	ğ•³
slY	æ•¢
slYd	æ• 
slYdz	æ•¡
slYf	ğ“¢‚
slYk	é™£
slYks	ğ‘€¢
slYkt	ğ‘€¡
slYm	æ•¤
slYn	è¡
slYnz	è³
slYp	ğ•œ²
slYs	æ•—
slYst	ğ•œ·
slYt	æ•£
slYts	ğ‘¢†
slYz	ğ•µ
sl^	ç¤¡
sl^d	ğ’•°
sl^f	ğ••
sl^fs	ğ•–
sl^g	æ–€
sl^gd	ğ•˜
sl^gz	ğ•™
sl^k	é¥™
sl^m	æ–
sl^mp	ğ• 
sl^mps	ğ•¢
sl^mpt	ğ•¡
sl^mz	ğ•£
sl^n	è·
sl^nd	è™
sl^ndz	è 
sl^nz	ğ“Šˆ
sl^p	ğ’¤“
sl^s	è…€
sl^t	ğ“™¢
sl^ts	ğ•¦
sl^v	é‰£
sla	æ•²
slaS	æ•³
slab	æ•±
slabz	ğ•ˆ
slaf	ğ–
slag	ğ‘€£
slagd	ğ‘€¤
slak	è¢
slam	ğ“ˆ±
slamz	ğ“ˆ²
slan	è•‘
slap	ğ•
slar	ğ” ²
slarb	ğ•²
slas	ğ•¹
slat	æ•´
slats	ğ•”
slatsh	ğ•€
slav	é‚
slavz	ğ•œ§
slc	è¦‚
slcf	ğ“•
slcrk	ğ•“
slcs	è¦
slct	ğ”³
slcv	ğ“–„
sle	èŒ¥
sled	ğ”„³
slek	ğ•±
slen	ğ•œ 
slep	ğ•œ¢
slet	ğ“œ³
slets	ğ“œ´
slev	æ•ˆ
slevd	ğ‘’“
slevz	ğ•œ¦
slez	ğ•˜—
sli	ä…£
slid	ğ”„´
slidz	ğ”„µ
slik	æ•‰
slip	ã‘
slips	æ•
slis	é™°
slit	æ•‘
slits	æ•’
sliv	æ•“
slivd	ğ•œ±
slivz	æ•”
sliz	ãƒ
slo	æ•·
slod	é™±
slodz	é™²
slon	ğ•…
slonz	ğ•†
slop	ğ•‘
slops	ğ•’
slot	ğ•‡
slovz	ğ•—
sloz	æ•¹
slu	æ•–
slup	ğ•‰
slus	è…
slut	ğ•œµ
sluts	ğ•œ¶
slx	ä™
sm	ğ•—
sm@	æ–„
sm@C	ğ”„¶
sm@Ct	ğ”„·
sm@k	æ–ƒ
sm@ks	ğ”£
sm@kt	ğ•§
sm@l	ğ•ƒ
sm@lts	ğ•¨
sm@n	ä”§
sm@nt	ğ‘€¦
sm@nz	é™¤
sm@r	ğ•©
sm@s	ğ”„±
sm@st	ğ•°
sm@t	ğ”™¥
smE	æ–‘
smEd	ğ•³
smEg	ğ•´
smEk	ğ•‡
smEl	æ–‰
smEld	æ–
smElt	ğ•‰
smElts	ğ•ˆ
smElz	æ–’
smEm	ğ‘€©
smEn	é™•
smEnt	ç™¨
smEnts	è„´
smEnz	ğ•–
smEt	ğ•µ
smI	ç¶
smIT	æ–—
smId	ğ’‘°
smIdt	ğ•¶
smIk	ğ•‘
smIl	ğ•·
smIn	ğŒ
smInk	ğ•¸
smIr	ğˆ
smIrd	ğ•±
smIrz	ğ•²
smIs	è’
smIst	ğ‘€°
smIt	çœ‰
smIts	çœ
smO	ğ•—
smR	ğ€ 
smRf	ğ• €
smRfs	ğ• 
smRk	ğ•¹
smRks	ğ•€
smRts	ğ•
smU	ğ••
smUs	ğ•“
smUst	ğ•”
smUt	ğ–“
smWs	ğ•–
smWz	ğ•†
smY	æ––
smYd	ğ•’
smYl	æ–“
smYld	æ–”
smYlz	æ–•
smYr	ğ‘”
smYt	ğ• ‚
sm^	æ˜†
sm^C	æ˜ƒ
sm^S	æ˜„
sm^St	æ˜…
sm^dz	ğ¢™
sm^g	ğ•˜
sm^gd	ğ•™
sm^k	ğ“…©
sm^l	ğ•˜
sm^lts	ğ•™
sm^n	è…–
sm^nd	ğ”‘¡
sm^nk	ğ•€
sm^nt	ç•„
sm^nts	ç•…
sm^nz	éŠ€
sm^s	ğ€¥
sm^t	ğ “
sm^ts	ğ•
sm^tz	ğ•‚
sma	ğ˜°
smag	ğ•‚
smak	ğ•
smal	ğ•‚
smalts	ğ•„
sman	ğ‘¡‰
smar	æ–ˆ
smark	ğ‘•§
smart	æ–‡
smarts	ğ”‘¹
smat	ğ“•‘
smc	æ–†
smcl	æ–…
smclz	ğ•…
smcr	æŒ´
sme	ä”¨
smed	ğ‘€§
smel	ğ“ˆ°
smet	ğ‚‡
smets	ğ‚ˆ
smez	ğ‘€¨
smi	ğ’ €
smid	è£
smig	ğ•“
smil	ğ“ˆ©
smir	ğ“‘
smit	ğ”„ˆ
smo	æ–™
smok	æ–˜
smoks	ğ•„
smokt	ğ•ƒ
smol	ğ•…
smolt	ğ•”
smon	ğ’’
smor	æ˜‚
smot	ğ•–
smu	æ˜
smuC	ğ•‡
smuD	æ˜€
smud	ğ•
smudd	ğ•‰
smudz	ğ•‘
smun	ğ•ˆ™
smut	ğ•ˆ
smuts	ğ•’
smuz	ğ••
smxs	ä„†
sn@	æ˜‰
sn@C	æ˜˜
sn@Ct	æ˜™
sn@g	ğ• „
sn@gd	ğ• …
sn@gz	ğ• †
sn@k	æ˜‡
sn@ks	æ˜ˆ
sn@kt	ğ• ƒ
sn@p	æ˜•
sn@ps	æ˜—
sn@pt	æ˜–
sn@r	ğ•„
sn@z	ğ•¤“
snE	ğ£
snEf	ğ“£
snEk	ğ•…
snEl	ğ”˜…
snEp	ğ•‰
snEpf	ğ•ˆ
snEr	ğ‘’”
snErd	ğ‘’•
snErz	ğ‘’–
snEt	ğ•Š™
snEts	ğ•Œ€
snI	å¥•
snIC	ğ• ¡
snIf	æ˜¥
snIfs	ğ• —
snIft	ğ• –
snIk	é‘™
snIks	æ˜¡
snIn	ğ˜¨
snInz	ğ‘œ¸
snIp	æ˜¦
snIps	å¥–
snIpt	æ˜§
snIr	ğ•†
snIrd	ğ• ”
snIrz	ğ• •
snIs	ğ…‚
snIt	è€
snIts	ğ•
snO	ğ¤€
snR	è¸
snRd	ğ””†
snRz	è¦‰
snU	ğ• §
snUk	ğ•‘
snUks	ğ•’
snUr	ğ’‘–
snW	ğ“¦
snWt	ğ• ±
snWts	ğ• ²
snY	è¥”
snYd	ğ•‡
snYn	ğ• 
snYp	ğ• ˜
snYps	ğ•  
snYpt	ğ• ™
snYv	ğ• ¢
sn^	æ˜¹
sn^b	ğ• ³
sn^bd	ğ• ´
sn^bz	ğ• µ
sn^f	æ˜¸
sn^fs	ğ• ·
sn^ft	ğ• ¶
sn^g	æ™€
sn^gz	ğ• ¸
sn^k	æ˜·
sn^kt	ğ‘œ·
sn^l	é™–
sn^lz	ğ”Š‘
sn^n	é‘˜
sn^nt	ğ–¢€
sn^s	è ¸
sn^t	é¥ 
sn^ts	é¥¡
sn^z	é¡°
sna	æ˜´
snab	ğ• £
snabz	ğ• ¤
snad	ğ• ¥
snar	ğ• ˆ
snarl	ğ‘’—
snarld	ğ‘’˜
snarlz	ğ• ‰
snast	ğ’©
snat	æ˜³
snc	ğœ¥
sncf	ğ“•¦
sncfs	ğ•¡¤
sncl	ğ•ƒ
sncr	æ˜²
sncrd	ğ•…ƒ
sncrt	æ˜±
sncrts	ğ• ©
snct	ğ• °
sne	æ˜”
snek	æ˜’
sneks	æ˜“
snel	æ˜
snelz	æ˜‘
snep	ğ• ‡
snev	ğ• 
sni	æ˜¢
snid	ğ• ‘
snik	æ˜ 
sniks	ğ• “
snikt	ğ• ’
sniz	æ˜£
snizd	æ˜¤
sno	æ˜°
snod	æ˜¶
snok	ğ• ¦
snost	ğ’±
snoz	æ˜µ
snu	ğ“¤
snup	ğ• ¨
snups	æ˜¨
snuz	æ˜©
so	ãŒ„
sob	ğ•˜™
sod	æµ
sodz	ğ‘”¤
sof	ğ•˜˜
sok	æ™ƒ
soks	ğ• ¹
sokt	æ™„
sol	æ™”
sold	æ™“
soldz	ğ–”
solf	ğ“¦…
solt	ğ•¡‘
solts	ğ•”
solz	ğŒ–
som	ğ€‚
somz	ğ€±
son	æ¶
sond	ğ‘€³
sonz	ğ•¡…
sop	æ™…
sops	ğ•¡€
sor	æ™§
sors	æ™µ
sos	ğ‘…ˆ
sot	ğ”‚
sov	ğ•¡
soz	æ·
sp	ğ•¤”
sp@	ä¡¥
sp@C	ğ‘€µ
sp@Ct	ğ‘€¶
sp@Gk	æš
sp@N	æš‚
sp@d	ğ”ˆ´
sp@g	ğ•¡µ
sp@k	ğ•™·
sp@l	ğ‘•©
sp@m	ğ•¢‚
sp@n	æš€
sp@nb	ğ•¢„
sp@nd	ğ‘™“
sp@ndz	ğ‘™”
sp@ns	ğ‘™•
sp@nz	éšƒ
sp@r	ğ•¢ˆ
sp@s	ğ–”–
sp@t	ğ•¢“
sp@ts	ğ•¢–
sp@z	ğ•¢’
spE	äœ§
spEd	ğ•¤…
spEk	ä”
spEks	æšˆ
spEkt	ã‘…
spEkts	ä–
spEl	æš’
spEld	ğ‘€·
spElts	ğ•¤‡
spElz	æš“
spEn	æš•
spEnd	æš”
spEndz	æš–
spEns	æ” 
spEnst	ğ‘€¸
spEnt	æš—
spEnz	ğ•¤‰
spEp	ğ‘Œ¤
spEr	ğ¤‚
spErd	ğ¤ƒ
spErz	ğ¤„
spEt	ğ•¤’
spI	ã‘ˆ
spIk	ğœ°
spIl	æœ
spIld	æœ‚
spIlt	ğ•¤¡
spIlz	æœƒ
spIn	æœ„
spInd	ğ•¤¢
spInk	ğ•¤£
spInks	ğ•¤¤
spInz	æœ‡
spIr	ğ•¤
spIrz	ğ•¤‚
spIs	è’‘
spIt	æœˆ
spIts	æœ‰
spO	ğ•¤¸
spOl	æœ™
spOld	æœ 
spOlz	ğ•¤¹
spOnt	ğ‘¢‡
spOnts	ğ‘¢ˆ
spR	è€
spRd	ç‰¢
spRg	ğ•¦•
spRl	ğ•¤
spRm	ğ‘‘¡
spRmz	ğ•¤‘
spRn	ğ•¦–
spRnd	ğ•¦—
spRnz	ğ•¦˜
spRs	ğ‘€¹
spRst	ğ‘€
spRt	ğ‘™—
spRts	ğ‘™˜
spRz	é …
spUr	ğ•¥ˆ
spUrz	ğ•¥‰
spW	ğ‘•¸
spWn	ğ‘™´
spWnd	ğ‘™³
spWndz	ğ‘™µ
spWs	ğ‘•µ
spWst	ğ‘•·
spWt	æœ²
spWts	ğ•¥“
spWz	ğ‘•´
spWzd	ğ‘•¶
spY	æš™
spYd	ğ•¤—
spYg	ğ•¤†
spYk	æœ€
spYks	ğ•¤ 
spYkt	ğ•¤™
spYn	ğ•¡¹
spYnz	æœ†
spYr	å¶
spYrd	è…
spYrz	ğ“†–
spYs	æš˜
spYst	ğ•¤–
spYt	ğ¤ˆ
spYz	ğ•¤˜
spYzd	ğ¤‡
sp^	è¡
sp^G	æ‚
sp^d	æ
sp^dz	é€ 
sp^k	ç¦„
sp^l	ğ”¨
sp^lz	ğ’”‚
sp^n	æœ£
sp^nJ	æœ¢
sp^ng	ğ‘™¹
sp^ngd	ğ‘š€
sp^nk	ğ•¦”
sp^nz	è‚
sp^s	ğ“„
sp^t	ğ¤‰
spa	æœ±
spag	ğ•¡¶
spagn	ğ•¡·
spak	è…†
spal	ğ“‰¢
spam	ğ•¢ƒ
span	äŠˆ
spand	æ‰ 
spandz	ğ‘
spanz	ğ•¢˜
spar	æš…
spard	ğ’‰€
spark	ğ•¢…
sparks	ğ•¢‡
sparkt	ğ•¢†
spars	ğ•¢‰
sparts	ğ•¢
sparz	ğ‘µ
spat	ä¦ˆ
spats	æœ°
spaz	ğ•¢‘
spc	ç¦…
spcl	ğ•¢
spcn	ğ…
spcnd	ğ•¢—
spcnz	ğ•¢™
spcr	ğ‘™°
spcrk	ğ•¥
spcrl	ğ•¤·
spcrn	ğ•¥’
spcrt	ğ‘‚
spcrts	ğ‘™±
spcrz	ğ•¥‘
spe	çœ“
sped	ğ•¡²
spedz	ğ•¡³
spek	ğ•¢€
spen	ğ¤
spenz	ğ•¡¸
sper	æš„
spes	æ™¹
spest	ğ•¡°
spet	ğ•¢”
spets	ğ•¢•
spi	ä‡
spiC	ğ“†•
spid	æš
spidz	æš‘
spik	æš†
spiks	æš‡
spil	ğ‘¢
spir	ğ•–’
spirz	ğ•–“
spis	ğ•¡
spit	ğ•¡´
spiz	ğ‘–
spl@	æœ‘
spl@S	æœ
spl@St	æœ’
spl@k	æœ˜
spl@n	ğ’”ƒ
spl@nt	ğ–’–
spl@nts	ğ–’—
spl@t	æœ“
splE	ğ‘ˆ
splEn	æœ”
splI	æœ•
splIS	æœ–
splIn	ğ‘•³
splInt	ğ•¤±
splInts	ğ•¤²
splIt	æœ—
splIts	ğ•¤³
splO	ğ‘™¤
splOt	ğ‘™£
splOts	ğ‘™¥
splR	ğ‘™¦
splRg	ğ•¤´
splRgd	ğ•¤µ
splY	ğ•¤°
splYs	ğ•¤¨
splYst	ğ•¤©
spl^	ğ‘•±
spl^nd	èˆ
splc	ğ‘™§
splcn	ğ•¤¦
splcrd	ğ‘™¨
splcrz	ğ‘™©
sple	ğ‘ƒ
spled	ğ‘„
splen	ä™
splend	ğ‘™™
splenz	ğ‘™ 
sples	ğ‘
splest	ğ‘‚
splez	ğ‘…
spli	ğ”©
splin	ğ•¤§
spliz	ğ‘†
splizd	ğ‘‡
splo	ä¡
splod	ğ‘™¡
splodz	ğ‘™¢
spo	ğ†”
spok	æœ¡
spoks	ğ•¥€
spol	ğ•¤¶
sport	æœ¨
sports	æœ©
spost	é˜³
sposts	é˜´
spoz	ğ‘™²
spozd	ä¤
spr	ğ•¦‘
spr@	ğ•¥”
spr@d	ğ•¥•
spr@g	ğ•¥–
spr@n	ğ•¥¢
spr@t	æœ³
sprE	ä¦
sprEd	ã˜˜
sprEdz	æœµ
sprEn	ğ•¥²
sprEs	ğ‘™¶
sprEst	ğ‘™·
sprI	ğ”…‚
sprIG	æœ¶
sprIGz	æœ·
sprIg	ğ•¥´
sprIgd	ğ•¥µ
sprIgz	ğ•¥¶
sprIk	ğ•¥³
sprIn	è†
sprIng	ğ•¥·
sprInt	æœ¹
sprInts	ğ”…
sprInz	ğ””¡
sprIs	ğ•„‰
sprIt	ğ¤…
sprW	ğ•¦‰
sprWl	ğ•¦„
sprWlz	ğ•¦†
sprWs	ğ•¦‡
sprWt	ğ•¦ˆ
sprWts	ğ•¦
sprY	ğ”…€
sprYs	ğ”„¸
sprYst	ğ”„¹
sprYt	ğ•¥±
spr^	ğ‘‘
spr^n	ğ•¦“
spr^nz	è‡
spr^t	ğ¤†
spra	ğ•¦€
sprak	ğ•¥¹
sprat	ğ•¦ƒ
sprc	ğ•¥¥
sprcl	ğ•¥£
sprcld	ğ•¥¤
sprclz	ğ•¥¦
sprcn	ğ•¦‚
spre	æœ´
spred	ğ•¥§
spreg	ğ•¥—
spregz	ğ•¥˜
spren	ğ•¥™
sprend	ğ•¥ 
sprenz	ğ•¥¡
sprez	ğ•¥¨
spri	ğ‘•¹
sprih	ğ•¥°
sprin	ğ•¥©
spriz	ğ‘–€
spro	ğ‘™¸
sprolz	ğ•¦
sprot	ğ•¥¸
spru	ğ‘”
sprul	ğ•¦…
sprus	æ€
sprust	ğ•¦’
spruv	ğ‘’
spruvd	ğ‘“
spruvz	ğ‘•
spu	ğ•¥ƒ
spuf	ğ•¥
spufs	ğ•¥„
spuft	ğ•¥‚
spuk	ğ•¥…
spuks	ğ•¥‡
spukt	ğ•¥†
spul	æœ¤
spulz	æœ¥
spun	æœ¦
spunz	æœ§
spur	ğ”™£
spx	ã‘†
sr@	ğ•˜²
sr@d	ğ”Œ¨
sr@g	ğ•¡
sr@k	ğ•™
sr@m	ğ•£
sr@nd	ğ–¤˜
sr@nk	ğ•¥
sr@ns	ğ•§
sr@nt	ğ•¤
sr@nts	ğ•¦
sr@p	ğ•˜³
sr@t	é˜µ
srE	ğ•™
srEd	ğ”……
srEdz	ğ•˜´
srEk	ğ•©
srEl	ğ“ˆµ
srEmp	ğ•²
srEmpf	ğ•³
srEnk	ğ•´
srEp	ğ‘™
srI	ğ‘˜
srIb	ğ•™€
srIft	ğ•™„
srIk	ğ•¸
srIl	ğ•™†
srIm	ğ•‘€
srImpf	ğ•¹
srIn	ğ“ˆ¶
srInk	ğ•™ˆ
srInks	ğ•™‰
srIp	ğ‘ 
srIv	ğ•™
srO	ğ‘¡”
srR	ğ•µ
srRz	ğ•¶
srU	ğ”‰°
srUmd	ğ”‰©
srW	ğ‘’’
srWd	ğ‘’‘
srWdz	ğ•™’
srWf	ğ•¨
srWt	ğ•™“
srY	ğ•°
srYb	ğ•±
srYn	ğ‘’‰
srYnd	ğ‘’
srYnz	ğ•™‡
srYr	ğ•·
srYt	ğ“ 
sr^	ğ”„²
sr^b	ğ•™”
sr^bz	ğ•™•
sr^d	ğ“Š
sr^g	ğ•™–
sr^gd	ğ•™—
sr^gz	ğ•™˜
sr^m	ğ•‘
sr^mpf	ğ•‘‘
sr^n	ğ•™ 
sr^nk	ğ•™™
sr^p	ğ‘¢
sr^pt	ğ‘¡
sr^pts	ğ‘£
sr^s	ğ”‰±
sra	è¤
srak	ğ•‘‚
sram	ğ•‘‡
srans	ğ•‘ˆ
srants	ğ•™‘
srap	ğ•‘‰
srat	ğ•……
srcf	ğ•‘…
srct	ğ‘¨
sre	ğ °
sred	ğ• 
sreg	ğ•¢
srek	ğ•˜±
srez	ğ ©
sri	è§
srid	ğ”…„
srik	ğ•™
sriks	ğ•™ƒ
srikt	ğ•™‚
sriv	ğ•˜µ
srivz	ğ•˜¶
sro	ğ•‘
srod	ğ•¢
srodz	ğ•£
srof	ğ–€˜
srog	ğ–€—
srok	ğ•‘ƒ
srol	ğ•‘†
srop	ğ•‘„
srot	ğ•…„
sru	ğ•˜¸
srud	ğ•˜·
srul	ğ”…‰
srum	ä„©
srumz	ğ‚‰
srut	ğ’•
sruts	ğ’•‘
sruz	ğ•˜¹
srx	ä„§
st	æ¡”
st@	å 
st@C	ğ–€¥
st@S	å ‰
st@b	ğ–€¢
st@bd	ğ–€£
st@bz	ğ–€¤
st@d	è…
st@dt	ğ–€§
st@f	é€™
st@fs	ğ‘œ–
st@ft	ğ”’‘
st@g	é˜¶
st@gz	ğ–€©
st@k	åˆ
st@ks	åˆ‚
st@kt	æ§
st@l	ğ”¶
st@m	ğ’œ¸
st@mp	æ³
st@mps	ğ–€¶
st@mpt	ğ–€µ
st@n	ä„—
st@nC	ğ–€·
st@nCt	ğ–€¸
st@nd	æµ
st@ndz	æ¸
st@ng	ğ–€
st@nk	ğ–€°
st@np	ğ–‚
st@ns	æ´
st@nt	ğ–ƒ
st@nz	çœ·
st@p	ğ–…
st@pf	ğ–„
st@r	ğ–€±
st@s	ğ”ˆ·
st@st	ğ”‰´
st@t	çœ•
st@ts	çœ–
stE	æ‘
stEb	ğ–³
stEd	å¸
stEdz	ğ“€‰
stEf	ğ–‚
stEfs	ğ–‚‚
stEg	ğ–‚ƒ
stEk	è‰¹
stEks	è¥
stEl	è•“
stElt	ğ–±
stElts	ğ–‚ˆ
stElz	ğ“ˆ¸
stEm	æ €
stEmd	ğ–‚‰
stEmz	ğ–‚
stEn	ç”‰
stEnC	ğ–‚‘
stEnd	ğ‘±
stEndz	ğ‘š‚
stEnt	ä¨
stEnts	ğ–‚“
stEnz	ğ’ˆ¶
stEp	æ 
stEps	æ ƒ
stEpt	æ ‚
stEr	ç¡µ
stErd	ğ–ˆ
stErz	è˜‚
stEst	ã™§
stEt	è…‡
stEts	ğ–‚—
stEv	ğ–’
stI	ã„¢
stIC	è˜ƒ
stICt	ğ–„—
stIG	ã¤ 
stIGg	ä”´
stIGk	ä”³
stIGks	æ 
stIGkt	ä”²
stId	ã¤™
stIf	ğ–„„
stIfs	ğ–„†
stIft	ğ–„…
stIg	è–
stIk	ä€µ
stIks	ã†…
stIkt	ğ–„‚
stIl	æ ˆ
stIld	ğ‘²
stIlt	ğ–„‡
stIlts	ğ–„ˆ
stIlz	ğ‘³
stIm	ğ–„‰
stImp	ğ–„
stIn	ã¸
stInC	ğ–„‘
stInd	ğ¤’
stIng	ğ‘¶
stInk	ğ‘µ
stInkt	ğ‘´
stInkts	ğ“†˜
stInt	ä‰‰
stInts	ğ–„’
stInz	è’“
stIp	ğ‘–ˆ
stIr	è’”
stIrd	ğ–¸
stIrz	ğ–¹
stIs	è…ˆ
stIt	ğ“’“
stIts	ğ–„™
stIv	ğŠ™
stO	ğ‘…‘
stOz	ğ–‘¢
stR	ã˜
stRbd	ğ‘‚„
stRbz	ğ‘‚…
stRd	æ‰
stRdz	è„
stRk	ğ–‚–
stRm	ğ–ˆ—
stRn	è¦“
stRnz	ğ¤
stRt	ğ’ ƒ
stRts	ğ–ˆ˜
stRz	ä†‡
stU	ğ–ˆ†
stUd	æ ™
stUk	ğ“ˆ¹
stUr	ğ–ˆˆ
stW	ğ”ˆ£
stWn	ç•
stWnd	è—
stWndz	è˜
stWt	æ §
stY	æ¡ 
stYl	æ ‡
stYld	ğ•„•
stYlz	ğ“„
stYm	ğ€¦
stYmz	ğ”•‘
stYn	ç˜·
stYnb	ğ–‚…
stYnh	ğ–‚†
stYnk	ğ–‚‡
stYnz	è¥¨
stYp	ğ–„“
stYps	ğ–„•
stYrz	ğ–„–
stYs	ğ–„
stYt	ğ–‚„
stYts	ğ–„˜
stYz	é¤—
stYzd	é¤˜
st^	æ “
st^C	ğ–€¦
st^G	æ¡™
st^b	ğ–ˆ
st^bd	ğ–ˆ‚
st^bz	ğ–ˆƒ
st^d	ç•†
st^dt	ğ–…‚
st^dz	ğ–ˆ„
st^f	æ¡—
st^fs	ğ‘Œ¡
st^ft	æ¡˜
st^g	ğ”µ
st^k	æ¡“
st^l	è†•
st^lts	ğ–ˆ‰
st^lz	é”‡
st^m	ç• 
st^md	ç•¡
st^mf	ğ–ˆ“
st^mp	ğ–ˆ
st^mpf	ğ–ˆ’
st^mps	ğ–ˆ”
st^mpt	ğ–ˆ‘
st^mz	è‰¶
st^n	ç””
st^nC	ğ“…
st^nd	ğ’¡°
st^nk	ğ–ˆ•
st^ns	ğˆ€
st^nst	ğ‘©
st^nt	è„
st^nts	è…
st^nz	è¦
st^p	ğ–ˆ–
st^s	èŠ”
st^st	ğ‘œ¹
st^t	ğ‘…³
st^ts	è¤
st^v	ğ’”„
st^z	è‚…
sta	æ ‘
stab	ğ–€™
stad	ğ™°
staf	ğ’š™
stag	é †
stagz	ğ–„¢
stak	ã–˜
staks	ğ‘£
stakt	ğ”’’
stal	é ‡
stald	ğ’€†
stalt	ğ–”˜
stalz	ğ•‚ƒ
stam	æ –
stamp	æ ”
stampt	æ •
stan	ç¥ƒ
stang	ğ–„±
stanz	ğ’Œ†
stap	ä•¨
staps	æ ¢
stapt	æ ¡
star	æ¹
starC	æ€
starCt	ğ–‡
stard	ğ–“
stark	è •
starks	ğ–‰
starn	ğ–
starnz	ğ–‘
start	æ‚
starts	æƒ
starv	æ„
starvd	æ…
starvz	æ†
starz	æ
stat	ğ–€ 
stats	ğ–€¡
stav	ğ•ˆ¢
staz	è˜
stc	å„
stcC	ğ–™
stcb	ğ–—
stcbz	ğ–˜
stcd	ğ– 
stcdt	ğ–¡
stcf	é„³
stcfs	é ˆ
stck	ğƒ
stcks	ğ„
stckt	ğ–€´
stcl	æ²
stcld	ğ“†—
stclt	ğ’‘
stclz	ğ’€‡
stcn	ğ–£
stcnC	ğ–¢
stcp	ğ–¤
stcr	æ ¦
stcrd	ğ•„’
stcrk	ğ–…
stcrm	æ ¥
stcrmd	é‚
stcrmz	éƒ
stcrt	ğ‘·
stcrts	ğ‘¸
stcrz	éŠ—
stcs	ğ–¥
ste	æ¦
steJ	æ¨
steb	ğ–€²
sted	æ‰
steg	è˜
stegd	ğ•„
stek	æ’
steks	æ“
stekt	ğ–€³
stel	æ±
stelz	ğ“€¹
sten	æ©
stend	ç”ˆ
stenz	é†“
ster	æ°
stert	ğ”ˆ¢
sterz	ä•·
stes	ğ¥
stest	ğ‘°
stet	æ‡
stets	æˆ
stev	ğ–¦
stevd	ğ–§
stevz	ğ–¨
stez	æ
sti	ã•¸
stib	ğ–´
stid	èŠ€
stidz	èŠ
stif	ğ–„ƒ
stig	ğ–µ
stik	ğ”‰·
stil	æ”
stild	ğ–¶
stilz	æ•
stim	æ–
stimd	æ—
stimz	ğ‘–‡
stin	æŒˆ
stints	ğ•š€
stinz	è¥§
stip	æ˜
stipt	ğ–·
stir	æ™
stirz	ğ–²
stis	ğ“Œ¡
stit	çœ¡
stits	çœ¢
stiv	æ „
stivz	ğ–‚€
stiz	æ”¢
sto	æ —
stod	è¦”
stof	ğ–„¡
stofs	ğ–…ƒ
stok	ğ–„£
stoks	ğ–„¥
stokt	ğ–„¤
stol	æ ’
stold	ğ‘šƒ
stolp	ğ–„§
stolt	ğ–„¦
stolts	ğ–„ 
stolz	ğ‘š„
stom	ğ™“
stomz	ğ™”
ston	è…
stond	ğ–„©
stonz	æ ˜
stop	ğ–„¹
stor	æ £
storz	æ ¤
stov	æ ¨
stovz	ğ–…„
stoz	è‚†
str@	è 
str@d	è£
str@k	ä”¶
str@ks	ğ”¦€
str@kt	ã„¤
str@kts	ä”·
str@m	ğ–…†
str@n	ğ¥ƒ
str@nd	è¡“
str@ndz	ğ–…‡
str@ng	ğ–…ˆ
str@p	æ ±
str@ps	æ ³
str@pt	æ ²
str@s	ğ–…‰
str@t	ğ–…
strE	æ¡‚
strEC	æ¡
strECt	ğ”’
strEGk	æ ¸
strEGkT	æ ·
strEb	ğ–… 
strEf	ğ–…¥
strEk	ğ–…¢
strEl	ğ”¸
strEn	ğ–…©
strEnkts	ğ–…°
strEnts	ğ–…±
strEp	ğ–…²
strEps	ğ–…³
strEs	æ ¹
strEst	æ¡€
strEt	ğ“ ©
strI	è™“
strIC	ğ“¥°
strIG	ã‚
strIGz	æ’
strId	è¡
strIg	ğ‘†
strIk	ğŒ¢
strIks	ğ“¥±
strIkt	ğŒ¡
strIkts	ğ‘‚€
strIl	é 
strIm	ğ”‘¦
strIn	è£
strInd	ğ–…¸
strInz	ğ’”
strIp	æ¡„
strIps	ç¡†
strIpt	ğ”’‚
strIs	å“
strIt	ğ–…¹
strO	ä‘¹
strOd	ğ¤“
strOk	ğ–†ƒ
strOz	ğ¤”
strU	ğ–†–
strUk	ğ–†ˆ
strW	è¥–
strWb	ğ–…‘
strWd	ğ–†‘
strWk	ğ–…’
strWm	ğ–…“
strWs	ğ–…”
strWt	ğ–†’
strY	ğ’‰ƒ
strYb	ğ–…§
strYd	è¢
strYdz	ğ–…¶
strYf	ğ“ ³
strYfs	ğ“ ´
strYk	æ¡ƒ
strYks	ç¡…
strYn	ğ–…·
strYp	æ¡…
strYps	æ¡‡
strYpt	æ¡†
strYr	ğ–…µ
strYt	ğ’¡‘
strYv	ğ–†€
strYvz	ğ–†
str^	æ¡‘
str^b	ğ–†”
str^k	ä’€
str^kt	ä‰
str^kts	ğŒ£
str^l	è‚‰
str^lz	è’˜
str^m	æ¡’
str^mz	è„ 
str^n	è’™
str^nd	ç ‘
str^nk	ğ•™µ
str^nks	ğ–†—
str^nt	ğ•±
str^nts	ğ•²
str^nz	ğ–š˜
str^p	ğ’Œ¸
str^ps	ğ“‘—
str^s	è€™
str^st	ğ‘‚‚
str^sts	ğ‘‚ƒ
str^t	ğ–†˜
str^ts	ğ–†™
str^z	è™
stra	è¤
strak	é™‚
stral	é ’
stram	è¡”
stran	èŠ™
strants	ğ•„‘
stranz	ğ–’
strar	ğ•³
strarz	ğ•´
strat	ğ’€µ
strc	æ ´
strcG	æ¡
strcf	ğ”‘§
strcn	èŒ€
strcnz	èŒ
strcr	ä°
strct	ğ‘¹
strcz	ğ–…•
stre	ä¥·
stred	ğ–…–
stref	ğ–……
strek	ğ–ƒ
strel	è’•
stren	æ °
strenJ	æ ©
strend	æ‰¥
streng	ğ‘–‰
strengd	ğ‘–
strent	ğŒ™
strents	ğŒ 
strenz	ğŒ˜
stret	ä‘¢
strets	é ‰
strez	è§
stri	ä¢
strib	ğ–…¡
strid	ğ–…£
strig	ğ–…¦
strik	ğ–…—
striks	æ µ
strikt	ğ–…˜
strim	ä•¸
strimd	ğ–…™
strimz	ğ‘š†
strip	ğ–…¤
strit	å’
strits	æ ¶
striz	ğ’¥¤
stro	å€
strob	ğ–†‚
strod	è¦•
strok	æ¡ˆ
stroks	ğ“‚
strokt	ğ–†…
strol	æ¡‰
strold	ğ–††
strolz	ğ–†‡
strom	é§
strop	ğ–†
stros	è¥
strov	ğ–†“
stroy	ğ–†„
stroz	é ‘
stru	é “
strub	ğ–†•
strud	ğŒ¤
strudz	ğ‘š‡
strum	ğ•„“
strumz	ğ•„”
strun	ğ–…´
strup	ğ–†‰
strus	ç”•
strut	ğ‘–‘
struv	ğ–ˆ€
struz	ğ”„ 
strx	å¹
strxs	ä’‰
stu	æ …
stub	ğ–ˆ…
stud	ğ–„€
stug	ğ–„²
stuk	ğ–‚˜
stuks	ğ–„³
stul	æ  
stulz	ğ–„´
stum	äŠ’
stumd	ğˆ
stumz	ğ‰
stun	ğ‘•
stund	ğ‘–
stup	ğ–„µ
stups	ğ–„·
stupt	ğ–„¶
stur	ğ”•
stut	è¦
stuts	ğ–„¸
stuv	ğ–ˆ‡
stuz	ğ–‚™
stx	ã³
stxd	æ‚
stxlz	ä³
stxm	ä™£
stxmd	ã…§
stxmz	æ¤”
stxn	å‘™
stxns	å·
stxnt	ä‰ˆ
stxnz	å”
stxz	åŒ‡
su	æ´
sub	ğ•˜¡
sud	æ¡²
sudd	ğ•¡¡
sudz	ğ•¡¢
suh	ğ–ˆ³
suk	ğ‘’‚
sul	ğ•‘’
sulk	ğ•‘“
sulz	ğ•¡¥
sum	ã‘•
sumd	ã‘–
sumz	èˆ
sun	æ™¥
sunz	ğ”†’
sup	æ™²
sups	æ™³
supt	ğ•¡¦
surz	ğ“ˆ·
sus	æ³
sut	ã–‚
suts	ã–ƒ
suz	æ¡³
sw@	é™™
sw@k	é™—
sw@ks	é™ 
sw@kt	é™˜
sw@m	æ¢…
sw@nk	ğ–‰¢
swE	æ¢‰
swEbk	ğ•’€
swEd	ğ•’
swEg	ğ•’…
swEl	æ¤
swEld	ğ–Š„
swElz	ğ“¦•
swEm	ğ•’‰
swEn	ğ”Œ’
swEnd	ğ•’
swEnk	ğ•’‘
swEnt	ğ•’’
swEp	ğ•’“
swEps	ğ•’”
swEpt	æ¤‚
swEr	æ¢ˆ
swErz	ğ“™
swEst	ğ–”
swEt	æ¢
swEts	ğ–Š‚
swI	æ¤„
swIC	æ¤‰
swICt	æ¤
swIG	æ¤†
swIGz	æ¤‡
swIS	æ¤ˆ
swIf	ğ–Š
swIft	ğ–Šˆ
swIfts	ğ–Š‰
swIg	é•µ
swIgz	é•¶
swIk	è¦—
swIl	ğ‘¡•
swIm	æ¤ƒ
swImz	æ¤…
swIn	è§
swInd	ğ’™·
swInk	ğ–Š‘
swInt	ğ•’•
swInz	ğ’Œ‰
swIr	ğ•’ƒ
swIrz	ğ•’„
swIs	è€‚
swIst	ğ–Š™
swIt	ğ–Œ‚
swIts	è’ˆ
swIv	ğ–Œƒ
swO	ğ–Œ•
swR	é˜
swRd	å¥¡
swRdz	ğ•¨
swRk	é–
swRks	ğ–œ¢
swRl	ğ–Š–
swRld	ğ–Š—
swRlz	ğ–Š˜
swRt	ç ¢
swRv	ğ–Š…
swRvd	ğ–Š†
swU	é™§
swUS	æ¤’
swUd	è©
swUdz	ğ’€¶
swW	ğ–Š€
swY	ğ•‘¢
swYf	ğ‘˜–
swYg	é–
swYk	ğ•’†
swYn	ğ–‰‰
swYns	ğ•’‡
swYp	ğ–Š’
swYps	ğ–Š”
swYpt	ğ–Š“
swYr	ğ–Š•
swYs	ğ•’ˆ
swYt	ğ•¦
swYvz	ğ‘˜—
swYz	ğ•§
sw^ld	ğ”‘£
sw^lt	ğ”‘¨
sw^m	ğ–Œ–
sw^n	ğ–Œ—
swa	æ¢„
swaC	ğ–‰¶
swaCt	ğ–‰·
swab	ğ•‘™
swabz	ğ•‘ 
swad	ğ–‰“
swadd	ğ–‰¸
swak	ğ•¤
swaks	ğ•¥
swal	ğ•‘¦
swalm	ğ•‘§
swam	ğ–‰™
swamp	ğ–‰–
swamps	ğ–‰ 
swan	ğ“¢—
swanz	ğ–‰£
swap	ğ–‰¤
swaps	ğ–‰©
swapt	ğ–‰§
sward	ğ–ˆ¡
swas	ğ–‰´
swat	ğ–‰µ
swav	ğ–ˆ¢
swaz	ğ’“
swc	ä¤ˆ
swcb	ğ•‘¡
swcl	ğ•‘¥
swclb	ğ•‘¤
swcm	ğ•‘¨
swcmp	ğ–‰—
swcmps	ğ–‰¡
swcmpt	ğ–‰˜
swcn	æ¢†
swcnk	ğ•‘°
swcns	ğ•‘²
swcnt	ğ•‘©
swcnts	ğ•‘±
swcnz	æ¢‡
swcpt	ğ–‰¨
swcr	ğ•‘·
swcrd	ğ–‰°
swcrk	ğ•‘³
swcrm	ğ•‘´
swcrmd	ğ–‰±
swcrmz	ğ–‰²
swcrn	ğ’€–
swcrt	ğ•‘¶
swcrts	ğ•‘µ
swct	ğ–‰¹
swe	æˆ
swed	ğ‘¨
swedz	ğ”˜
sweg	è†
swegd	è‡
swek	ğ•‘£
swelz	ğ–‰”
swem	ğ–‰•
swen	é‰€
swep	ğ–‰¥
sweps	ğ–‰¦
swev	ğ–Š
swez	é 
swi	æ¢•
swiC	ğ–Š‡
swid	ğ•’‚
swidz	ğ–Šƒ
swin	ğ”€¡
swip	æ¢“
swips	æ¢–
swipt	æ¢”
swis	ğ–ˆ´
swit	æ¢—
swits	æ¢˜
swo	æ¤‘
swold	ğ’˜•
swop	ğ–Œ‘
swops	ğ–Œ’
swov	ğ–Œ”
swu	ğ–Œ†
swun	ğ–Œ„
swund	ğ–Œ…
swup	ğ–Œ‡
swups	ğ–Œ‰
swupt	ğ–Œˆ
swust	ğ–Œ
sx	ã„—
sxk	æ¡¤
sxl	ã¡
sxld	çŒ˜
sxlz	ã¡‚
sxm	ã’ƒ
sxmd	ãœ¥
sxmz	æ‚ˆ
sxn	ã„–
sxnt	ã„¸
sxnts	ã„¹
sxnz	ãŠ
sxs	å‘
sxz	ã‰µ
t	ğ–˜
t@	ã‘¥
t@C	ã‘ 
t@Ct	ã‘¡
t@G	æˆµ
t@Gk	æ¤©
t@S	å±
t@b	æ¤•
t@bz	æ¤–
t@d	æ¤—
t@f	ğ‘”¥
t@fs	ğ‘”¦
t@ft	ğ–Œ¦
t@fts	ğ–Œ§
t@g	æ¤˜
t@gd	ğ–Œ¨
t@gl	ğ“†™
t@gz	æ¤™
t@k	ã‘£
t@ks	æ¥‡
t@kst	ğ”’“
t@kt	ã‘¤
t@kts	ğŒ§
t@l	åƒ
t@lk	ğ–Œ²
t@lks	ğ–Œ³
t@m	æ¤¦
t@mp	ğ”©
t@mps	ğ–Œ¸
t@mz	ğ–Œµ
t@n	å¤„
t@nd	ğ–‚
t@ng	ğ•”
t@nk	è…¡
t@nks	ğ–€
t@nkt	ğ–
t@nt	ğ–ƒ
t@nz	éœƒ
t@p	æ¤±
t@ps	æ¤¸
t@pt	æ¤·
t@s	ã¦’
t@sk	ğ”‰—
t@sks	ğ–‘
t@skt	ğ–
t@t	æ¤¹
t@ts	ğ’œ
t@v	ğ” 
t@z	æ¥
tE	ã”
tEb	ğ–¥
tEbz	ğ–¦
tEd	ğ–©
tEdz	ğ–°
tEf	ğ—€¢
tEft	è…¢
tEfts	ğ––
tEg	ğ“ˆ
tEk	æ…„
tEkC	è‰¢
tEks	æ‡
tEkst	ä‰—
tEksts	ğŒ©
tEkt	æ…ƒ
tEkts	è‰¡
tEl	æ¥—
tElz	æ¥˜
tEm	æ¢
tEmp	ç•‰
tEmps	ç•
tEmpt	æ¥™
tEmpts	è‘„
tEmz	ğ–“
tEn	ã‘§
tEnC	ğ–¶
tEnT	æ¥ 
tEnd	æ„¢
tEndz	è‘…
tEns	å‚
tEnt	ä‰•
tEnts	ä‰–
tEnz	ğ˜
tEp	é”
tEr	æ¥
tErp	ğ–€
tErz	æ¥‘
tEs	ç ƒ
tEsk	ğ’™„
tEst	æ……
tEsts	è‘†
tEt	ğ‘”§
tEts	ğ‘”¨
tEtz	ğ–†
tEv	ğ–‰
tEz	è”
tI	ã†
tIC	ğ“•…
tIG	ã…ƒ
tIGz	å„€
tIJ	ãˆ¦
tIS	æ¸
tIbz	ğ–²
tId	ã…„
tIdz	çœ©
tIf	ğ”–
tIfs	ğ”™´
tIft	ğ–‘
tIg	çš‡
tIgd	çšˆ
tIgz	ğ–‘‚
tIk	ã–
tIks	ã—
tIkt	ğ–³
tIl	ç€ 
tIld	è¥´
tIlt	ç€¢
tIlts	ğ–‘†
tIlz	ğ•ˆ§
tIm	ç€£
tImp	ğ–‘ˆ
tImz	ç€¥
tIn	ã‘±
tInC	ğ–‘‰
tInd	ğ–ƒ
tIng	ğ‘‚
tInk	ğ‘…”
tInks	ğ–‚
tIns	ã‘“
tInt	å´
tInts	ğ–‘
tInz	è…µ
tIp	ä¹
tIps	ç€¨
tIpt	ç€§
tIr	ã¤¸
tIrd	ğ–œ²
tIrz	é––
tIs	ã¤¶
tIst	ä•
tIsts	ä‘¤
tIt	ğ‘…¡
tIts	ğ–‘‘
tIv	ã†“
tIvz	ç˜ˆ
tIz	ç•
tIzm	è•°
tO	ç€µ
tOC	ğ–ˆ
tOb	ğ–‡
tOd	ç¦–
tOl	é”ˆ
tOld	ğ–‘™
tOlz	ğ–‘ 
tOt	ğ‘Œ…
tOz	ç¦
tR	ã†’
tRb	ä”¸
tRbd	ğ”˜‚
tRbz	ğ”˜ƒ
tRd	ä€“
tRdz	è¦™
tRf	ã¤¥
tRh	ç‰
tRk	è±
tRks	è²
tRm	æ¥¡
tRmd	ğ–¹
tRmz	æ¥¢
tRn	å”§
tRnd	æ‰°
tRnz	å¥´
tRp	ğ‘¢
tRs	è ‚
tRst	è–
tRsts	è—
tRt	ğ¤–
tRz	ã…
tSI@	ä”
tSR	æ
tSRt	æ¢‘
tSRts	æ¢’
tU	ç¦™
tUS	ç„
tUg	ğ–•©
tUk	ç…
tUks	ğ–‘¨
tUl	ğ”‘°
tUr	èŒµ
tUrd	ğŒ²
tUrn	ğ–•´
tUrz	ğŒ³
tUs	ğ–•¶
tUt	ç‘
tW	ç¥
tWb	ğ–“
tWbz	ğ–•
tWk	ğ––
tWl	ç£
tWlz	ç¤
tWn	ä•¹
tWnz	ğ‘…¨
tWpt	é‘‰
tWr	ğ–‚
tWs	ğ–˜
tWt	é€“
tWts	ğ˜´
tWz	ğ–…
tY	äœ™
tYd	ç€˜
tYdz	è†
tYg	ğ“€
tYk	ğ–³
tYks	ğ–‘„
tYl	ç€¡
tYld	ğ–‘…
tYlz	ğ’Š™
tYm	ã¥
tYmd	ğ–‘‡
tYmz	å¢
tYn	ç…˜
tYnd	ğ”¥†
tYnz	ç…™
tYp	ç„¥
tYps	ç„¦
tYpt	ğ–‚•
tYr	äœ 
tYrd	æ‰©
tYrz	ç€°
tYs	äœ˜
tYst	ğ‘”„
tYt	ã
tYts	ç€™
tYv	ğ”™µ
tYz	å ¥
tYzd	çš”
t^	æŠ—
t^C	ç˜
t^Ct	ç™
t^G	ç
t^Gz	ç‚
t^b	ã–‡
t^bz	è•
t^d	ç™
t^dz	ğ““
t^f	ç 
t^fs	ğ”—
t^ft	ğ–‘¶
t^fts	ğ–•°
t^g	ç„ˆ
t^gd	ç„‰
t^gz	ğ–¦
t^k	ç„†
t^ks	é™µ
t^kt	ç„‡
t^l	ç”³
t^ld	è ƒ
t^lm	è™
t^lmz	è 
t^lz	ç–•
t^m	æ¢™
t^md	éŒ°
t^mp	ğ–§
t^mps	ğ–©
t^mpt	ğ–¨
t^mz	æ¤€
t^n	ç€¹
t^nd	é’‘
t^nk	ğ”€
t^nks	ğ–•²
t^ns	ç”©
t^nst	ğ••¶
t^nt	ç•‡
t^nts	ç•ˆ
t^nz	ç„
t^p	ğ’…’
t^ps	ğ•–‚
t^r	ğ“¶
t^rz	ğ“·
t^s	ç˜’
t^sk	ğ–•·
t^sks	ğ–•¸
t^st	çš
t^sts	èŒ²
t^t	ğ‘… 
t^ts	ğ–•¹
t^v	ğ´
t^z	çš†
ta	å…¥
taG	ç€
tad	ç€´
tadt	ğ–‘•
tadz	ğ–‘”
taf	é¥–
tafs	ğ“„
taft	ğ–‘–
tag	ğ’¤…
tagl	ğ–Œ©
tagz	ğ–‘˜
tak	ç€³
taks	ğ¤˜
tal	è‘‚
talz	ğ’‘©
tam	ç€·
tamp	ğ–ˆ
tamz	ç€¸
tan	ä¦‰
tang	ğ–‘£
tanks	ğ–‘¦
tant	ğ¥
tants	ğ¦
tanz	è 
tap	äŠ™
taps	ç’
tapt	ğ–‘²
tar	å……
tard	è‘ƒ
tardz	ğ•„–
tark	è…‰
tarl	ğ–†
tarn	ğ–‡
tarp	ğˆ©
tarps	ğ–ˆ
tart	ğ’”‡
tarts	æ¥€
tarz	è”—
tas	è…§
tat	çƒ
tats	ç“
taz	é¦—
tazd	ğ•‰ 
tc	æ¤¢
tcb	ğ–”
tcd	ğ–”
tcf	ğ˜²
tcfs	ğ˜³
tck	å¤¡
tcks	æ¤¤
tckt	æ¤£
tcl	æ¤¥
tcldz	ğ±
tclt	ğ”±
tclz	ğ”Œ
tcn	ç¤±
tcnk	ğ–‘¥
tcnt	ğ´
tcnts	ğ–—
tcnz	è¤³
tcp	ğ”¦‡
tcps	ğ–”ˆ
tcr	ç•
tcrC	éˆ’
tcrCt	ğ–‘³
tcrg	ğ”‡
tcrk	ğ–‘µ
tcrm	ğ–‘´
tcrn	é–’
tcrnz	ğ’ £
tcrp	ç¦“
tcrt	ğŒ°
tcrts	ğŒ±
tcrz	é¡™
tcs	ç–
tcst	ç—
tct	æ¥†
tcts	ç”
tcv	ğ”¤‡
tcz	ğ– 
te	ä‰’
ted	ğ°
tef	ğ“š’
teg	ğ”€¢
tek	å‘
teks	æ¤¡
tel	äŠ“
teld	ğ˜¢
telz	æ¤ 
tem	è
temd	ğ–Œ¶
temz	ğ–Œ·
ten	ä‰‘
tend	ä‰“
teng	ğ–Œ¹
tent	ğ–Œ°
tents	ğ–Œ±
teny	ğ”†“
tenz	ä‰”
tep	æ¤²
teps	æ¤¶
tept	æ¤³
tes	æ¥„
test	æ¥‚
tests	æ¥ƒ
tet	äœ¨
tetg	ğ–’
tets	å“
tevz	ğ–™
tez	ğ„‘
ti	ã„
tiC	æ¥ˆ
tiT	æ¥”
tibz	ğ–•
tid	è…
tidt	ğ–¶
tif	è††
tifs	ğ”ˆ¥
tig	è…˜
tigd	ğ‘
tigz	ğ‘‚
tik	è…™
tiks	è… 
tikt	ğ”³
til	ğ’Š˜
tilk	ğ–€
tils	ğ–
tilz	ğ“™€
tim	æ¥‰
timd	ğ–£
timz	ğ–¢
tin	ä™³
tinT	ä™´
tind	ğ”¥…
tint	ğ‘‡
tints	ğ–„
tinz	æŒ—
tip	ğ–·
tir	ç†ƒ
tird	ğ–¸
tirs	ğ–·
tirz	ğ”‰²
tis	æ¥’
tist	ğ”¨
tists	ğ”°
tit	ğ”˜†
titg	ğ–¹
tits	ğ”˜‡
titz	ğ–‘€
tivz	ğ’™˜
tiz	ã€•
tizd	ğ–¤
tli	ã˜†
tmInt	ãˆ•
to	ä 
tob	ğ–†
tod	ç€©
todz	é ¦
toft	ğ–‘—
tok	ğ–‘“
tol	è‚‡
told	ç€¶
tolf	è¥³
tolz	ğ–‘¡
tom	ğ’†
tomz	ğ–‡
ton	ä‰¶
tond	ğ“ˆ’
tonz	è
top	ğ‘”©
tops	ğ“ˆ´
tor	ç“
tord	ç¡
tordz	ç¢
torn	ç”
tos	ç€²
tost	ç€±
tosts	ğ–‘’
tot	è©
tots	è°
tov	ğ–‘¸
toz	å¶
tr	ğ–•˜
tr@	ç©
tr@S	ç¸
tr@dz	ğ–„
tr@f	ğ–’‚
tr@k	ã‘©
tr@ks	ç§
tr@kt	è‘‡
tr@kts	è‘ˆ
tr@m	è¡
tr@mp	ğ–’…
tr@mpt	ğ–’†
tr@mpz	ğ–’‡
tr@mz	ğ–’ˆ
tr@n	çµ
tr@nC	ğ–’‰
tr@ns	ç´
tr@nst	ğ‘”‡
tr@nt	ğ–’˜
tr@nz	éœ©
tr@p	äœ¢
tr@ps	ğ–’™
tr@pt	ç·
tr@sk	ğ–”€
tr@st	ğŒ´
tr@sts	ğŒµ
tr@v	ğ–”†
tr@z	ç¢‚
trE	ä‰ 
trEd	ğ•„™
trEdz	ğ•„ 
trEf	ğ–”‰
trEfz	ğ–”
trEk	ğ”¢
trEks	ğ‰¨
trEkt	ğ–”‘
trEl	é†
trEm	ğ”‘©
trEn	ğ‘”’
trEnC	ğ‘”
trEnCt	ğ‘”‘
trEnd	ğ™†
trEndz	ğ™‡
trEnt	ğ–”“
trEnts	ğ–””
trEnz	ğ–”’
trEp	ğ–”•
trEr	ğ–’
trEs	ğ–“
trEst	ğ–”—
trEt	é
trEts	ğ–’
trI	ä™¸
trIC	å¤“
trIb	ğ–”£
trId	ğ”¤¦
trIf	ğ–—
trIfs	ğ–˜
trIft	ğ’’
trIfts	ğ––
trIg	è‘‘
trIgz	ğ–”§
trIk	äˆ±
trIks	ã˜ˆ
trIkt	ç‚…
trIl	è…¨
trIld	ğ–™
trIlz	ğ– 
trIm	ç‚‰
trImd	ğ–”°
trImp	ğ–”±
trImz	ğ–”²
trIn	é ¢
trIns	äœ¡
trInz	é £
trIp	ç‚
trIps	ğ–¡
trIpt	ç‚’
trIr	ğ–”¥
trIs	ä„™
trIsk	ğ‘
trIst	é¡£
trIsts	é¡¤
trIt	é §
trIts	ğ–”¶
trO	ä‘¸
trOd	éŒˆ
trOt	ğ¤™
trOts	ğ¤ 
trOz	ğ–•‚
trR	ğ˜¶
trU	ğ–•¡
trUk	ğ¥¸
trW	ç‚–
trWb	ğ– ´
trWdt	ğ–•’
trWlt	ğ–…
trWn	ğ–•–
trWns	ğ–•”
trWnst	ğ–••
trWs	ğ–”„
trWt	ç‚—
trWts	ğ–•—
trY	ç‚„
trYb	ğ¥‘
trYbz	ğ¥’
trYd	ç‚†
trYdz	ğ”˜‰
trYk	ç‚ˆ
trYl	ğ–”¡
trYlz	ğ–”¢
trYm	ğ–”©
trYn	ğ–”³
trYp	ğ–”µ
trYs	ğ–•
trYst	ğ–•¦
trYt	é³
trYts	é´
trYv	ğŒ¶
trYvd	ğŒ·
trYvz	ğ–¢
trYz	ç‚‡
tr^	ç‚€
tr^Gk	ç„€
tr^Gks	ç„
tr^St	ç¹
tr^d	è¥µ
tr^dz	ğ’ †
tr^g	é‘
tr^gd	ğ–• 
tr^k	ä’
tr^ks	ç‚˜
tr^kt	ğ–•™
tr^l	éŒ±
tr^lz	é¡¡
tr^m	è¥¶
tr^md	ğ•¤ƒ
tr^mp	ğ–•¢
tr^mps	ğ–•£
tr^mpt	ğ–•¤
tr^mz	ğ•¤„
tr^n	è‰ˆ
tr^nd	è¥·
tr^nft	ğ’’
tr^ns	ğ•‘
tr^nt	ğ‘”ˆ
tr^nts	ğ‘”‰
tr^nz	ğ§
tr^p	è™µ
tr^ps	ğ”²
tr^s	ç˜‘
tr^st	ç„‚
tr^sts	é¡¥
tr^t	ğ‘
tr^ts	ğ”³
tr^z	èŒ´
tra	äšƒ
traC	ğ–‘¹
trab	ğ’ ¹
trabz	ğ’¡€
trad	ğ–•€
trag	ğ–•
trak	é™
tral	é—
tralz	ğŒ¸
tram	ç‚“
tramp	ğ–•„
tran	çœƒ
trand	ğ“‰¦
tranz	ğ¨
trap	ğ–•ˆ
trar	ğ”˜ˆ
tras	ç¡·
trast	ğ–•‰
trat	ğ–¤
trats	ğ–•
trav	ğ•˜€
traz	è‰†
trc	ç‚
trcb	ğ–”
trcdt	ğ–”‚
trcf	ç‚•
trcfs	ğ–•“
trcl	ğ‘”€
trcld	ğ‘”
trcm	ğ–”ƒ
trcn	éš‰
trcnd	ğ–£
trcnz	éš
trct	ğ–”…
tre	äˆ°
tred	ç¨
tredz	ğ–’€
treg	ğ”‘³
tregd	ğ”‘´
trel	ğ˜µ
treld	ç°
trelz	ç±
tren	æ‚–
trend	ç²
trenz	ç³
trep	ğ–’„
treps	ğ–’ƒ
tres	ğ’€€
trest	ğ•„˜
tret	äˆ©
trets	è‰‡
trev	è‰£
trevz	è‰¤
trez	é€ƒ
tri	äŒ‚
triC	ğ”‘µ
trig	ğ“ˆ”
trigd	å†
trigz	ğ“ˆ•
trik	ğ‘‡
triks	å¥²
trim	ğ–”¨
trin	ğ¥
trinz	ğ‘•†
tris	å¥±
trist	ğ–”¦
trit	ç‚‚
trits	ç‚ƒ
triv	ğ•„¡
trivd	ğ•„¢
trivz	ğ•„£
triz	äŒ
tro	ä‰£
trob	è‘
trobz	è’
trod	ğ‘ˆ
trodz	ğ‘‰
trol	ä‰¡
trold	ä‰¢
trolz	ä‰¤
trom	ğ–•ƒ
tron	ğ¦
trond	ğ¤—
trop	ç¥ˆ
trops	ç¥‰
tros	é€
trot	ğ˜¸
trov	ğ–¥
troz	ğ’¡…
tru	ç‚™
truT	ç„ƒ
trub	ğ–•‘
trud	ğ’Œ‘
truds	ğ–˜´
trudz	ğ“ˆ–
trum	è“
trumz	è”
trun	ğ–•…
trup	ç‚”
trups	ğ””¸
trupt	ğ–•†
trur	ğ–”™
trus	é¤”
trust	ğ–•‡
trut	ğ”˜
truts	ğ–•¥
truz	é²
trx	ã¦“
trxl	å ´
trxm	æš‰
trxmz	æ¤°
trxn	ã”
ts	ğ–•§
tu	å…
tuT	ç‰
tub	ç„„
tubz	ç„…
tud	ã‘¨
tudd	ğ–‘±
tudz	ç¦•
tug	ğ“
tuk	ğœ¨
tuks	ğ–
tul	ç†
tuld	ğ•„—
tulz	ç‡
tum	ğ‘”…
tumd	ğ‘”†
tumz	ğ“¤¢
tun	ã¦„
tund	è‘’
tunz	ã¦…
tups	ğ–‘©
tur	ä’…
turn	ğ–‘·
turz	ğ”ˆ¤
tus	ğ”•
tut	æ¡£
tuts	ç
tutt	ğ–‘°
tuy	ğ•€¤
tuz	æ¥…
tuzd	ğ‘”‚
tw@ks	ğ•ˆ¥
twE	è¦’
twEdt	ğ––…
twEl	è‘–
twElfT	ç„”
twElv	ç„•
twElvt	ğ––‡
twElz	ğ•ˆ¦
twEn	ç„–
twEr	æ™‘
twErz	ğ•¡‡
twEst	ğ”Š”
twEsts	ğ”Š•
twI	ç„˜
twIC	ğ” ´
twICt	ğ––—
twIG	ç„™
twId	ğ––ˆ
twIg	ğ“¥µ
twIgd	ğ––‰
twIgz	ğ––
twIk	è¦–
twIkst	é€†
twIl	ğ––‘
twIn	é¤¢
twInd	ğ‘ˆ
twIng	ğ––’
twInz	ğ––“
twIs	ç„¢
twIst	ã””
twIsts	ğ–––
twIt	ğ’€˜
twIts	ğ“•“
twIz	ã†
twR	ç„¡
twRd	ğ‘‡
twRdz	ğ”’ƒ
twRk	èŒ¶
twRks	èŒ·
twRkt	ğ”Œ˜
twRl	ç„ 
twRld	ğ––”
twRlz	ğ––•
twRm	ğ™€
twRmz	ğ™
twRp	è…±
twRst	é
twRt	è‘—
twU	é ±
twUd	è‘“
twUdz	è‘”
twWt	ğ–‰³
twY	ç„£
twYd	ğ‡
twYl	ğ‘•”
twYn	è…²
twYnd	ğ‘”“
twYs	ç„—
twYt	ğ––˜
twYz	ğ’¡‚
tw^	è…¥
tw^k	ğ“ ‡
tw^ld	ğ’”
tw^lt	ğ’”‘
tw^n	ğ”¤’
tw^t	ğ•©
tw^z	ç–
twa	èŒ³
twaC	ğ†
twad	ğ–‘ƒ
twak	é ©
twaks	ğ’œƒ
twam	ğ–¢‚
twan	è…¤
twar	ğ•‚™
twas	ğ”ˆ¹
twast	ğ–¢
twaz	ğ“˜´
twc	è‘•
twck	é °
twcl	é¤¡
twcn	é •
twcr	ğ’¡
twcrt	è¸
twcrts	ğ–±
twe	è¤£
twed	ğ”’„
twen	ğ––
twenz	ğ––‚
twet	é‡
twev	ğ•˜¨
twez	ğ’‚‡
twi	ç„’
twid	ğ––†
twik	ğ’ ³
twiks	ç„‘
twikt	ğ––„
twil	é’
twilz	é“
twin	ã™©
twinz	é€…
twit	ç„“
two	ğˆ–
twol	ğ’•’
twum	ğ––™
tx	ã‚†
txd	ã¡
txl	ã–‘
txld	æ²
txlz	ã˜¥
txm	ã•ˆ
txmz	ã‚
txn	ã¥
txnd	ã¤§
txns	ã…‚
txnt	å–
txnz	ã¤©
txs	æ¤
txst	ä “
txz	ä‘
u	äœ¹
ud	ğ–˜ƒ
uf	ğ”µ
uk	ğ‘Œ°
ul	è˜µ
ulz	è˜¶
um	ğ“‚–
umf	ğ”´
un	éœ³
und	ğ“¥‘
up	å¢•
ups	å¢–
us	ğ¢‡
ut	è ¡
uz	è…¦
uzd	ğ”¶
v	ğ–œ˜
v@	äœ±
v@C	ğ’™¶
v@d	è€
v@g	ğ–¨
v@k	é¡±
v@ks	ğ“€
v@kt	ğ”€´
v@l	ç… 
v@lv	é‚…
v@lvz	é‚†
v@lz	ğ–™‡
v@m	ç…¡
v@mp	ğ•„¨
v@mps	ğ•„°
v@mpt	ğ•„©
v@n	ãˆ¥
v@nd	ğ–™’
v@ns	çš…
v@nst	ãˆ¤
v@nt	ğ“¨
v@nv	ğ–™§
v@nz	ç…£
v@s	é¤
v@st	ğ–šƒ
v@t	ç…§
v@ts	è˜‡
v@z	è•‚
vE	ã²
vEC	ğ“˜¢
vEJ	ç…¨
vEd	ğ‘˜€
vEdt	ğ––€
vEg	è¥
vEk	çš‘
vEks	ğ…
vEkst	ğ–œ€
vEl	ç…°
vEld	ğ“’
vElt	ğ•ˆˆ
vElts	ğ•ˆ‰
vElz	ğ”€
vEm	å¡—
vEn	ã€˜
vEnd	ğ–‰
vEng	è”˜
vEngd	è”™
vEnsk	ğ–‰‘
vEnt	äœ³
vEnts	æ„¥
vEnzk	ğ–š”
vEr	è”¥
vErt	ğ’Œ—
vEs	ã
vEsk	ğ“±
vEss	ğ•‚…
vEst	çš•
vEsts	ç…³
vEt	é ¹
vEts	é‘¢
vEz	é¤©
vI	ã†”
vIC	ã¡†
vIG	ã…±
vIGz	å˜¸
vIZ	æ¥–
vId	ä±
vIdz	ğ‚
vIg	é‘£
vIgd	ğ•€´
vIk	ç…´
vIks	é‰¶
vIkt	ğ‡
vIkts	ğˆ
vIl	ã™
vIld	ğ’˜¢
vIlh	ğ–œˆ
vIlt	é…‚
vIlz	çš–
vIm	ğ•Œ†
vIn	äšˆ
vInT	äš‰
vInd	è‚
vIng	ğ–œ‘
vInk	ğ–œ’
vIns	ğ‰
vInst	ğ
vInt	ğ–œ“
vIny	ğ“œ…
vInz	å‘¹
vIr	ç˜•
vIrd	ğ”˜€
vIrz	ğ‘¥
vIs	ä²
vIst	å†ˆ
vIsts	ç˜‰
vIt	é¡€
vIts	ç‘·
vIv	ğ–œ–
vIz	ğ’†”
vO	ç†€
vOd	è”±
vOdz	è”²
vOgt	ğ–œ¤
vOgts	ğ–œ¥
vOlz	ğ–œ§
vOs	ç…¹
vOst	ğ–œ¡
vOt	ğ–œ£
vOts	ğ–œ¦
vOz	ğ“
vR	ã„
vRb	çš’
vRbd	ğ•„³
vRbz	çš“
vRd	äŒ‰
vRdz	ğ’•
vRg	ğ‚
vRgd	ğƒ
vRh	ğ”’•
vRn	ç…²
vRnd	ğ’” 
vRny	ğ“œ„
vRnz	é ¸
vRp	ğ”’‰
vRs	æ‰²
vRst	ğ„
vRt	è”¦
vRts	è”§
vRv	ğ–š—
vRz	ã˜‰
vU	ğ–™¨
vUl	ğ–…
vUr	ğ–™©
vUrd	ğ–™¡
vUrst	ğ–™°
vUrt	ğ–™—
vW	ä’ˆ
vWC	ğ–œ¶
vWCt	ğ–œ·
vWd	è”´
vWlz	ğ–œ¹
vWt	ğ¤³
vWz	ğ–€
vY	ãˆ¨
vYC	ğ–š“
vYb	ğ–œ
vYbz	ğ–œ‚
vYd	ğ‘‚‡
vYdz	ğ‘‚ˆ
vYk	ğ–œ…
vYks	ğ–œ†
vYl	ğ“©
vYld	ğ•„µ
vYlz	ğ–œ‡
vYn	ä•‚
vYnz	ç…·
vYr	ğ‘°
vYrz	ğ–œ•
vYs	ãˆ§
vYt	è€†
vYts	åˆ
vYv	æ¢ƒ
vYvd	ğ•„¶
vYvz	ğ•„·
vYz	å•¥
vYzd	çš—
v^	ç•³
v^C	ğ“•˜
v^d	è”¨
v^g	ğ„€
v^h	ğ–’
v^k	ğ’ ™
v^ks	ğ“™
v^l	è…³
v^ld	è¡ 
v^lg	ğ‘‚
v^lgd	ğ‘‚‘
v^lt	è•…
v^lz	èˆ˜
v^m	ğ”‚
v^n	çš‰
v^nd	è‰ƒ
v^ng	ğ•Œ¸
v^ns	è¤–
v^nt	è” 
v^nts	ğ
v^nz	è”³
v^s	è¡ˆ
v^st	é¥
v^sts	ğ’–
v^t	çœ¨
v^ts	ğ·
v^z	ç…¦
va	ä€
vad	ğ–š„
vag	é ³
vak	ğ™¡
vaks	è‘©
val	ç”´
vald	ğ‘˜
valt	ğµ
valv	ğ¤¨
valvd	å‰
valvz	å
valz	ğ¤£
van	è”•
vank	ğ–œ³
vant	è””
vanz	ğ“ ˆ
var	ç¥§
vard	é€
vardz	éŒµ
vark	ç‚
varks	çƒ
varn	ğ“œ‚
varnz	ğ–™¶
varvz	ğ–™¸
varz	ğ–™·
vas	ğ¤°
vat	ğ‘’
vaz	ğ˜
vc	ğ‘Œˆ
vcf	ğ“
vck	ğ–™…
vcks	ğ–šˆ
vcl	ç†
vcld	ğ–´
vclt	ğ¶
vclts	ğ–š‡
vclvd	ğ–˜©
vclz	ğ–™†
vcn	ğ¤¤
vcns	ç¡’
vcnts	è”–
vcnz	ğ–š…
vcr	ä•„
vcrd	è€‡
vcrn	ğ–œµ
vcrs	ä•ƒ
vcrst	ğ‘‚‰
vcrt	é¡‚
vcrz	éƒ
vcs	é¤°
vct	ğ–š†
ve	ã†‘
ved	ğ†
vedz	ğ‘–™
veg	ç…—
vel	ç…±
veld	è”‘
velz	ç…©
ven	ç…¥
venz	ğ–™£
vep	ğ–™´
ver	è€ƒ
verz	ğ–™µ
ves	ğ–™¹
vesk	ğ–š€
vet	ç˜†
vets	ç˜‡
vez	ç˜…
vi	ä‰¥
viC	ğ–š‘
vid	ğ‘‚’
vig	ğƒ
vik	ğ“•²
vil	æ‰±
vild	ğ•„±
vilz	ğ•„²
vin	ğ¡
vind	ğŒ¹
vinz	ğ€
vip	ğ–š’
vir	ğ•Œˆ
virz	ğ–š–
vis	é¥²
vit	ğ”‰§
vits	ğ–œ„
viv	è”©
vivz	è”°
viz	å
vo	ä’‡
vog	ğ–œ 
vok	ğ‘
voks	ğ‘˜‘
vokt	ğ’
vol	ç†‚
vold	é˜
volk	ğ–œ©
volks	ğ–œ°
volp	ğ–œ±
volt	ğ¢
volts	ğ•„¸
volz	ğ–œ™
von	ğ“ 
vos	é¡ 
vost	ğ”¡
vosts	ğ”¢’
vot	ç†„
vots	ğ¤±
voz	ğ¤©
vr@	ğ’  
vr@n	ğ–™±
vrE	ğ–ƒ
vrEk	ğ–š
vrEt	è”¹
vrI	ä ’
vrIg	è”¡
vrIgd	è”¢
vrIk	ğ“¦
vrIks	ğ“¦‘
vrIl	è”¤
vrIn	ğ‘‘™
vrInz	ğ“œ‡
vrIs	ğ“… 
vrIst	ğ“…¡
vrIt	ä ‘
vrO	ğ¤µ
vrRd	ğ‘˜’
vrY	ğ”–
vr^	è”¶
vr^g	ğ“°
vr^l	è•€
vr^m	è”¸
vr^n	é¥¨
vr^nd	ğ•„´
vr^ns	ğ ¤
vr^nz	é¥°
vr^s	ğ’‰¡
vr^st	ğ‘˜„
vr^sts	ğ‘˜…
vr^t	ğ‘˜†
vr^ts	ğ‘˜‡
vra	ğ–©
vran	é¥©
vrant	é¥¦
vranz	é¥±
vre	ğ”€†
vren	ğ–‚
vri	äœ´
vrid	ğ“ ‰
vrim	è•
vris	ğ¤´
vriz	ğ ¥
vro	é¥§
vrot	ğ”Š™
vroz	ğ–°
vru	ğ•–ƒ
vrulz	ğ“¦“
vrum	ç†…
vrxJ	ã‘·
vu	é˜˜
vul	ğ–„
vus	ğ”™
vut	ğ–œ¸
vuz	é˜™
vx	ãŒ•
vxl	ä„ 
vxld	æ”„
vxlz	æ”€
vxn	ä’†
vxnt	å†˜
vxnz	åˆ¡
vxs	å ²
vxt	æ„³
vxz	ã‘µ
vyE	ğ–¥£
vyEn	ğ¤¦
vyErz	ğ–…
vyEt	ç…µ
vyI	ğ•…²
vyIr	ğ‘¡–
vyR	ã˜·
vyRz	è¢…
vyU	é¡
vy^	ğ”’˜
vya	ğ–†
vyan	ğ–œ—
vyard	ğ’•–
vyardz	ğ’•—
vyas	ğ–‡
vyc	ğ’‰™
vycn	ğ•Œ‡
vyu	å¦‚
vyud	ğ“ˆ
vyul	ğ”’™
vyulz	ğ””€
vyuv	ğ–š™
vyuz	ğ“ˆ‘
w	ğ–¤™
w@	ç††
w@g	ç†ˆ
w@gd	ğ–§
w@gz	ğ–¤
w@k	çˆ¸
w@ks	çˆ™
w@kst	ğ– 
w@kt	ğ–”
w@lp	ğ–¹
w@m	ç‰
w@n	èœ•
w@nz	ğ–ˆ
w@s	ğ’š€
wE	ã—
wEC	ğ—„‰
wEb	çˆ¦
wEbd	ğ– –
wEbz	ä†’
wEd	ğ”Œ 
wEdz	ğ”Œ¡
wEg	ğ– ™
wEgd	ğ–  
wEk	ğ– 
wEks	ğ”˜’
wEkt	ğ– —
wEkts	ğ– ˜
wEl	ã’
wElC	ğ–¡…
wEld	ğ°
wEldz	ğ–¡†
wElg	ğ–¡‡
wElk	ğ–¡ˆ
wElm	ğ”’”
wElmd	ğ”’–
wElmz	ğ”’—
wElp	ğ–¡‰
wEls	ğ–¡
wElt	ğ‰ƒ
wElts	ğ‰„
wElz	ğ‘œ—
wEm	ğ–¡‘
wEmp	ğ–¡’
wEn	ç‰ˆ
wEnC	ğ–¡“
wEnd	ğ–¡•
wEndz	ğ–¡–
wEng	ğ–¡—
wEnk	ğ–¡”
wEns	ğ–¡¨
wEnt	çˆµ
wEnts	ğ–¡˜
wEnz	çˆ§
wEpt	ğ–¡™
wEr	ã’‚
wErst	ğ’…–
wErt	ğ–¡
wErz	ç„³
wEs	ğ–¡£
wEsp	ğ–¡¥
wEst	åœµ
wEsts	ğ”³
wEt	çˆ·
wEts	ğ•™¦
wEw	ç‰‘
wEz	ğ–¡¤
wI	ä”µ
wIC	ã€³
wICt	é€‘
wID	çŠ•
wIG	æ•¸
wIGk	ç€¦
wIGz	çŠ†
wIS	çŠ“
wISt	çŠ”
wId	ğ™–
wIdT	ç‰´
wIdts	ğ–¢ˆ
wIf	ğ–¡©
wIg	ç‰·
wIgz	è™¦
wIk	ç‰³
wIks	é•´
wIl	çŠ€
wIld	ç‰¹
wIlg	ğ”
wIlk	ğ–¢–
wIlks	ğ–¢—
wIlmz	ğ–¢˜
wIlp	ğ–¢™
wIlt	ğ–™™
wIlts	ğ–¤€
wIlz	ğ•„
wIm	ğ–¡±
wImp	ğ–¤‚
wImps	ğ–¤ƒ
wImz	ğ–¡²
wIn	çŠ‚
wInC	ğ–¤†
wInd	çŠƒ
wIndz	çŠ„
wIng	ğ–¤‰
wInk	ğ–¤‘
wInks	ğ–´
wInkt	ğ–¤
wIns	ğ–¤„
wInst	ğ–¤…
wInt	ğ–¤ˆ
wInts	ğ–¤’
wInz	å¦–
wIp	ç‰–
wIpf	ğ–¤“
wIps	ğ–¡µ
wIpt	ğ–¡´
wIr	ğ–¡€
wIrd	ğ–¡
wIrts	ğ– ¦
wIs	ç‰¡
wIsk	ğ–¡¶
wIsks	ğ–¡¹
wIskt	ğ–¡·
wIsp	ğ–¤—
wIst	è„¢
wIsts	ğ“™
wIt	ç‰£
wIts	ç‘¸
wIz	ğ’œ„
wIzd	ğ–¢ƒ
wO	ğ–¤¥
wOt	ğ–¤¦
wR	å•
wRT	çŒ•
wRd	ä™¦
wRdz	ãˆ¶
wRf	ğ–™˜
wRk	å‰¶
wRks	çŒ‰
wRkt	çŒ‡
wRl	ğ–¡¡
wRld	ç‰™
wRldz	çŒ
wRlz	ğ–¢†
wRm	å¡
wRmz	çŒ‘
wRn	ğ“œ†
wRnt	çˆ¶
wRnts	ğ–¡¢
wRs	çŒ“
wRst	çŒ”
wRt	ç¤¹
wRts	ç £
wRz	ğ–°
wU	ç‰¨
wUd	å‰²
wUdz	çŒ„
wUf	çŒ…
wUl	çŒ€
wUlf	çŠ™
wUlfs	ğ••¡
wUlvz	ğ–¡ 
wUlz	ğ–¥‚
wUns	ğ–¥˜
wUp	ç‰°
wUrt	ğ–¥™
wUrts	ğ–¥ 
wUs	çŒ 
wW	ã–
wWd	ğ–™ 
wWlf	ğ–¥‰
wWnd	çŒ–
wWz	ğ”ˆ
wY	ç‰•
wYC	ğ–¥¢
wYS	çŠ’
wYd	ç‰²
wYdz	ğ”Š“
wYf	ç‰µ
wYfs	ç‰¶
wYg	ğ•ˆ–
wYh	ğ–™²
wYk	ğ– °
wYks	ğ”ˆ§
wYkt	ğ– ±
wYl	åœ’
wYld	ç‰¸
wYldfl	ğ–¢“
wYldz	ğ–¢’
wYlst	ğ–¡°
wYlz	ğ– ²
wYn	ç‰’
wYnd	ğ•…‚
wYndz	ğ–¤‡
wYnt	ğ– ¶
wYnts	ğ– µ
wYnz	ğ–¡³
wYp	çŠ‡
wYps	çŠ
wYpt	çŠˆ
wYr	ã•“
wYrd	ğ–¤”
wYrz	çŠ‘
wYs	ğ¥€
wYst	ğ–¡ƒ
wYt	ä™…
wYts	ğ”—
wYvz	ç¤…
wYz	å¤”
wYzd	ğ–¤•
w^	å¢’
w^d	ğ“™²
w^g	ğ–¥¡
w^k	ğ–œ
w^l	ç³
w^ld	ğ•’
w^lf	ğ¥‚
w^lt	ğˆ
w^lz	é ”
w^m	ğ”„§
w^n	ã£
w^ns	å¢‘
w^nt	çˆ€
w^nts	çˆ‚
w^nz	äœ¶
w^s	ğ‘„
w^st	ğ“ˆ“
w^t	ç‰‚
w^ts	ç‰ƒ
w^z	çˆˆ
wa	ä°
waC	çˆ•
waCt	çˆ–
waS	å‰¦
wab	ğ–¤ 
wabst	ğ–¤¡
wad	è•ƒ
wadz	ğ–™
waf	ğ–£
waft	ğ–¢
wag	ğ–‰
wak	è‰„
waks	ğ–¤§
wakt	ğ–•
wal	ç†—
wald	é–…
walt	è‚ˆ
wam	ç¦
wamz	ğ’™¸
wan	ç†™
wand	ç†˜
wandz	ğ–…
wank	ğ–‰
wanks	ğ–¤¶
want	ğ–‘
wants	çˆ
wanz	ğ“„—
wap	ğ–’
waps	ğ–¥„
war	è…´
ward	ğ“´
warf	ğ–¡§
warz	èŠ•
was	è•‡
wasp	çˆ’
wasps	çˆ“
wast	é„
wat	ğ“¡
wats	ğ“¢
waz	ğ¢
wazdz	ğ’œ…
wc	ç†‡
wcC	ğ–‘
wcS	çˆ‰
wcSt	çˆ‘
wcd	ğ–˜
wch	ğ––
wck	æ”‡
wcks	ç†”
wckt	ç†“
wcl	ç†‘
wclC	ğ–²
wcld	è˜‘
wcldz	ğ’•²
wclfl	ğ–¶
wclk	ğ–³
wclm	ğ–·
wcln	ğ–¸
wclp	ğ–€
wcls	ğ–
wclt	ç†–
wclts	ğ–ƒ
wclz	ç†•
wcm	ğ–„
wcn	ğ“‘†
wcnd	ğ–¤µ
wcnz	ğ–
wcr	çˆƒ
wcrd	æ‰³
wcrdz	è•†
wcrf	ğ–•
wcrfs	ğ–¡¦
wcrk	ğ–—
wcrl	ğ–¢…
wcrlz	ğ–¢‡
wcrm	çˆ„
wcrmd	çˆ…
wcrmt	ğ–™
wcrmz	ğ–˜
wcrn	çˆ†
wcrnd	ğ’€ˆ
wcrnz	ğ’€‰
wcrp	ğ– 
wcrps	ğ– ƒ
wcrpt	ğ– ‚
wcrs	ğ– „
wcrst	ğ– †
wcrt	èœ“
wcrts	ğ’¦•
wcrz	çˆ‡
wcs	ğ– ‡
wct	ğ“
wctn	ğ– ‰
wcz	ğ– ˆ
we	ã¦
wed	ğ––
wedz	ğ–—
wef	ğ–©
weg	ğ–¥
wegd	ğ–¦
wek	ã’€
weks	ç†
wel	çˆ¹
weld	ğ–°
welz	ç‰€
wen	ğ¤¸
wend	ğ–†
wenz	ğ–‡
wer	ã¨
werd	ç‰
werz	çˆ¥
wes	ğ–
west	çˆ”
wests	ğ–±
wet	ç†‰
wets	è•„
wev	åœ³
wevd	çˆ—
wevz	çˆ˜
wez	ã§
wi	å’–
wiC	ğ– ¡
wib	ğ–¢‰
wid	çˆ 
widz	çˆ¨
wig	ğ– §
wih	ğ– ©
wik	çˆ¤
wiks	çˆ°
wil	çˆ¡
wild	ğ– ³
wildz	ğ–¢
wilz	ç‰‡
wimz	ğ– £
win	å…§
wind	ğ– ‘
wink	ğ–¢‘
wint	ğ– ’
winz	çˆ±
wip	ğ– ¤
wips	ğ– ¥
wir	çˆ¢
wird	çˆ³
wirz	ğ– ¸
wis	ç¥¢
wist	ğ– “
wit	ç‰…
wits	ğ–¡„
wiv	çˆ£
wivd	ğ– ”
wivz	ğ– •
wiz	çˆ²
wo	ç‰¥
wok	çŠ˜
wol	ğ–¤¢
wold	ğ–¤¨
wolk	ğ–¤±
wolsk	ğ–¤³
wolt	ğ–¤©
wolts	ğ–¤´
wolz	ğ–¤²
wont	çŒ‚
wor	çŒ†
worn	çŒ’
wost	ğ–¤¤
wov	ğ–¥‘
woz	ğ–¤£
wu	çŒƒ
wuS	ç‰±
wud	ğ–¥€
wuf	ğ–¥
wuk	ğ“Œ 
wum	çŒ
wun	ğ–¥ƒ
wundz	ğ–¥
wup	ç‰§
wups	ç‰©
wupt	ğ–¢„
wut	ğ–ˆ
wuz	ğ–¤·
wx	ã•
x	ã„„
xb	ã„™
xd	æ€‚
xl	ã†˜
xlz	ä€–
xm	ã„
xmz	å•
xn	ã‘
xns	å
xnz	å·
xp	ç…„
xs	ã‘‚
xst	æ ‰
xts	ä’–
xz	ã‚–
y	ğ—€¶
y@	ğ’¤
y@G	çŒ±
y@Gk	çŒ©
y@Gks	çŒ²
y@Gkt	çŒ°
y@f	ğ–¥°
y@k	çŒ¤
y@ks	çŒ¥
y@kt	ğ–¥¨
y@l	é—
y@m	çŒ§
y@mz	çŒ¨
y@n	ğ“‰”
y@nk	ğ–¥±
y@nks	ğ–¥¸
y@nkt	ğ–¥·
y@nt	ğ’–™
y@nts	ğ’˜€
y@nz	ğ”¤©
y@p	ğ’Œ¡
y@ps	ğ–¥¹
y@s	è•¡
y@t	ğ–¦–
y@v	ğ–¦…
y@z	ğ–¦‚
yE	çƒ
yEd	ğ•Œ
yEf	è©
yEk	ğ•†˜
yEl	ç„
yEld	ç…
yElp	ğ–¦—
yElt	ğ–¦˜
yElz	ç†
yEn	ç ‚
yEnt	å¤ˆ
yEnz	ğ–¦™
yEp	ç‡
yEr	ğ“
yErl	ğ”˜·
yErz	ğ’„·
yEs	ç
yEsk	ğ—€
yEst	ğ—€‚
yEt	ç’
yEts	ğ“¡€
yEv	è¨
yEw	ğ™¢
yI	ç“
yIG	ã‰
yId	ğ“‰©
yIm	ğ—€„
yIn	å„
yIngst	ğ—€…
yInkst	ğ—€†
yInz	ğ”‘¢
yIp	ğ—€‡
yIpt	ç•
yIr	å•¹
yIrz	ğ“…
yIs	ğ·
yIt	ğ—€ˆ
yO	ğ—€´
yOn	ğ“‚
yR	ä¡ƒ
yRd	ä¡
yRdz	éƒ
yRk	ğ—€€
yRn	ğ–¦ˆ
yRnd	ğ–¦‰
yRnz	ğ–¦
yRs	ğ¤§
yRt	ğ‘”˜
yRz	ä¡‚
yU	ã‚”
yUk	ğ”¹
yUn	ğ“Œ–
yUnz	ğ“Œ—
yUr	ç¥
yUrd	ğ“ˆ—
yUrt	ğ—€¹
yUrz	ç¦
yW	ğ‘ ³
yWns	ğ—€§
yWnt	ğ—€©
yWnts	ğ—€°
yWs	ğ—€±
yWt	ğ—€²
yWts	ğ—€³
yY	ğ“”¤
yYks	ç”
y^	ç©
y^G	ä™±
y^k	ç¨
y^ks	ç°
y^l	ğŠ˜
y^lz	ğœ†
y^m	ç²
y^mz	ğŒ—
y^n	ç„·
y^ndt	ğ—€¸
y^ng	ğ—€¨
y^nk	ğ“‰–
y^ns	é’•
y^nst	ğ“…·
y^nt	é†
y^nts	é‡
y^ntts	ğ”‚—
y^nz	è’—
y^p	çµ
y^s	ğ¸
y^sk	ğ“‰¡
y^st	ğ—€
y^t	ğ“‘ˆ
y^v	ğ“•—
y^z	è’–
ya	ä±
yaf	ğ“˜”
yak	ğ”¥
yal	ğ’˜
yalz	ğ•…³
yam	ğ“‰’
yamz	ğ—€•
yan	ç 
yang	ğ—€ 
yank	ğ—€¡
yans	ğ—€—
yants	ğ—€£
yanz	ğ“³
yap	ğ—€¥
yar	è„ƒ
yard	ä „
yardz	ğ²
yarn	çŒ³
yarnz	ğ–¦
yarsk	ğ“•§
yart	ğ‘”—
yarz	ğ’¡²
yas	ğ“‘‡
yat	çŒ£
yats	ğ–¥§
yaz	çŒ¸
yc	çŒ¶
ycC	ğ–¦„
ycf	ğ“˜
yck	ğ“–‘
ycl	çŒ¦
ycn	çŒ´
ycnd	çŒµ
ycnz	ğ”…°
ycr	ç‰
ycrk	ç¡
ycrks	ğ”Œ§
ycrt	ğ’¥°
ycs	ğ—€¦
ycst	ğ—€‘
ye	çŒ·
yek	ğ–¥²
yel	ğ–¥´
yelz	ğ–¥µ
yenz	ğ–¥¶
yeps	çˆ
yets	ğ–¦ƒ
yez	ğ‘…‰
yi	çŒ¹
yil	ğ–˜¶
yild	ğ’¤²
yildz	ğ—€ƒ
yir	ç€
yirz	ç
yis	ğ–¦’
yist	ç‚
yists	ğ–¦“
yit	ğ–¦”
yits	ğ–¦•
yiz	ğ•¡™
yo	ç–
yod	ğ—€
yok	ç™
yoks	ğ—€“
yokt	ğ—€’
yol	ğ‘•°
yom	ğ—€”
yomz	ğ—€–
yon	è  
yos	èˆ¹
yost	ğ—€‰
yoz	ç¢˜
yu	ã“
yuJ	ã±
yuT	ç§
yuZ	ç…’
yub	ğœ’
yubl	ğ“ ‘
yud	ä‰™
yudz	ğ”‰˜
yug	ğ ·
yugd	ğ ¸
yuk	ğ¡‡
yuks	ğ¡‰
yul	ç¢
yum	ğ“œµ
yumz	ğ“œ¶
yun	ç„¶
yund	ğ“…¤
yunz	ğ“…¥
yur	ç£
yurz	ğ—€¤
yus	ç…
yut	ğ‰¥
yuts	ğ‰¦
yuv	ç¤
yuz	åœƒ
yuzd	ç…€
yx	ãš…
yxl	ä£
yxm	çŠ
yxn	ä„ƒ
yxnd	å¦
yxnz	å„
yxz	ã¥
z	ğ“Š’
z@	ç·
z@d	ğ“¡“
z@f	ğ—‚
z@g	çƒ
z@gd	ğ—ƒ
z@gz	ğ—…
z@k	ç¶
z@ks	ğ“¡
z@kt	ä€
z@kts	ğ‘˜˜
z@l	ğ‘„£
z@m	äƒ
z@mz	ğ‘˜¡
z@n	ã‰¸
z@nd	è¸
z@nk	ğ—
z@np	ğ“‰§
z@nt	ğ–™³
z@nts	ğ—
z@nz	é¡²
z@p	ğ—‘
z@pf	ğ—’
z@ps	ç¸
z@pt	ğ—“
z@r	ğ—–
z@s	ä””
z@t	è‡
z@z	ğ”™¤
zE	å¤£
zEG	ç€
zEd	ğ— 
zEf	ğ™£
zEk	é€–
zEks	ğ‘˜¨
zEl	è…¶
zElt	ğ—¦
zElz	é’
zEm	é¥
zEmb	ğ—§
zEmk	ğ—¨
zEmp	ğ‘˜³
zEmpt	ğ‘˜²
zEmpts	ğ‘˜´
zEn	æ‰“
zEnd	ğ“™¦
zEng	ğ—´
zEnk	ğ—©
zEns	ğ”…ˆ
zEnt	ğ”…†
zEnts	ğ”…‡
zEnz	ğ—°
zEp	ğ•‰–
zEr	é€”
zErd	ğ—•
zErn	ğ¥…
zErz	ğ“‰™
zEs	ğ‘‰
zEst	ğ‘
zEt	é‚ˆ
zEts	ğ•ˆ—
zEv	ğ—³
zEw	ğ“•’
zEz	ğ•¤€
zI	ä†
zIC	ğ—µ
zIG	ãŒ“
zIb	ğ’™µ
zIf	ğ—‚
zIfs	ğ“Œ„
zIg	ç‚
zIgd	ğ‘”•
zIh	é“
zIk	å—
zIks	è·
zIl	è”
zIlC	ğ—‚‚
zIlz	ã•³
zIm	ğ”•‚
zImp	ğ—‚ƒ
zIn	äŒ‡
zInd	ç€‚
zIng	ğ—‚…
zInk	ğ—‚„
zIns	æ„ 
zInsk	ğ‘Œ¦
zInt	å†‘
zInts	æ„¡
zInz	äŒˆ
zIp	ç…‚
zIpf	ğ—‚‡
zIps	ç…
zIpt	ç…ƒ
zIr	è¤©
zIrb	ğ—±
zIrl	ğ– ·
zIrn	ğ—²
zIrz	ğ¤
zIs	æ‰™
zIsk	ğ’™´
zIst	ğ†™
zIsts	ä‘
zIt	ä…¤
zIts	å¤€
zIv	ğ‘˜ƒ
zIz	ãˆ©
zO	ğ“¡•
zOd	ğ•…ˆ
zOl	ğ”–ƒ
zOlz	ğ”–„
zR	ã™
zRbz	ğ—‚ˆ
zRd	åˆƒ
zRdz	å˜ƒ
zRk	ğ–¥¥
zRn	ğ—„ˆ
zRt	ä‘±
zRts	ğ¢’
zRv	ä‘²
zRvd	å¡°
zRvz	ğ¢“
zRz	æ°
zU	è•¨
zUg	ç”¤
zUk	ğ—‚”
zUl	ğ—„‡
zUlk	ğ—„ƒ
zUn	å…“
zUnd	ğ’Œ•
zUr	é€µ
zW	ğ–¥¦
zWn	ğ•„ˆ
zWnd	ğ•„‡
zWndz	ğ—‚™
zWr	ğ”Œ¤
zWt	ğ”˜ 
zY	çŒ¢
zYC	ğ—„
zYd	ğš—
zYdz	è•¤
zYk	ğ—£
zYl	è £
zYld	ğ‘™ˆ
zYlz	ğ‘™
zYm	ğ†–
zYmz	ğ‘”™
zYn	ä‘³
zYnd	ğ¢•
zYnz	ğ¢–
zYr	ä‘´
zYs	ğ—¤
zYsk	ğ—„‘
zYt	ğ‘¡ˆ
zYz	ğ–” 
z^	ç•™
z^C	ğ—„
z^b	é‚
z^d	çš˜
z^dz	ç†
z^f	ğ“Œ‘
z^fs	ğ“Œ
z^g	ç”£
z^gz	ğ—„…
z^h	ğ“• 
z^k	ğ˜¦
z^l	æ‰§
z^ld	ğ€
z^lt	æ‰¦
z^lts	æ‰¨
z^lz	èˆ“
z^m	ç‘—
z^mp	ğ” ·
z^mz	è©
z^n	ç‘¹
z^nd	å€ 
z^ndt	ğ–
z^ndts	ğ–‘
z^ndz	ğ–…¨
z^ng	ğ“¡”
z^nh	ğ‘’
z^ns	ğˆ‚
z^nt	è¥¹
z^nts	ğ”•¤
z^nz	ç’€
z^p	ğ’ §
z^r	ğ”Œ€
z^s	è…·
z^st	ğ–¤–
z^t	ğ‰ 
z^ts	ğ…ƒ
z^v	ğ•„†
z^z	çˆ
za	å¥
zad	ğ“‰‚
zag	ğ’¤ˆ
zak	è™…
zaks	ğ“‰‡
zal	ç”‚
zalv	ç’™
zalvd	ç”€
zalvz	ç”
zalz	ğ””‡
zam	ğ“‰ 
zan	å”±
zand	è¹
zant	ğ”¡–
zanz	è€–
zar	ç¢ƒ
zarb	ğ—”
zard	é‘
zark	ğ””‰
zarks	ğ””
zarn	ğ¥„
zart	ğ‘‚
zarts	ğ”‰
zarz	è•£
zat	ğ“‰
zats	ğ‘•’
zav	é¤²
zaz	ğ•ˆ¸
zc	ğ‘˜¹
zcf	è•¥
zcg	ğ—˜
zcgt	ğ–˜µ
zcl	ä
zcld	ğ–¦‘
zclt	ğ‘˜™
zclts	ğ‘˜ 
zcn	ğ’˜
zcnp	ğ“‰¨
zcr	ã„ 
zcrb	ç”ƒ
zcrbd	ç”„
zcrbz	ç”…
zcrg	ğ”ˆ¶
zcrn	ğ—‚—
zcrnz	ğ—‚˜
zcrp	ç”†
zcrt	ğ‘™‚
zcrts	ğ‘™ƒ
zcrz	è•¦
zcs	ğ‘™€
zcst	ğ‘˜¸
zcsts	ğ‘™
zct	ğ“²
zcv	ğ–¦†
ze	ä„¡
zed	ğ—†
zek	ğ“‰†
zel	è•¢
zelz	ğ—‰
zen	ğ“‚‡
zenz	ã 
zer	ğ“œ
zerz	ğ”´
zesk	ğ——
zet	èƒ
zets	ğ—ˆ
zev	çŒ¡
zez	ğ“Œ€
zi	ã€¥
zib	ğ—¡
zid	é™¡
zig	ğ“”§
zik	è¤
zil	è ¤
zilk	ğ—¶
zim	ğ”Š—
zimk	ğ—·
zimz	ğ”˜“
zin	å™”
zinz	å™•
zirk	ğ—¸
zis	ğ—¢
zisk	ğ—¹
zit	ğ—‚€
zits	ğ—¥
ziv	ğ”¦‘
ziz	ä
zizd	ğ‘€ˆ
zo	ç
zol	ğ–œ”
zold	é€‡
zolf	ğ“¥¡
zolp	ğ—‚‘
zolt	ğ”˜‘
zolz	ğ””‘
zom	ğ€©
zomz	ğ€°
zon	ç‰
zond	ğ—‚’
zonz	ğ—‚“
zop	ğ—‚–
zos	é¥
zoz	ç¡™
zu	ç‡
zub	ğ—„€
zud	ğ‘šˆ
zudz	ğ‘š‰
zug	ğ—„‚
zulk	ğ—„„
zum	ç‘
zumd	ğ” µ
zumz	ğ” ¶
zus	ç
zut	ğ—‚•
zuz	ç’
zx	ä™™
zxl	ã•²
zxlz	æ…¶
zxm	èœ–
zxndz	ç€ƒ
zxnt	ä•ˆ
zxnz	æˆ¨
zxs	å±
zxz	ã…
