unidentifiable	x/nY/dEn/tI/fY/x/bxl
impossibility	Im/pa/sx/bI/lI/ti
czechoslovakia's	CE/kx/slx/va/ki/xz
uncomfortable	xn/k^m/fR/tx/bxl
understandable	^n/dR/st@n/dx/bxl
unfortunately	xn/fcr/CI/nIt/li
investigator	In/vEs/tI/ge/tR
antibiotic	@n/tI/bY/a/tIk
antibiotics	@n/tI/bY/a/tIks
independently	In/dI/pEn/dInt/li
individual	In/dI/vI/Ju/xl
indestructible	In/dIs/tr^k/tx/bxl
accidentally	@k/sI/dEn/tx/li
particularly	pR/tI/kyx/lR/li
personality	pR/sI/n@/lI/ti
cooperating	ko/a/px/re/tIG
coordination	ko/cr/dI/ne/SIn
electricity	x/lEk/trI/sI/ti
electronically	^/lEk/tra/nI/kli
photosynthesis	fo/to/sIn/Tx/sIs
cooperative	ko/a/px/rI/tIv
opportunity	a/pR/tu/nI/ti
electrocuted	x/lEk/trx/kyu/tId
regurgitated	rI/gR/JI/te/tId
immediately	I/mi/di/It/li
disobedient	dI/sx/bi/di/Int
communication	kx/myu/nI/ke/SIn
hippopotamus	hI/px/pa/tx/mxs
refrigerator	rI/frI/Jx/re/tR
telemarketing	tE/lx/mar/kI/tIG
anniversary	@/nI/vR/sx/ri
nickelodeon	nI/kx/lo/di/In
imagination	I/m@/JI/ne/SIn
animosity	@/nI/ma/sI/ti
disinfected	dI/sIn/fEk/tId
inexpensive	I/nEks/pEn/sIv
concentrating	kan/sIn/tre/tIG
condensation	kan/dIn/se/SIn
conversation	kan/vR/se/SIn
entertaining	E/nR/te/nIG
exercises	Ek/sR/sY/zIz
exercising	Ek/sR/sY/zIG
expectations	Ek/spEk/te/SInz
masterpieces	m@/stR/pi/sIz
overflowing	o/vR/flo/IG
entertainment	E/nR/ten/mInt
acceptable	Ek/sEp/tx/bxl
extinguisher	Eks/tIG/gwI/SR
unfortunate	xn/fcr/CI/nIt
overzealous	o/vR/zE/lxs
successfully	sxk/sEs/fx/li
wonderfully	w^n/dR/fx/li
investigate	In/vEs/tI/get
unorganized	x/ncr/gx/nYzd
obviously	ab/vi/I/sli
antisocial	@n/ti/so/Sxl
tasmanian	t@z/me/ni/In
portfolio	port/fo/li/o
malnutrition	m@l/nx/trI/SIn
multicolored	m^l/ti/k^/lRd
actually	@k/Cu/x/li
independent	In/dI/pEn/dInt
infrastructures	In/frx/str^k/CRz
interested	In/tx/rE/stId
interesting	In/tx/rE/stIG
orthodontic	cr/Tx/dan/tIk
orthodontics	cr/Tx/dan/tIks
orthodontist	cr/Tx/dan/tIst
improperly	Im/pra/pR/li
accidently	@k/sI/dEnt/li
congratulate	kxn/gr@/Cx/let
experience	Eks/pI/ri/Ins
ulterior	xl/tI/ri/R
activator	@k/tI/ve/tR
aspirated	@/spI/re/tId
calculator	k@l/kyx/le/tR
circulation	sR/kyx/le/SIn
combination	kam/bI/ne/SIn
complicated	kam/plI/ke/tId
complication	kam/plI/ke/SIn
dandelion	d@n/dx/lY/In
explanation	Eks/plx/ne/SIn
formulated	fcr/myx/le/tId
invitation	In/vI/te/SIn
perspiration	pRs/px/re/SIn
bacteria	b@k/tI/ri/x
victoria	vIk/to/ri/x
absolutely	@b/sx/lut/li
asparagus	xs/p@/rx/gxs
certificate	sR/tI/fI/kIt
conditioner	kxn/dI/SI/nR
conditioning	kxn/dI/SI/nIG
considerate	kxn/sI/dx/rIt
considering	kxn/sI/dx/rIG
discoverer	dIs/k^/vx/rR
experiment	Eks/pE/rI/mInt
impossible	Im/pa/sx/bxl
incredible	In/krE/dx/bxl
invisible	In/vI/zx/bxl
particular	pR/tI/kyx/lR
thermometer	TR/ma/mx/tR
uncovering	xn/k^/vx/rIG
unlimited	xn/lI/mI/tId
altogether	cl/tx/gE/DR
disposition	dIs/px/zI/SIn
expedition	Ek/spx/dI/SIn
activity	@k/tI/vI/ti
conspiracy	kxn/spI/rI/si
discovery	dIs/k^/vx/ri
incredibly	In/krE/dx/bli
infinity	In/fI/nI/ti
ordinary	crd/nx/ri
armadillo	ar/mx/dI/lo
dictionary	dIk/SI/nE/ri
participate	par/tI/sI/pet
angelica	@n/JE/lI/kx
cinderella	sIn/dx/rE/lx
harmonica	har/ma/nI/kx
motorcycle	mo/tR/sY/kxl
electrician	E/lxk/trI/SIn
priority	prY/c/rI/ti
identify	Y/dEn/tI/fY
coordinate	ko/cr/dI/net
ecosystem	i/ko/sI/stxm
radiator	re/di/e/tR
obedient	o/bi/di/Int
dehydrated	di/hY/dre/tId
okeydokey	o/ki/do/ki
roly+poly	ro/li/po/li
baby+sitter	be/bi/sI/tR
resealable	ri/si/lx/bxl
triangular	trY/@G/gyx/lR
universal	yu/nI/vR/sxl
unicycle	ju/nI/saI/kl
nigerians	nY/JI/ri/Inz
diarrhea	dY/x/ri/x
olivia	o/lI/vi/x
rearranging	ri/x/ren/JIG
photogenic	fo/tx/JE/nIk
photographic	fo/tx/gr@/fIk
robitussin	ro/bI/t^/sIn
binoculars	bY/na/kyx/lRz
nutritional	nu/trI/SI/nxl
rhinoceros	rY/na/sx/rxs
cooperate	ko/a/px/ret
alexander	@/lIg/z@n/dR
alexander's	@/lIg/z@n/dRz
emergency	I/mR/JIn/si
accordion	x/kcr/di/In
satisfying	s@/tIs/fY/IG
adjustable	x/J^/stx/bxl
electrical	x/lEk/trI/kxl
reversible	rI/vR/sx/bxl
cholesterol	kx/lEs/tx/rcl
caterpillar	k@/tR/pI/lR
caterpillars	k@/tR/pI/lRz
watermelon	wc/tR/mE/lxn
watermelons	wc/tR/mE/lxnz
catastrophe	kx/t@s/trx/fi
eventually	E/vEn/Cu/x/li
electrolytes	x/lEk/trx/lYts
appliances	x/plY/In/sIz
polyester	pa/li/E/stR
semicircle	sE/mi/sR/kxl
amazingly	x/me/zIG/li
seriously	sI/ri/I/sli
unusual	xn/yu/Zu/xl
appropriate	x/prop/ri/et
cauliflower	kc/lI/flW/R
situation	sI/Cu/e/SIn
pinnochio	pI/no/ki/o
appreciate	x/pri/Si/et
appreciates	x/pri/Si/ets
graduation	gr@/Ju/e/SIn
tapioca	t@/pi/o/kx
awakening	x/we/kx/nIG
emotional	I/mo/SI/nxl
maneuvering	mx/nu/vx/rIG
recyclable	rI/sY/klx/bxl
variable	v@/ri/x/bxl
honeysuckle	h^/ni/s^/kxl
illusory	I/lu/zx/ri
variety	vx/rY/I/ti
anybody	E/ni/b^/di
everybody	E/vri/ba/di
communicate	kx/myu/nI/ket
everybody's	Ev/ri/ba/diz
anorexic	@/nx/rEk/sIk
helicopter	hE/lI/kap/tR
apparently	x/pe/rInt/li
definitely	dE/fI/nIt/li
regularly	rEg/yx/lR/li
aquarium	x/kwE/ri/xm
aggravated	@/grx/ve/tId
aggravating	@/grx/ve/tIG
alligator	@/lI/ge/tR
ballerinas	b@/lx/ri/nxz
celebrating	sE/lx/bre/tIG
decoration	dE/kx/re/SIn
decorations	dE/kx/re/SInz
european	yU/rx/pi/In
fascinated	f@/sI/ne/tId
fascinating	f@/sI/ne/tIG
fascination	f@/sI/ne/SIn
generations	JE/nx/re/SInz
illustrated	I/lx/stre/tId
imitating	I/mI/te/tIG
innovative	I/nx/ve/tIv
irritated	I/rI/te/tId
irritating	I/rI/te/tIG
operator	a/px/re/tR
pacifier	p@/si/fYr
pacifiers	p@/sI/fYrz
preparation	prE/px/re/SIn
purifier	pyU/rI/fYr
stimulated	stI/myx/le/tId
stimulating	stI/myx/le/tIG
terrorizing	tE/rx/rY/zIG
traumatizing	trc/mx/tY/zIG
macaroni	m@/kx/ro/ni
minestrone	mI/nI/stro/ni
ballerina	b@/lx/ri/nx
galleria	g@/lx/ri/x
hallelujah	h@/lx/lu/yx
jeremiah	JE/rx/mY/x
disappointing	dI/sx/pOn/tIG
adorable	x/do/rx/bxl
belligerent	bx/lI/JI/rInt
elizabeth	x/lI/zx/bxT
imagining	I/m@/JI/nIG
refrigerant	rI/frI/Jx/rInt
ridiculous	rI/dI/kyx/lIs
traditional	trx/dI/SI/nxl
irritable	I/rI/tx/bxl
miserable	mI/zx/rx/bxl
automatic	c/tx/m@/tIk
definition	dE/fI/nI/SIn
demolition	dE/mx/lI/SIn
television	tE/lx/vI/ZIn
apology	x/pa/lx/Ji
artillery	ar/tI/lx/ri
especially	E/spE/Sx/li
officially	x/fI/Sx/li
philosophy	fI/la/sx/fi
avocado	@/vx/ka/do
military	mI/lI/tE/ri
necessary	nE/sI/sE/ri
solidified	sx/lI/dI/fYd
evaporate	E/v@/px/ret
automobile	c/tx/mx/bil
avocados	@/vx/ka/doz
america	x/mE/rI/kx
absorbent	xb/zcr/bInt
accepted	Ek/sEp/tId
acknowledge	@k/na/lIJ
acknowledged	@k/na/lIJd
adventure	@d/vEn/CR
concentric	kxn/sEn/trIk
congestion	kxn/JEs/CIn
disgusted	dIs/g^/stId
disgusting	dIs/g^/stIG
distracted	dI/str@k/tId
distracting	dI/str@k/tIG
distraction	dIs/tr@k/SIn
entrapment	En/tr@p/mInt
exalted	Eg/zcl/tId
expected	Ek/spEk/tId
expecting	Ek/spEk/tIG
expensive	Eks/pEn/sIv
external	Eks/tR/nxl
extracted	Ek/str@k/tId
fantastic	f@n/t@s/tIk
important	Im/pcr/txnt
infection	In/fEk/SIn
infections	In/fEk/SInz
inflicting	In/flIk/tIG
insistent	In/sIs/tInt
instructions	In/str^k/SInz
invented	In/vEn/tId
performer	pR/fcr/mR
performing	pR/fcr/mIG
persistent	pR/sIs/tInt
september	sEp/tEm/bR
suspender	sxs/pEn/dR
suspenders	sx/spEn/dRz
sylvester	sIl/vE/stR
baptism	b@p/tI/zxm
comfortable	k^m/fR/tx/bxl
comforter	k^m/fR/tR
comforting	k^m/fR/tIG
ordering	cr/dx/rIG
rambling	r@m/bx/lIG
sorcerer	scr/sx/rR
ticklish	tI/kxl/IS
tumbling	t^m/bx/lIG
wandering	wan/dx/rIG
whispering	wI/spx/rIG
wonderful	w^n/dR/fxl
basketball	b@/skIt/bcl
basketballs	b@/skIt/bclz
discontent	dIs/kxn/tEnt
fingerprints	fIG/gR/prInts
handlebars	h@n/dxl/barz
internet	In/tR/nEt
mastercard	m@/stR/kard
silverware	sIl/vR/wer
smorgasbord	smor/gxs/bord
tenderness	tEn/dR/nIs
timberland	tIm/bR/l@nd
turtleneck	tR/txl/nEk
underarm	^n/dR/arm
undershirt	^n/d@/St
understand	^n/dR/st@nd
understood	^n/dR/stUd
underwear	^n/dR/wer
blockbuster	blak/b^/stR
hamburger	h@m/bR/gR
malfunction	m@l/f^Gk/SIn
midmorning	mId/mcr/nIG
chimpanzee	CIm/p@n/zi
exactly	Eg/z@kt/li
certainly	sR/txn/li
comfortably	k^m/fR/tx/bli
endlessly	End/lI/sli
infantry	In/fxn/tri
instantly	In/stInt/li
perfectly	pR/fIkt/li
practically	pr@k/tI/kli
symphony	sIm/fx/ni
tickly	tI/kxl/I
bumblebee	b^m/bxl/bi
yesterday	yEs/tR/de
afternoon	@f/tR/nun
bumblebees	b^m/bxl/biz
concentrate	kan/sIn/tret
entertained	E/nR/tend
exercise	Ek/sR/sYz
fingernail	fIG/gR/nel
fingernails	fIG/gR/nelz
underneath	^n/dR/niT
advises	@d/vY/zIz
complaining	kxm/ple/nIG
completed	kxm/pli/tId
computer	kxm/pyu/tR
confusing	kxn/fyu/zIG
container	kxn/te/nR
containers	kxn/te/nRz
controller	kxn/tro/lR
dalmatian	d@l/me/SIn
dalmatians	d@l/me/SInz
disposal	dIs/po/zxl
excited	Ek/sY/tId
exciting	Ek/sY/tIG
exploded	Ek/splo/dId
explosion	Eks/plo/ZIn
impatient	Im/pe/SInt
including	In/klu/dIG
invited	In/vY/tId
inviting	In/vY/tIG
mistaken	mIs/te/kxn
surprising	sR/prY/zIG
survivor	sR/vY/vR
actual	@k/Cu/xl
argument	ar/gyx/mInt
calcium	k@l/sixm
earlier	R/li/R
fiftieth	fIf/ti/IT
hungrier	h^G/gri/R
indian	In/di/In
indians	In/di/Inz
influence	In/flu/Ins
scorpion	skcr/pi/In
handyman	h@n/di/m@n
windowsill	wIn/do/sIl
arguing	arg/yu/IG
frustrated	fr^/stre/tId
frustrating	fr^/stre/tIG
lawn+mower	lcn/mo/R
leftover	lEf/to/vR
leftovers	lEf/to/vRz
lopsided	lap/sY/dId
october	ak/to/bR
push+overs	pU/So/vRz
salvation	s@l/ve/SIn
sunflower	s^n/flW/R
sunflowers	s^n/flW/Rz
wallpaper	wcl/pe/pR
wind+breaker	wInd/bre/kR
completely	kxm/plit/li
volcano	vcl/ke/no
parcheesi	par/Ci/zi
unruly	^n/ru/li
orioles	o/ri/olz
india	In/di/x
convenience	kxn/vi/nyIns
excitement	Ek/sYt/mInt
surrounded	sx/rWn/dId
rectangle	rEk/t@G/gxl
entirely	En/tYr/li
extremely	Ek/strim/li
ambitious	@m/bI/SIs
consider	kxn/sI/dR
discover	dIs/k^/vR
discovered	dI/sk^/vRd
discussion	dIs/k^/SIn
embarrassed	Em/b@/rIst
encourage	En/kR/rIJ
exhibits	Eg/zI/bIts
exploring	Ek/splo/rIG
expression	Eks/prE/SIn
fitzgerald	fIts/JE/rxld
forever	fx/rE/vR
gonzales	gxn/za/lEs
ignoring	Ig/no/rIG
macdonald	mxk/da/nxld
mcdonald	mxk/da/nxld
mcdonalds	mxk/da/nxldz
mcgregor	mx/grE/gR
mcmuffin	mxk/m^/fIn
permission	pR/mI/SIn
suspicious	sxs/pI/SIs
unbuckle	xn/b^/kxl
unbuckled	xn/b^/kxld
unbutton	xn/b^/txn
uncover	xn/k^/vR
unpacking	xn/p@/kIG
unpleasant	xn/plE/zInt
unplugging	xn/pl^/gIG
accident	@k/sI/dInt
answering	@n/sx/rIG
article	ar/tI/kxl
articles	ar/tI/kxlz
averaging	@v/rI/JIG
benjamin	bEn/Jx/mIn
cardinal	kar/dI/nxl
cardinals	kar/dI/nxlz
circular	sR/kyx/lR
confident	kan/fI/dInt
emperor's	Em/px/rRz
excellent	Ek/sx/lInt
exodus	Ek/sx/dxs
fixable	fIk/sx/bxl
furniture	fR/nI/CR
hospital	has/pI/txl
ignorance	Ig/nx/rIns
instrument	In/strx/mInt
instruments	In/strx/mInts
maximum	m@k/sI/mxm
necklaces	nE/klI/sIz
octopus	ak/tx/pxs
ornaments	cr/nx/mInts
personal	pR/sI/nxl
popsicle	pap/sI/kxl
practicing	pr@k/tI/sIG
principle	prIn/sI/pxl
questioning	kwEs/CI/nIG
sensitive	sEn/sI/tIv
strengthening	strEGk/Tx/nIG
technical	tEk/nI/kxl
temperature	tEm/px/rx/CR
torturing	tcr/Cx/rIG
vegetable	vEJ/tx/bxl
vegetables	vEJ/tx/bxlz
wondering	w^n/dx/rIG
alcohol	@l/kx/hcl
alphabet	@l/fx/bEt
alphabets	@l/fx/bEts
baltimore	bcl/tI/mcr
interrupt	In/tx/r^pt
laundromat	lcn/drx/m@t
margarine	mar/Jx/rIn
multiple	m^l/tI/pxl
octagon	ak/tx/gan
pentagon	pEn/tx/gan
personnel	pR/sI/nEl
restaurant	rE/stx/rant
barefooted	ber/fU/tId
dish+washer	dIS/wc/SR
forbidden	fcr/bI/dxn
forgetting	fcr/gE/tIG
godmother	gad/m^/DR
grandmother	gr@nd/m^/DR
grasshopper	gr@s/ha/pR
hard+headed	hard/hE/dId
horseradish	hcrs/r@/dIS
nutcracker	n^t/kr@/kR
sunglasses	s^n/gl@/sIz
zigzagging	zIg/z@/gIG
unhappy	xn/h@/pi
continue	kxn/tI/nyu
balcony	b@l/kx/ni
blustery	bl^/stx/ri
carefully	ker/fx/li
century	sEn/Cx/ri
clumsily	kl^m/zI/li
company	k^m/px/ni
constantly	kan/stInt/li
contrary	kxn/trE/ri
horribly	hc/rx/bli
injury	In/Jx/ri
innocent	I/nx/sInt
mystery	mIs/tx/ri
normally	ncr/mx/li
nursery	nR/sx/ri
technically	tEk/nI/kx/li
barbecue	bar/bx/kyu
bungalow	b^G/gx/lo
corduroy	kcr/dx/rO
indigo	In/dI/go
already	cl/rE/di
blackberry	bl@k/bE/ri
cranberry	kr@n/bE/ri
granddaddy	gr@nd/d@/di
mulberry	m^l/bE/ri
raspberry	r@z/bE/ri
somebody	s^m/b^/di
continued	kxn/tIn/yud
absolute	@b/sx/lut
cantaloupe	k@n/tx/lop
centipede	sEn/tI/pid
envelope	En/vx/lop
envelopes	En/vx/lops
hercules	hR/kyx/liz
introduced	In/trx/dust
marmalade	mar/mx/led
organize	cr/gx/nYz
organized	cr/gx/nYzd
porcupine	pcr/kyx/pYn
substitute	s^b/stI/tut
synthesized	sIn/Tx/sYzd
tambourine	t@m/bx/rin
tangerines	t@n/Jx/rinz
turnaround	tR/nx/rWnd
velveteen	vEl/vx/tin
versatile	vR/sI/txl
blackberries	bl@k/bE/riz
marshmallows	marS/mE/loz
somebody's	s^m/b^/diz
antenna	@n/tE/nx
umbrella	xm/brE/lx
formula	fcr/myx/lx
bandana	d^//nR
godzilla	gad/zI/lx
flavorful	fle/vR/fxl
ironing	Yr/nIG
opener	o/px/nR
opening	o/px/nIG
powerful	pW/R/fxl
quietness	kwY/It/nIs
seasoning	si/zI/nIG
neighborhood	ne/bR/hUd
overalls	o/vR/clz
overboard	o/vR/bord
paper+work	pe/pR/wRk
superman	su/pR/m@n
tablecloth	te/bxl/klcT
cucumbers	kyu/k^m/bRz
cucumber	kyu/k^m/bR
gigantic	JY/g@n/tIk
november	no/vEm/bR
utensil	yu/tEn/sxl
utensils	yu/tEn/sxlz
beautifully	byu/tI/fx/li
neighborly	ne/bR/li
quietly	kwY/It/li
seemingly	si/mIG/li
usually	yuZ/u/x/li
overflow	o/vR/flo
motorbike	mo/tR/bYk
overload	o/vR/lod
overnight	o/vR/nYt
overtime	o/vR/tYm
tablespoon	te/bxl/spun
creative	kri/e/tIv
cranium	kre/ni/xm
easier	i/zi/R
medium	mi/di/xm
nutrient	nu/tri/Int
premiums	pri/mi/xmz
sodium	so/di/xm
tiniest	tY/ni/Ist
usual	yu/Zu/xl
sleepy+head	sli/pI/hed
daydreaming	de/dri/mIG
profiling	pro/fY/lIG
reunion	ri/yu/nyIn
screwdriver	skru/drY/vR
shoelaces	Su/le/sIz
teenager	tin/e/JR
vacation	ve/ke/SIn
radio	re/di/o
studio	stu/di/o
tokyo	to/ki/o
crybaby	krY/be/bi
ohio	o/hY/o
ponytail	po/ni/tel
relocate	ri/lo/ket
julia	Jul/yx
hyena	hY/i/nx
isaiah	Y/ze/x
teaspoonfuls	ti/spun/fxlz
triangle	trY/@G/gxl
triangles	trY/@G/gxlz
becoming	bI/k^/mIG
beginning	bx/gI/nIG
beautiful	byu/tI/fxl
bicycle	bY/sI/kxl
breakable	bre/kx/bxl
crocuses	kro/kx/sIz
favorite	fe/vx/rIt
favorites	fe/vx/rIts
hydrogen	hY/drx/JIn
lunatic	lu/nI/tIk
musical	myu/zI/kxl
notices	no/tI/sIz
noticing	no/tI/sIG
poisonous	pOz/In/Is
quieter	kwY/I/tR
tricycle	trY/sI/kxl
tylenol	tY/lx/ncl
vehicle	vi/I/kxl
violence	vY/x/lIns
violent	vY/x/lInt
violet	vY/x/lIt
vitamin	vY/tx/mIn
vitamins	vY/tx/mInz
dialect	dY/x/lEkt
dinosaur	dY/nI/scr
reassured	ri/x/SUrd
theodore	Ti/x/dcr
uniforms	yu/nI/fcrmz
universe	yu/nI/vRs
violin	vY/x/lIn
beautician	byu/tI/SIn
eyeglasses	Y/gl@/sIz
flyswatter	flY/swc/tR
nutritious	nu/trI/SIs
pineapple	pY/n@/pxl
pineapples	pY/n@/pxlz
whoever	hu/E/vR
piano	pi/@/no
easily	i/zx/li
finally	fY/nx/li
nobody	no/bx/di
peony	pi/x/ni
totally	to/tx/li
blueberry	blu/bE/ri
library	lY/brE/ri
primary	prY/mE/ri
groceries	gro/sI/riz
nobody's	no/bx/diz
peonies	pi/x/niz
boomerang	bu/mx/r@G
gatorade	ge/tx/red
microphone	mY/krx/fon
microphones	mY/krx/fonz
microwave	mY/kro/wev
realized	ri/x/lYzd
rearrange	ri/x/renJ
styrofoam	stY/rx/fom
xylophone	zY/lx/fon
blueberries	blu/bE/riz
koala	ko/a/lx
omega	o/mE/gx
counter+top	kWn/tR/tap
cheese+burger	Ciz/bR/gR
mailboxes	mel/bak/sIz
handkerchiefs	h@G/kR/CIfs
foundation	fWn/de/SIn
lifesavers	lYf/se/vRz
newspaper	nuz/pe/pR
outrageous	Wt/re/JIs
dangerous	den/Jx/rxs
maintenance	men/tI/nIns
roadrunner	ro/dr^/nR
toothbrushes	tuT/br^/SIz
counselor	kWn/sx/lR
gracefully	gres/fx/li
gratefully	gret/fx/li
hopefully	hop/fx/li
kangaroo	k@G/gx/ru
potpourri	po/pU/ri
gooseberry	gus/bE/ri
kangaroos	k@G/gx/ruz
adjustment	x/J^s/tmInt
apartment	x/par/tmInt
assemble	x/sEm/bxl
asserting	x/sR/tIG
assistance	x/sIs/tIns
assortment	x/scrt/mInt
attention	x/tEn/SIn
attractive	x/tr@k/tIv
collection	kx/lEk/SIn
commanded	kx/m@n/dId
commander	kx/m@n/dR
commercial	kx/mR/Sxl
december	dI/sEm/bR
defender	dI/fEn/dR
deliver	dx/lI/vR
destructive	dIs/tr^k/tIv
detergent	dI/tR/JInt
determine	dI/tR/mIn
determined	dI/tR/mInd
direction	dI/rEk/SIn
directions	dI/rEk/SInz
disaster	dI/z@s/tR
domestic	dx/mEs/tIk
electric	x/lEk/trIk
enormous	I/ncr/mxs
equipment	I/kwIp/mInt
eternal	i/tR/nxl
familiar	fx/mI/lyR
italian	I/t@l/yIn
neglecting	nx/glEk/tIG
offensive	x/fEn/sIv
opinion	x/pI/nyIn
pavilion	px/vIl/i/In
prescription	prIs/krIp/SIn
prescriptions	prI/skrIp/SInz
pretending	prI/tEn/dIG
protected	prx/tEk/tId
protecting	prx/tEk/tIG
protection	prx/tEk/SIn
protesting	prx/tE/stIG
recorded	rI/kcr/dId
recorder	rI/kcr/dR
recording	rI/kcr/dIG
reflection	rI/flEk/SIn
refraction	rI/fr@k/SIn
regarding	rI/gar/dIG
rejected	rI/JEk/tId
relaxing	rx/l@k/sIG
remember	rx/mEm/bR
remembered	rx/mEm/bRd
remembers	rx/mEm/bRz
reported	rI/por/tId
resistant	rI/zIs/tInt
responding	rI/span/dIG
retarded	rI/tar/dId
returning	rI/tR/nIG
reversal	rI/vR/sxl
sebastian	sx/b@s/CIn
suggestion	sx/JEs/CIn
addicted	x/dIk/tId
repairman	rI/per/m@n
calendar	k@/lIn/dR
challenging	C@/lIn/JIG
character	k@/rxk/tR
characters	k@/rxk/tRz
clattering	kl@/tx/rIG
colorful	k^/lR/fxl
coloring	k^/lx/rIG
differences	dI/fx/rIn/sIz
gentleman	JEn/txl/mxn
jiggling	JI/gx/lIG
juggling	J^/gx/lIG
littler	lI/tx/lR
littlest	lI/tx/lIst
meddlesome	mE/dxl/sxm
meddling	mE/dx/lIG
medicine's	mE/dI/sInz
oranges	c/rIn/JIz
orangish	c/rIn/JIS
passenger	p@/sIn/JR
popular	pa/pyx/lR
puckering	p^/kx/rIG
punishment	p^/nIS/mInt
register	rE/JIs/tR
registered	rE/JI/stRd
rustling	r^/sx/lIG
several	sE/vx/rxl
shimmering	SI/mx/rIG
shoveling	S^/vx/lIG
slobbering	sla/bx/rIG
applesauce	@/pxl/scs
butternut	b^/t@/n^t
hollywood	ha/li/wUd
mockingbird	ma/kIG/bRd
motherland	m^/DR/l@nd
somersault	s^/mR/sclt
somersaults	s^/mR/sclts
stickleback	stI/kl/b@k
tupperware	t^/pR/wer
volunteer	va/lxn/tir
waterfall	wc/tR/fcl
aplenty	x/plEn/ti
correctly	kx/rEkt/li
flamingo	flx/mIG/go
cavalry	k@/vx/lri
energy	E/nR/Ji
heavenly	hE/vxn/li
honestly	a/nIst/li
magically	m@/JI/kli
properly	pra/pR/li
seventy	sE/vIn/ti
suddenly	s^/dxn/li
butterfly	b^/tRf/lY
dragonfly	dr@/gxn/flY
mistletoe	mI/sxl/to
satisfy	s@/tIs/fY
saturday	s@/tR/de
waterloo	wc/tR/lu
peroxide	px/rak/sYd
butterflies	b^/tR/flYz
cottontail	ka/txn/tel
dinnertime	dI/nR/tYm
otherwise	^/DR/wYz
recognize	rE/kxg/nYz
satisfied	s@/tIs/fYd
seventeen	sE/vIn/tin
seventeenth	sE/vIn/tinT
summertime	s^/mR/tYm
valentine	v@/lIn/tYn
valentines	v@/lIn/tYnz
valentine's	v@/lIn/tYnz
vaseline	va/sx/lin
magenta	mx/JEn/tx
miranda	mI/r@n/dx
samantha	sx/m@n/Tx
agreeing	x/gri/IG
amazing	x/me/zIG
amusing	x/myu/zIG
annoying	x/nO/IG
arriving	x/rY/vIG
careening	kx/ri/nIG
dakota's	dx/ko/txz
decided	dI/sY/dId
deleting	dx/li/tIG
destroying	dI/strO/IG
devotion	dI/vo/SIn
enjoying	En/JO/IG
occasion	x/ke/ZIn
parading	px/re/dIG
procedure	prx/si/JR
provider	prx/vY/dR
recycling	rI/sY/kx/lIG
related	rx/le/tId
retriever	rI/tri/vR
borrowing	ba/ro/IG
bullying	bU/li/IG
carrying	k@/ri/IG
cereal	sI/ri/xl
cereals	sI/ri/xlz
chillier	CI/li/R
curious	kyU/ri/xs
following	fa/lo/IG
funniest	f^/ni/Ist
furious	fyU/ri/xs
glorious	glo/ri/Is
happiest	h@/pi/Ist
happiness	h@/pi/nIs
heavier	hE/vi/R
idiot	I/di/It
lillian	lI/li/In
period	pI/ri/xd
prettier	prI/ti/R
samuel	s@/myu/xl
serious	sI/ri/xs
sillier	sI/li/R
skinnier	skI/ni/R
steadier	stE/di/R
studying	st^/di/IG
visual	vI/Zu/xl
warrior	wc/rir
anymore	E/ni/mor
anyone	E/ni/w^n
anything	E/ni/TIG
anywhere	E/ni/wer
everyone	E/vri/w^n
everything	E/vri/TIG
everything's	Ev/ri/TIGz
everywhere	E/vri/wer
hollyhock	ha/li/hak
jelly+fish	JE/li/fIS
lollipop	la/li/pap
pussycat	pU/si/k@t
storybook	sto/ri/bUk
volleyball	va/li/bcl
baloney	bx/lo/ni
mosquito	mxs/ki/to
potato	px/te/to
tomato	tx/me/to
bologna	bx/lo/ni
marino	mx/ri/no
alfredo	@l/fre/do
cheerio	tSI@/rI/@U
grocery	gro/sI/ri
patio	p@/ti/o
video	vI/di/o
anyhow	E/ni/hW
anyway	E/ni/we
disobey	dI/sx/be
stereo	stE/ri/o
mosquitos	mx/ski/toz
cheerios	Ci/ri/oz
videos	vI/di/oz
anytime	E/ni/tYm
anyways	E/ni/wez
copyright	ka/pi/rYt
halloween	h@/lx/win
dakota	dx/ko/tx
elijah	x/lY/Jx
granola	grx/no/lx
jemima	Jx/mY/mx
papaya	px/pY/x
theresa	tx/ri/sx
vagina	vx/JY/nx
area	e/ri/x
joshua	Ja/Su/x
lydia	lI/di/x
amazement	x/mez/mInt
appointment	x/pOnt/mInt
arranging	x/ren/JIG
policeman	px/lis/mxn
reminding	rx/mYn/dIG
politely	px/lYt/li
aggressive	x/grE/sIv
aladin	l@//dIn
another	x/n^/DR
apparent	x/pe/rInt
appearance	x/pi/rIns
attaches	@/tx/Sez
attacking	x/t@/kIG
bananas	bx/n@/nxz
decisions	dI/sIZ/Inz
delicious	dx/lI/SIs
deposit	dI/pa/zIt
dramatic	drx/m@/tIk
eleven	x/lE/vIn
eleventh	x/lE/vInT
enamel	E/n@/mxl
galoshes	gx/la/SIz
gorillas	gx/rI/lxz
imagine	I/m@/JIn
official	x/fI/Sxl
pajamas	px/Ja/mxz
position	px/zI/SIn
professor	prx/fE/sR
propeller	prx/pE/lR
recovered	rI/k^/vRd
religious	rx/lI/JIs
republic	rI/p^b/lIk
terrific	tx/rI/fIk
together	tx/gE/DR
whenever	wEn/E/vR
african	@/frI/kxn
animal	@/nI/mxl
animals	@/nI/mxlz
awfully	c/fx/li
beverage	bE/vx/rIJ
bothering	ba/Dx/rIG
buttoning	b^/tI/nIG
cabinet	k@/bI/nIt
cabinets	k@/bI/nIts
cameras	k@/mx/rxz
chocolate	Cc/kx/lIt
christening	krI/sI/nIG
christopher	krI/stx/fR
cigarette	sI/gx/rEt
covering	k^/vx/rIG
decibels	dE/sx/bxlz
difficult	dI/fI/kxlt
donovan	da/nx/vxn
edible	E/dx/bxl
elegant	E/lx/gxnt
elephant	E/lx/fInt
elephants	E/lx/fxnts
elephant's	E/lx/fInts
fabulous	f@/byx/lxs
finishing	fI/nI/SIG
follicles	fa/lI/kxlz
foraging	fc/rI/JIG
genesis	JE/nI/sIs
gibberish	JI/bx/rIS
happening	h@/px/nIG
hollering	ha/lx/rIG
horrible	hc/rx/bxl
katherine	k@/TrIn
listening	lI/sI/nIG
lyricists	lI/rI/sIsts
magical	m@/JI/kxl
measuring	mEZ/x/rIG
medicine	mE/dI/sIn
messages	mE/sI/JIz
modeling	ma/dx/lIG
monitor	ma/nI/tR
natural	n@/Cx/rxl
nautilus	nc/tI/lxs
negative	nE/gx/tIv
opposite	a/px/zIt
opposites	a/px/zIts
pegasus	pE/gx/sIs
pitiful	pI/tI/fxl
platinum	pl@/tI/nxm
positive	pa/zI/tIv
possible	pa/sx/bxl
prisoner	prI/zI/nR
privilege	prI/vx/lIJ
promises	pra/mI/sIz
quivering	kwI/vx/rIG
regular	rE/gyx/lR
scattering	sk@/tx/rIG
scheduling	skE/JU/lIG
solomon	sa/lx/mxn
staticky	st@/tI/ki
supplement	s^p/lx/mInt
talkative	tc/kx/tIv
terrible	tE/rx/bxl
traveler	tr@/vx/lR
traveling	tr@/vx/lIG
vinegar	vI/nx/gR
visiting	vI/zI/tIG
watering	wc/tx/rIG
wearable	we/rx/bxl
wrestling	rE/sx/lIG
apricot	@/prI/kat
apricots	@/prI/kats
autograph	c/tx/gr@f
catalogs	k@/tx/lcgz
catalogue	k@/tx/lcg
cinnamon	sI/nx/mxn
daffodil	d@/fx/dIl
daffodils	d@/fx/dIlz
disappear	dI/sx/pir
disappeared	dI/sx/pird
sonogram	sa/nx/gr@m
wherever	we/rE/vR
whatever	w^t/E/vR
karate	kx/ra/ti
salami	sx/la/mi
spaghetti	spx/gE/ti
tomorrow	tx/ma/ro
battery	b@/tx/ri
brittany	brI/tI/ni
broccoli	bra/kx/li
celery	sE/lx/ri
comedy	ka/mI/di
coppery	k0/p@/rI
emily	E/mI/li
enemy	E/nI/mi
family	f@/mx/li
feathery	fE/Dx/ri
finicky	fI/nI/ki
gradually	gr@/Ju/x/li
gravity	gr@/vI/ti
gregory	grE/gx/ri
happily	h@/px/li
hickory	hI/kx/ri
italy	I/tx/li
jeremy	JE/rx/mi
luckily	l^/kI/li
melanie	mE/lx/ni
memory	mE/mx/ri
merrily	mE/rI/li
misery	mI/zx/ri
policy	pa/lI/si
probably	pra/bx/bli
quality	kwa/lI/ti
raggedy	r@/gI/di
remedy	rE/mx/di
rubbery	r^/bx/ri
sesame	sE/sx/mi
slippery	slI/px/ri
stephanie	stE/fx/ni
terribly	tE/rx/bli
timothy	tI/mx/Ti
watery	wc/tx/ri
zachary	z@/kx/ri
alibi	@/lx/bY
avenue	@/vx/nu
faraway	fa/rx/we
glorify	glo/rI/fY
holiday	ha/lI/de
runaway	r^/nx/we
strawberry	strc/bE/ri
tomorrow's	tx/ma/roz
batteries	b@/tx/riz
calories	k@/lx/riz
families	f@m/liz
abigail	@/bI/gel
appetite	@/pI/tYt
attitude	@/tI/tud
celebrate	sE/lx/bret
civilized	sI/vI/lYzd
crocodile	kra/kx/dYl
crocodiles	kra/kx/dYlz
generate	JE/nx/ret
glorified	glo/rI/fYd
imitates	I/mI/tets
irritate	I/rI/tet
magazine	m@/gx/zin
magazines	m@/gx/zinz
navigate	n@/vI/get
paranoid	p@/rx/nOd
regulate	rE/gyx/let
separate	sE/px/ret
telephone	tE/lx/fon
telephones	tE/lx/fonz
telephone's	tE/lx/fonz
strawberries	strc/bE/riz
banana	bx/n@/nx
gorilla	gx/rI/lx
iguana	I/gwa/nx
melissa	mx/lI/sx
pajama	px/Ja/mx
vanilla	vx/nI/lx
chihuahua	CI/wa/wa
africa	@/frI/kx
camera	k@/mx/rx
canada	k@/nI/dx
deborah	dE/bx/rx
monica	ma/nI/kx
concerned	kxn/sRnd
concerns	kxn/sRnz
content	kxn/tEnt
contents	kxn/tEnts
control	kxn/trol
controlled	kxn/trold
controls	kxn/trolz
discuss	dIs/k^s
discussed	dI/sk^st
distracts	dI/str@kts
disturb	dIs/tRb
exact	Eg/z@kt
except	Ek/sEpt
excess	Ek/sEs
exists	Eg/zIsts
expect	Eks/pEkt
explore	Eks/plor
express	Eks/prEs
herself	hR/sElf
himself	hIm/sElf
hisself	hIz/sElf
ignore	Ig/nor
impressed	Im/prEst
inform	In/fcrm
informed	In/fcrmd
insist	In/sIst
instead	In/stEd
intense	In/tEns
intent	In/tEnt
invent	In/vEnt
involved	In/valvd
itself	It/sElf
midwest	mId/wEst
obsessed	xb/sEst
percent	pR/sEnt
perhaps	pR/h@ps
respect	rIs/pEkt
response	rIs/pans
uncurl	xn/kRl
undressed	xn/drEst
unfair	xn/fer
unhook	xn/hUk
unless	xn/lEs
unlocked	xn/lakt
unplug	xn/pl^g
unplugged	xn/pl^gd
unstrap	^n/str@p
until	xn/tIl
unzip	xn/zIp
upstairs	xp/sterz
yourself	yUr/sElf
acting	@k/tIG
action	@k/SIn
active	@k/tIv
actor	@k/tR
after	@f/tR
agnes	@g/nIs
answer	@n/sR
answered	@n/sRd
answers	@n/sRz
arches	ar/CIz
arthur	ar/TR
backing	b@/kIG
bantam	b@n/txm
barber	bar/bR
barking	bar/kIG
bashful	b@S/fxl
basket	b@s/kIt
baskets	b@/skIts
belches	bEl/CIz
bended	bEn/dId
bending	bEn/dIG
better	bE/tR
biscuits	bI/skIts
blinking	blIG/kIG
boarded	bor/dId
booger	bU/gR
boring	bo/rIG
boxes	bak/sIz
branches	br@n/CIz
breakfast	brEk/fxst
brendan	brEn/dIn
brilliant	brI/lyInt
bringing	brIG/IG
brooklyn	brU/klIn
building	bIl/dIG
buildings	bIl/dIGz
bumbling	b^m/blIG
bumper	b^m/pR
bumping	b^m/pIG
bundle	b^n/dxl
bunting	b^n/tIG
burning	bR/nIG
burping	bR/pIG
business	bIz/nIs
busted	b^/stId
buster	b^s/tR
cactus	k@k/tIs
calling	kc/lIG
campbell	k@m/bxl
camping	k@m/pIG
cancel	k@n/sxl
candle	k@n/dxl
candles	k@n/dxlz
captain	k@p/tIn
careful	ker/fxl
carmen	kar/mxn
carpet	kar/pIt
carton	kar/txn
center	sEn/tR
charming	Car/mIG
cheerful	Cir/fxl
chester	CE/stR
children	CIl/drIn
chilling	CI/lIG
chirping	CR/pIG
christmas	krI/smxs
circle	sR/kxl
circled	sR/kxld
circles	sR/kxlz
circus	sR/kxs
clearance	kli/rIns
clearer	kli/rR
clinking	klIG/kIG
comfort	k^m/fRt
concept	kan/sEpt
concert	kan/sRt
constant	kan/stInt
corner	kcr/nR
cornish	kcr/nIS
couldn't	kU/dxnt
courting	kor/tIG
crinkles	krIG/kxlz
crinkling	krIG/klIG
critter	krI/tR
crumble	kr^m/bxl
crusted	kr^s/tId
crystals	krI/stxlz
current	kR/rInt
curtain	kR/txn
curtains	kR/txnz
cymbals	sIm/bxlz
dances	d@n/sIz
dancing	d@n/sIG
daniel	d@n/yxl
darling	dar/lIG
didn't	dI/dxnt
dillon	dI/lxn
dimples	dIm/pxlz
doctor	dak/tR
doctor's	dak/tRz
doesn't	d^/zxnt
dolphins	dcl/fInz
dreadful	drEd/fxl
drinking	drIG/kIG
drunken	dr^G/kxn
ducklings	d^/klIGz
dumping	d^m/pIG
dumpling	d^m/plIG
dungeon	d^n/JIn
earring	ir/rIG
earrings	ir/rIGz
edges	E/JIz
edward	Ed/wRd
ellis	E/lIs
ended	En/dId
engine	En/JIn
english	IG/glIS
enter	En/tR
entered	En/tRd
entrance	En/trIns
fallen	fc/lxn
falling	fc/lIG
farmer	far/mR
farmer's	far/mRz
farted	far/tId
farther	far/DR
filling	fI/lIG
finger	fIG/gR
fingers	fIG/gRz
fixes	fIk/sIz
fixing	fIk/sIG
flirting	flR/tIG
forcing	for/sIG
forward	fcr/wRd
foxes	fck/sIz
friction	frIk/SIn
frosting	frc/stIG
fumble	f^m/bxl
further	fR/DR
garbage	gar/bIJ
garden	gar/dxn
garland	gar/lxnd
garlic	gar/lIk
garrett	g@/rIt
gentle	JEn/txl
gerber	gR/bR
getting	gE/tIG
girded	gR/dId
girder	gR/dR
goodness	gUd/nIs
gordon	gcr/dIn
gorgeous	gcr/JIs
grunted	gr^n/tId
grunting	gr^n/tIG
hadn't	h@/dxnt
handed	h@n/dId
handle	h@n/dxl
handled	h@n/dxld
handsome	h@n/sxm
harder	har/dR
hardest	har/dIst
harmless	harm/lIs
harvest	har/vIst
hasn't	h@/zInt
haven't	h@/vxnt
hearing	hi/rIG
helmet	hEl/mIt
helper	hEl/pR
helpful	hElp/fxl
helping	hEl/pIG
helter	hEl/tR
honking	hcG/kIG
horner	hcr/nR
horses	hcr/sIz
hundred	h^n/drId
hundreds	h^n/drIdz
hunting	h^n/tIG
hurting	hR/tIG
husband	h^z/bxnd
hymnal	hIm/nxl
inches	In/CIz
inching	In/CIG
infant	In/fxnt
inning	I/nIG
interest	In/tx/rIst
isn't	I/zInt
itches	I/CIz
itching	I/CIG
it'd	I/tId
it'll	I/txl
jasmine	J@z/mIn
jingle	JIG/gxl
jingles	JIG/gxlz
jordan	Jcr/dxn
jordan's	Jcr/dxnz
jumble	J^m/bxl
jumper	J^m/pR
jumping	J^m/pIG
jungle	J^G/gxl
kansas	k@n/zxs
ketchup	kE/Cxp
killing	kI/lIG
kingdom	kIG/dxm
landed	l@n/dId
landing	l@n/dIG
landings	l@n/dIGz
lantern	l@n/tRn
latches	l@/CIz
learning	lR/nIG
lifting	lIf/tIG
lobster	lab/stR
lobsters	lab/stRz
london	l^n/dxn
longer	lcG/gR
longest	lcG/gIst
luster	l^s/tR
madman	m@d/mxn
magnet	m@g/nIt
magnets	m@g/nIts
marble	mar/bxl
marshalls	mar/Sxlz
master	m@s/tR
matches	m@/CIz
matching	m@/CIG
melted	mEl/tId
melting	mEl/tIG
mention	mEn/SIn
merchant	mR/CInt
million	mI/lyIn
millions	mIl/yxnz
mixer	mIk/sR
mixing	mIk/sIG
monster	man/stR
monsters	man/stRz
monstrous	mans/trIs
morgan	mor/gIn
morgan's	mor/gInz
morning	mor/nIG
mumbling	m^m/blIG
mustard	m^s/tRd
napkin	n@p/kIn
napkins	n@p/kInz
nearer	ni/rR
necklace	nEk/lIs
nervous	nR/vxs
nesting	nE/stIG
normal	ncr/mxl
number	n^m/bR
numbers	n^m/bRz
nursing	nR/sIG
options	ap/SInz
order	cr/dR
ordered	cr/dRd
orphan	cr/fxn
ostrich	as/trIC
pamper	p@m/pR
pampers	p@m/pRz
panther	p@n/TR
panting	p@n/tIG
pardon	par/dxn
parlor	par/lR
parsnips	par/snIps
parting	par/tIG
partner	part/nR
pencil	pEn/sxl
pencils	pEn/sxlz
penguin	pEG/gwIn
penguins	pEGg/wInz
perfect	pR/fEkt
person	pR/sIn
phillip	fI/lIp
picnic	pIk/nIk
pictures	pIk/CRz
piglet	pIg/lIt
piglets	pI/glIts
pinching	pIn/CIG
planted	pl@n/tId
plastic	pl@s/tIk
practice	pr@k/tIs
pregnant	prEg/nInt
pretzel	prEt/sxl
pretzels	prEt/sxlz
printed	prIn/tId
pumpkin	p^m/pkIn
pumpkins	p^mp/kInz
punkin	p^G/kIn
purchase	pR/CIs
purple	pR/pxl
purpose	pR/pxs
quarter	kwcr/tR
quarters	kwcr/tRz
question	kwEs/CIn
ramble	r@m/bxl
rascal	r@s/kxl
renting	rEn/tIG
resting	rE/stIG
ringer	rI/GR
ringing	rIG/IG
rinsing	rIn/sIG
romper	ram/pR
rumbling	r^m/blIG
sample	s@m/pxl
sampling	s@m/px/lIG
sandal	s@n/dxl
sandals	s@n/dxlz
sandwich	s@n/dwIC
santas	s@n/txz
scamper	sk@m/pR
scramble	skr@m/bxl
scrambled	skr@m/bxld
scrumptious	skr^m/pSIs
seltzer	sElt/sR
sending	sEn/dIG
serpent	sR/pInt
service	sR/vIs
serving	sR/vIG
shepherd	SE/pRd
shorter	Scr/tR
signal	sIg/nxl
silver	sIl/vR
simple	sIm/pxl
singing	sIG/IG
sister	sIs/tR
sisters	sI/stRz
sister's	sI/stRz
skelter	skEl/tR
slumber	sl^m/bR
slumbers	sl^m/bRz
smallness	smcl/nIs
smarter	smar/tR
smartest	smar/tIst
snorting	sncr/tIG
softest	scf/tIst
sorted	scr/tId
sorter	scr/tR
sparkle	spar/kxl
specter	spEk/tR
spectrum	spEk/trxm
splendid	splEn/dId
splendor	splEn/dR
sponges	sp^n/JIz
sprinkler	sprIG/klR
squinting	skwIn/tIG
squirming	skwR/mIG
squirted	skwR/tId
squirting	skwR/tIG
stalking	stc/kIG
standing	st@n/dIG
started	star/tId
starting	star/tIG
startle	star/txl
startled	star/txld
starving	star/vIG
stinker	stIG/kR
stinking	stIG/kIG
stitches	stI/CIz
stomping	stam/pIG
stringing	strIG/IG
stronger	strcG/R
suction	s^k/SIn
surface	sR/fIs
swinging	swIG/IG
system	sIs/txm
tantrum	t@n/trxm
tantrums	t@n/trxmz
target	tar/gIt
temper	tEm/pR
tending	tEn/dIG
testing	tE/stIG
that'll	D@/txl
thinking	TIG/kIG
thoughtful	Tct/fxl
thumper	T^m/pR
thunder	T^n/dR
thundered	T^n/dRd
tickler	tI/klR/
tickling	tI/kx/lIG
tilted	tIl/tId
timber	tIm/bR
timbers	tIm/bRz
tinkle	tIG/kxl
toddler	tad/lR
tortoise	tcr/tIs
tractor	tr@k/tR
tumble	t^m/bxl
tumbled	t^m/bxld
tumbles	t^m/bxlz
turning	tR/nIG
turtle	tR/txl
turtles	tR/txlz
twinkle	twIG/kxl
twister	twIs/tR
twisting	twI/stIG
uncle	^G/kxl
uncles	^G/kxlz
under	^n/dR
urchins	R/CInz
version	vR/ZIn
versus	vR/sIs
walters	wcl/tRz
wandered	wan/dRd
wanted	w^n/tId
wanting	w^n/tIG
warmer	wcr/mR
warming	wcr/mIG
warning	wcr/nIG
wasn't	w^/zInt
weirdest	wir/dIst
welcome	wEl/kxm
whisker	wIs/kR
whiskers	wI/skRz
whisper	wIs/pR
whispered	wI/spRd
william	wIl/yxm
wilted	wIl/tId
winter	wIn/tR
wonder	w^n/dR
wondered	w^n/dRd
wonders	w^n/dRz
working	wR/kIG
worship	wR/SIp
wrinkled	rIG/kxld
wrinkles	rIG/kxlz
yearling	yR/lIG
yonder	yan/dR
younger	y^G/gR
back+door	b@k/dor
back+wash	b@/kwcS
backyard	b@/kyard
barbells	bar/bElz
barefoot	ber/fUt
bath+tub	b@T/t^b
batman	b@t/m@n
black+bird	bl@k/bRd
black+birds	bl@k/bRdz
block+head	blak/hEd
bull+frog	bUl/frcg
cardboard	kard/bord
checkbook	CEk/bUk
chipmunks	CIp/m^Gks
cobweb	ka/bwEb
cobwebs	kab/wEbz
contact	kan/t@kt
crisscross	krI/skrcs
doorbell	dor/bEl
doorknob	dor/nab
dustpan	d^st/p@n
eardrum	ir/dr^m
farmyard	farm/yard
football	fUt/bcl
footprints	fUt/prInts
forehead	for/hEd
forget	fcr/gEt
forgets	fcr/gEts
forgive	fcr/gIv
forgot	fcr/gat
fuss+pot	f^S/pat
girl+friend	gRl/frEnd
grandad	gr@n/d@d
grandma's	gr@nd/maz
grandpas	gr@nd/paz
grandpa's	gr@nd/paz
hairbrush	her/br^S
haircut	her/k^t
handbook	h@nd/bUk
headband	hEd/b@nd
hedgehog	hEJ/hcg
hog+wash	hcg/waS
income	In/k^m
indoors	In/dorz
input	In/pUt
israel	Iz/ril
knapsack	n@p/s@k
muskrats	m^/skr@ts
mustache	m^/st@S
ourself	ar/sElf
pass+word	p@/swRd
popcorn	pap/kcrn
princess	prIn/sEs
redhead	rEd/hEd
sandman	
sixpence	sIk/spEns
soft+ware	scf/twer
softball	scft/bcl
someone	s^/mw^n
someone's	s^m/w^nz
something	s^m/TIG
something's	s^m/TIGz
somewhat	s^/mwat
somewhere	s^/mwer
starfish	star/fIS
steadfast	stEd/f@st
sultan	s^l/tIn
sunburn	s^n/bRn
suntan	s^n/t@n
sweat+pants	swEt/p@nts
sweatshirt	swE/tSRt
sweatshirts	swE/tSRts
syndrome	sIn/drom
tarzan	tar/z@n
themselves	DEm/sElvz
therefore	Der/for
thumb+tacks	T^m/t@ks
tomcat	tam/k@t
undone	^n/d^n
uphill	xp/hIl
upset	^p/sEt
washcloth	wcS/klcT
washcloths	wcS/klcTs
whirlwind	wR/lwInd
zigzag	zIg/z@g
ziploc	zI/plak
although	cl/Do
destroy	dIs/trO
enjoy	En/JO
july	JU/lY
shampoo	S@m/pu
unscrew	xn/skru
untie	xn/tY
algae	@l/Ji
also	cl/so
andy	@n/di
army	ar/mi
auntie	@n/ti
badly	b@d/li
bambi	b@m/bi
barbie	bar/bi
barely	ber/li
barkley	bar/kli
barley	bar/li
barney	bar/ni
belly	bE/li
betty	bE/ti
billy	bI/li
bingo	bIG/go
birdie	bR/di
boogie	bU/gi
bookie	bU/ki
bully	bU/li
bumpy	b^m/pi
bunny	b^/ni
burrow	bR/ro
candy	k@n/di
charlie	Car/li
cheery	Ci/ri
chili	CI/li
chilly	CI/li
chimney	CIm/ni
chunky	C^G/ki
clumpy	kl^m/pi
clunky	kl^G/ki
comfy	k^m/fi
corny	kcr/ni
cosby	kcz/bi
country	k^n/tri
crinkly	krIG/kli
crispy	krI/spi
crusty	kr^s/ti
cuddly	k^d/li
curly	kR/li
curvy	kR/vi
dandy	d@n/di
dirty	dR/ti
disney	dIz/ni
donkey	dcG/ki
dumpty	d^mp/ti
early	R/li
elmo	El/mo
empty	Em/pti
entry	En/tri
ernie	R/ni
fairly	fer/li
fairy	fe/ri
fancy	f@n/si
fifty	fIf/ti
filthy	fIl/Ti
firmly	fRm/li
forty	fcr/ti
friendly	frEn/dli
frilly	frI/li
frisbee	frIz/bi
frosty	frcs/ti
furry	fR/ri
gently	JEnt/li
girlie	gR/li
glory	glo/ri
grumpy	gr^m/pi
grundy	gr^n/di
guilty	gIl/ti
handy	h@n/di
hardly	hard/li
healthy	hEl/Ti
henry	hEn/ri
humpty	h^mp/ti
hungry	h^G/gri
hurry	hR/ri
into	In/tu
itchy	I/Ci
itty	wI/tI
junky	J^G/ki
kidney	kId/ni
laundry	lcn/dri
lefty	lEf/ti
lingo	lIG/go
lovely	l^v/li
lumpy	l^m/pi
mandy	m@n/di
mercy	mR/si
milky	mIl/ki
monkey	m^G/ki
murphy	mR/fi
nasty	n@s/ti
nearly	nir/li
nellie	nE/li
nilly	nI/li
nixie	nIk/sI
pantry	p@n/tri
party	par/ti
pearly	pR/li
pepsi	pEp/si
pesky	pEs/ki
pinky	pI9/kI
plenty	plEn/ti
prickly	prIk/li
punky	p^G/ki
puppy	p^/pi
quickly	kwI/kli
quincy	kwIn/si
sadly	s@d/li
sandy	s@n/di
sexy	sEk/si
shelby	SEl/bi
shortly	Scrt/li
sidney	sId/ni
silky	sIl/ki
simply	sIm/pli
sixty	sIk/sti
slinky	slIG/ki
softly	scft/li
sparky	spar/ki
stingy	stIn/Ji
stinky	stIG/ki
stormy	stcr/mi
sturdy	stR/di
surely	SUr/li
taxi	t@k/si
thirsty	TRs/ti
thirty	TR/ti
thorny	Tcr/ni
tootsie	tUt/si
turkey	tR/ki
twenty	twEn/ti
twisty	twIs/ti
ugly	^g/li
waldo	wcl/do
whitney	wIt/ni
wiggly	wIg/li
window	wIn/do
windy	wIn/di
wrinkly	rIG/kli
argue	ar/gyu
bamboo	b@m/bu
banjo	b@n/Jo
birthday	bRT/de
bongo	baG/go
condo	kan/do
doorway	dor/we
earache	i/rek
elbow	El/bo
goodbye	gUd/bY
hairdo	her/du
halfway	h@f/we
hallway	hcl/we
monday	m^n/de
nearby	nir/bY
onto	an/tu
pinto	pIn/to
rescue	rEs/kyu
scarecrow	sker/kro
someday	s^m/de
somehow	s^m/hW
sunday	s^n/de
survey	sR/ve
thursday	TRz/de
tiptoe	tIp/to
tomboy	tam/bO
undo	^n/du
velcro	vEl/kro
wednesday	wEnz/de
weirdo	wir/do
alright	cl/rYt
balloon	bx/lun
balloons	bx/lunz
complain	kxm/plen
complains	kxm/plenz
complete	kxm/plit
confuse	kxn/fyuz
confused	kxn/fyuzd
contain	kxn/ten
contains	kxn/tenz
despise	dIs/pYz
disguised	dIs/gYzd
dispose	dIs/poz
divine	dI/vYn
enjoyed	En/JOd
entire	En/tY/R
escape	Es/kep
escaped	E/skept
estate	Es/tet
excuse	Eks/kyus
exposed	Ek/spozd
fifteenth	fIf/tinT
implies	Im/plYz
increase	In/kris
indeed	In/did
inside	In/sYd
inspire	In/spYr
invites	In/vYts
jerome	Jx/rom
mistake	mIs/tek
mistreat	mI/strit
obtained	xb/tend
perfume	pR/fyum
restrain	rIs/tren
succeed	sxk/sid
survive	sR/vYv
unfold	xn/fold
untied	xn/tYd
unused	xn/yuzd
barbies	bar/biz
barney's	bar/niz
bellies	bE/liz
boogies	bU/giz
bookies	bU/kiz
bunnies	b^/niz
crunchy	kr^n/Ci
disney's	dIz/niz
donkeys	daG/kiz
fifteen	fIf/tin
fortune	fcr/CIn
hostile	has/txl
kerchief	kR/CIf
mercies	mR/siz
monkeys	m^G/kiz
panties	p@n/tiz
sydney's	sId/niz
taxis	t@k/siz
thingies	TIG/iz
turkeys	tR/kiz
undies	^n/diz
windows	wIn/doz
airline	er/lYn
airplane	er/plen
almost	cl/most
always	c/lwez
armhole	^m/h@Ul
background	b@k/grWnd
ball+game	bcl/gem
bath+room	b@/Trum
bath+rooms	b@/Trumz
bed+room	bE/drum
bedtime	bEd/tYm
bongos	baG/goz
bookcase	bUk/kes
car+seat	kar/sit
cartoon	kar/tun
cartoons	kar/tunz
checkout	CE/kWt
combine	kam/bYn
condos	kan/doz
cornfield	kcrn/fild
cupcake	k^p/kek
doghouse	dcg/hWs
earthquake	RT/kwek
elbows	El/boz
fish+bowl	fIS/bol
flashlight	fl@S/lYt
forsake	fcr/sek
fourteen	for/tin
fourteenth	for/tinT
good+night	gUd/nYt
head+phones	hEd/fonz
headache	hE/dek
heartbeat	hart/bit
lunchtime	l^nC/tYm
melt+down	mElt/dWn
membrane	mEm/bren
mermaid	mR/med
midnight	mId/nYt
mushroom	m^/Srum
mushrooms	m^S/rumz
neckties	nEk/tYz
online	an/lYn
pancake	p@n/kek
pancakes	p@n/keks
pigtail	pIg/tel
pipsqueak	pIp/skwik
porthole	port/hol
rescued	rEs/kyud
rescues	rEs/kyuz
sixteen	sIks/tin
sixteenth	sIks/tinT
someplace	s^m/ples
sometime	s^m/tYm
sometimes	s^m/tYmz
springtime	sprIG/tYm
standpoint	st@n/dpOnt
sun+screen	s^n/skrin
sun+screens	s^n/skrinz
sunshine	s^n/SYn
swimsuit	swIm/sut
thirteen	TR/tin
tiptoed	tIp/tod
tiptoes	tIp/toz
touchdowns	t^C/dWnz
translate	tr@ns/let
trombone	tram/bon
upside	^p/sYd
upstream	^p/strim
uptown	^p/tWn
utmost	^t/most
vampire	v@m/pYr
windshield	wInd/Sild
wishbone	wIS/bon
work+place	wRk/ples
work+room	wR/krUm
workout	wR/kWt
alpha	@l/fx
brenda	brEn/dx
extra	Eks/trx
georgia	Jcr/Jx
grandma	gr@/ma
linda	lIn/dx
marcher	mar/CR
marches	mar/CIz
margaret	mar/grIt
marker	mar/kR
markers	mar/kRz
market	mar/kIt
marking	mar/kIG
martha	mar/Tx
ninja	nIn/Jx
panda	p@n/dx
salsa	scl/sx
santa	s@n/tx
tonka	taG/kx
tonya	tan/yx
grandpa	gr@m/pa
able	e/bxl
acre	e/kR
apron	e/prxn
bacon	be/kxn
baker	be/kR
baker's	be/kRz
basic	be/sIk
basics	be/sIks
basil	b@/zxl
bathing	be/DIG
beaten	bi/txn
beaters	bi/tRz
beating	bi/tIG
beatrix	bi/trIks
beavers	bi/vRz
beeper	bi/pR
beetle	bi/txl
beetles	bi/txlz
bible	bY/bxl
biting	bY/tIG
bleaching	bli/CIG
bleated	bli/tId
blooming	blu/mIG
blowing	blo/IG
bogus	bo/gxs
boiling	bO/lIG
bowing	bW/IG
braiding	bre/dIG
breaking	bre/kIG
breather	bri/DR
breathing	bri/DIG
brian	brY/In
brighter	brY/tR
broken	bro/kxn
buying	bY/IG
cable	ke/bxl
cases	ke/sIz
ceiling	si/lIG
ceilings	si/lIGz
chafing	Ce/fIG
chases	Ce/sIz
chasing	Ce/sIG
chewing	Cu/IG
choices	CO/sIz
choking	Co/kIG
cider	sY/dR
cleaner	kli/nR
cleanest	kli/nIst
cleaning	kli/nIG
climber	klY/mR
climbing	klY/mIG
closer	klo/sR
closes	klo/zIz
closest	klo/sIst
closing	klo/zIG
clouding	klW/dIG
clover	klo/vR
combing	ko/mIG
cooler	ku/lR
cooling	ku/lIG
coupon	ku/pan
coupons	ku/panz
cradle	kre/dxl
creature	kri/CR
creatures	kri/CRz
crowded	krW/dId
crying	krY/IG
cutest	kyu/tIst
cycle	sY/kxl
david	de/vId
davis	de/vIs
decent	di/sInt
deepest	di/pIst
dialing	dY/lIG
diamond	dY/mxnd
diamonds	dY/mxndz
diaper	dY/pR
diapers	dY/pRz
diet	dY/It
dining	dY/nIG
diving	dY/vIG
doing	du/IG
doodle	du/dxl
doting	do/tIG
dover	do/vR
drainage	dre/nIJ
dreaming	dri/mIG
driver	drY/vR
driving	drY/vIG
drooling	dru/lIG
dryer	drYr
drying	drY/IG
dueling	du/x/lIG
dying	dY/IG
easter	i/stR
eaten	i/txn
eater	i/tR
eating	i/tIG
eden	i/dxn
either	i/DR
even	i/vxn
evening	iv/nIG
evil	i/vxl
faces	fe/sIz
facing	fe/sIG
faker	fe/kR
faking	fe/kIG
famous	fe/mxs
favor	fe/vR
feeder	fi/dR
feeding	fi/dIG
fever	fi/vR
fiber	fY/bR
fighter	fY/tR
fighting	fY/tIG
flavor	fle/vR
flavored	fle/vRd
floating	flo/tIG
flowing	flo/IG
fluids	flu/Idz
flyer	flYr
flying	flY/IG
fooling	fu/lIG
freaking	fri/kIG
freedom	fri/dxm
freezer	fri/zR
frightened	frY/txnd
frozen	fro/zIn
frying	frY/IG
future	fyu/CR
gazing	ge/zIG
genius	Ji/nyxs
giant	JY/Int
goading	go/dIG
goers	go/Rz
going	go/IG
gracious	gre/SIs
grater	gre/tR
gratings	gre/tIGz
grayish	gre/IS
greatest	gre/tIst
groaning	gro/nIG
grover	gro/vR
growing	gro/IG
hated	he/tId
hating	he/tIG
heated	hi/tId
heater	hi/tR
heating	hi/tIG
hiding	hY/dIG
higher	hYr
highest	hY/Ist
hikers	hY/kRz
hoping	ho/pIG
howling	hW/lIG
huber	hyu/bR
human	hyu/mxn
humor	hyu/mR
hydrant	hY/drInt
hyper	hY/pR
iron	Y/Rn
ironed	Yrnd
isaac	Y/zIk
island	Y/lxnd
island's	Y/lxndz
items	Y/txmz
jacob	Je/kxb
jacob's	Je/kxbz
jesus	Ji/zxs
jewish	Ju/IS
joking	Jo/kIG
joseph	Jo/sIf
joyful	JO/fxl
juices	Ju/sIz
junior	Ju/nyR
keaton	ki/txn
keeper	ki/pR
keeping	ki/pIG
kneeling	ni/lIG
label	le/bxl
labels	le/bxlz
later	le/tR
latest	le/tIst
laying	le/IG
leader	li/dR
leading	li/dIG
leaking	li/kIG
leaning	li/nIG
leaving	li/vIG
lever	li/vR
lighted	lY/tId
lighter	lY/tR
liking	lY/kIG
lining	lY/nIG
lion	lY/xn
lions	lY/xnz
liter	li/tR
loosen	lu/sIn
loosens	lu/sInz
losing	lu/zIG
lotion	lo/SIn
louder	lW/dR
lower	lo/R
luis	lu/Is
luther	lu/TR
lying	lY/IG
lysol	lY/scl
making	me/kIG
maple	me/pxl
mason	me/sIn
mayor	me/R
meeting	mi/tIG
michael	mY/kxl
michael's	mY/kxlz
moaning	mo/nIG
molar	mo/lR
moment	mo/mInt
moments	mo/mInts
moses	mo/zIz
motive	mo/tIv
motor	mo/tR
mouses	mW/sIz
mouthing	mW/DIG
moving	mu/vIG
mower	mo/R
mowing	mo/IG
muses	myu/zIz
music	myu/zIk
naked	ne/kId
nathan	ne/Txn
nation	ne/SIn
nations	ne/SInz
neatest	ni/tIst
needed	ni/dId
needing	ni/dIG
needle	ni/dxl
neighbor	ne/bR
neighbors	ne/bRz
neighbor's	ne/bRz
neither	ni/DR
neutral	nu/trxl
nicest	nY/sIst
noah's	no/xz
noises	nO/zIz
noodle	nu/dxl
noodles	nu/dxlz
noses	no/zIz
notice	no/tIs
noticed	no/tIst
nuisance	nu/sIns
ocean	o/SIn
open	o/pxn
opened	o/pxnd
opens	o/pxnz
outer	W/tR
oval	o/vxl
over	o/vR
owner	o/nR
pager	pe/JR
pages	pe/JIz
paging	pe/JIG
paper	pe/pR
papers	pe/pRz
patience	pe/SIns
patient	pe/SInt
patients	pe/SInts
paying	pe/IG
payment	pe/mInt
peaches	pi/CIz
peeing	pi/IG
peeling	pi/lIG
peeping	pi/pIG
people	pi/pxl
people's	pi/pxlz
peter	pi/tR
peter's	pi/tRz
pieces	pi/sIz
piping	pY/pIG
places	ple/sIz
planing	ple/nIG
player	ple/R
playful	ple/fxl
playing	ple/IG
poison	pO/zIn
poking	po/kIG
polar	po/lR
poodle	pu/dxl
pooping	pu/pIG
poser	po/zR
potent	po/txnt
pouting	pW/tIG
powder	pW/dR
power	pW/R
private	prY/vxt
protest	pro/tEst
proving	pru/vIG
quiet	kwY/It
races	re/sIz
racing	re/sIG
railing	re/lIG
raining	re/nIG
raisin	re/zIn
raising	re/zIG
raisins	re/zInz
raven	re/vxn
ravens	re/vInz
raying	re/IG
raymond	re/mxnd
razor	re/zR
reaches	ri/CIz
reaching	ri/CIG
reading	rE/dIG
reason	ri/zIn
rhyming	rY/mIG
riders	rY/dRz
riding	rY/dIG
roaming	ro/mIG
roller	ro/lR
rolling	ro/lIG
roofing	rU/fIG
roses	ro/zIz
router	rW/tR
rover	ro/vR
ruin	ru/In
ryan	rY/In
safer	se/fR
safest	se/fIst
sailing	se/lIG
sailor	se/lR
sailors	se/lRz
saving	se/vIG
savings	se/vIGz
saying	se/IG
science	sY/Ins
scooping	sku/pIG
scooter	sku/tR
scooting	sku/tIG
scraping	skre/pIG
screaming	skri/mIG
screecher	skri/tSR
screwy	skru/i
season	si/zIn
seasons	si/zInz
secret	si/krIt
secrets	si/krIts
seeing	si/IG
sewer	so/R
sewing	so/IG
shaking	Se/kIG
shielded	Sil/dId
shining	SY/nIG
shoeless	Su/lIs
shooting	Su/tIG
shouted	SW/tId
shouting	SW/tIG
shower	SW/R
showing	So/IG
signing	sY/nIG
silence	sY/lIns
silent	sY/lInt
siren	sY/rIn
sizes	sY/zIz
skating	ske/tIG
sleeper	sli/pR
sleeping	sli/pIG
sliding	slY/dIG
slouching	slW/CIG
slower	slo/R
smiling	smY/lIG
smoother	smu/DR
sneaking	sni/kIG
sneezes	sni/zIz
sneezing	sni/zIG
snowing	sno/IG
soaking	so/kIG
sodas	so/dxz
sooner	su/nR
speaker	spi/kR
speaking	spi/kIG
spices	spY/sIz
spider	spY/dR
spraying	spre/IG
spying	spY/IG
squeaker	skwi/kR
squeaking	skwi/kIG
squeezing	skwi/zIG
stable	ste/bxl
staples	ste/pxlz
station	ste/SIn
staying	ste/IG
steven	sti/vxn
straighten	stre/txn
straightened	stre/txnd
straightens	stre/txnz
straining	stre/nIG
stupid	stu/pId
styling	stY/lIG
stylish	stY/lIS
super	su/pR
susan	su/zIn
sweeping	swi/pIG
sweetest	swi/tIst
swollen	swo/lIn
table	te/bxl
taken	te/kxn
taking	te/kIG
taping	te/pIG
tasted	te/stId
tasting	te/stIG
teacher	ti/CR
teacher's	ti/CRz
teasing	ti/zIG
teething	ti/DIG
thousand	TW/zInd
throwing	Tro/IG
tiger	tY/gR
tigers	tY/gRz
tighter	tY/tR
timer	tY/mR
timing	tY/mIG
tiny	tY/ni
tiring	tY/rIG
toilet	tO/lIt
tooting	tu/tIG
totem	to/txm
tower	tW/R
towers	tW/Rz
training	tre/nIG
trousers	trW/zRz
trying	trY/IG
tubing	tu/bIG
tulip	tu/lIp
tulips	tu/lIps
tying	tY/IG
typing	tY/pIG
unit	yu/nIt
uses	yu/sIz
using	yu/zIG
viper	vY/pR
wafer	we/fR
wafers	we/fRz
waited	we/tId
waiting	we/tIG
waking	we/kIG
wasted	we/stId
wasting	we/stIG
waving	we/vIG
weasel	wi/zxl
weaving	wi/vIG
whining	wY/nIG
wider	wY/dR
wipers	wY/pRz
wiping	wY/pIG
writing	rY/tIG
xavier	zev/yR
yogurt	yo/gRt
zealand	zi/lxnd
zebras	zi/brxz
zooming	zu/mIG
ahab	e/h@b
blowup	blo/^p
crayon	kre/an
crayons	kre/anz
day+care	de/ker
detour	di/tur
doughnut	do/n^t
doughnuts	do/n^ts
eyeball	Y/bcl
eyeglass	Yg/l@s
haystack	he/st@k
haystacks	he/st@ks
high+chair	hY/Cer
ideas	Y/di/xz
keyboard	ki/bord
kleenex	kli/nEks
makeup	me/k^p
myself	mY/sElf
neon	ni/an
newborns	nu/bcrnz
newport	nu/port
nowhere	no/wer
paycheck	pe/CEk
peanut	pi/n^t
peanuts	pi/n^ts
playoffs	ple/cfs
playpen	ple/pEn
playtex	ple/tEks
program	pro/gr@m
rebuild	ri/bIld
refill	ri/fIl
replant	ri/pl@nt
repot	ri/pat
sea+shells	si/SElz
seagulls	si/g^lz
seashore	si/Sor
shoestring	Su/strIG
shoestrings	Su/strIGz
snowballs	sno/bclz
snowman	sno/m@n
snowmen	sno/mEn
teapot	ti/pat
toucan	tu/k@n
tripod	trY/pad
weekend	wi/kEnd
yukon	yu/kan
meow	mi/W
baby	be/bi
bailey	be/li
beady	bi/di
beauty	byu/ti
bony	bo/ni
booty	bu/ti
chewy	Cu/i
cloudy	klW/di
cozy	ko/zi
crazy	kre/zi
creamy	kri/mi
creepy	kri/pi
croaky	kr@U/kI
cutie	kyu/ti
daily	de/li
daisy	de/zi
doozy	du/zi
downie	dW/ni
downy	dW/ni
dreamy	dri/mi
droopy	dru/pi
easy	i/zi
facie	fe/si
frutti	fru/ti
genie	Ji/ni
gloomy	glu/mi
goofy	gu/fi
goopy	gu/pI
gravy	gre/vi
greasy	gri/si
greedy	gri/di
grouchy	grW/Ci
gucci	gu/Ci
halo	he/lo
hayley	he/li
hokey	ho/ki
holy	ho/li
icy	Y/si
ivy	Y/vi
jodie	Jo/di
joey	Jo/i
judy	Ju/di
juicy	Ju/si
julie	Ju/li
katie	ke/ti
katy	ke/ti
kiki	ki/ki
kiwi	ki/wi
lady	le/di
lazy	le/zi
leafy	li/fi
lucy	lu/si
maybe	me/bi
meanie	mi/ni
meaty	mi/ti
mighty	mY/ti
mikey	mY/ki
moody	mu/di
movie	mu/vi
navy	ne/vi
neato	ni/to
nightie	nY/ti
ninety	nYn/ti
noisy	nO/zi
nosey	n@U/zI
pasty	pes/ti
phony	fo/ni
photo	fo/to
pokey	po/ki
pony	po/ni
posy	po/zi
pouty	pW/ti
rainy	re/ni
really	ri/x/li
rightie	rY/ti
roomy	ru/mi
rosie	ro/zi
rosy	ro/zi
ruby	ru/bi
shady	Se/di
shaky	Se/ki
shiny	SY/ni
sleepy	sli/pi
slimy	slY/mi
slowly	slo/li
smiley	smY/li
smoky	smo/ki
sneaky	sni/ki
snowy	sno/i
soapy	so/pi
sophie	so/fi
soupy	su/pi
speedy	spi/di
spicy	spY/si
squeaky	skwi/ki
stacy	ste/si
susie	su/zi
suzy	su/zi
sweetie	swi/ti
tasty	tes/ti
teenie	ti/ni
teeny	ti/ni
tofu	to/fu
truly	tru/li
tutti	tu/ti
weepy	wi/pi
wheeling	wi/lIG
wily	wY/li
yuli	yu/li
bobo	bo/bo
booboo	bu/bu
chico	Ci/ko
cocoa	ko/ko
cowboy	kW/bO
eyebrow	Y/brW
fido	fY/do
friday	frY/de
lego	lE/go
nino	ni/no
obey	o/be
ok	o/ke
okay	o/ke
polo	po/lo
psycho	sY/ko
redo	ri/du
relay	ri/le
tutu	tu/tu
tyco	tY/ko
weewee	wi/wi
yoyo	yo/yo
babies	be/biz
baby's	be/biz
booties	bu/tiz
brownies	brW/niz
ladies	le/diz
lady's	le/diz
movies	mu/viz
ouchies	W/Ciz
sweeties	swi/tiz
wheaties	wi/tiz
chichi's	Ci/Ciz
chinese	CY/niz
daytime	de/tYm
eighteen	e/tin
email	i/mel
eyebrows	Y/brWz
eyesight	Y/sYt
homemade	ho/med
legos	lE/goz
levis	li/vYz
mayonnaise	me/x/nez
mobile	mo/bil
playground	ple/grWnd
playhouse	ple/hWs
playroom	ple/rum
playtime	ple/tYm
produce	pra/dus
protein	pro/tin
realize	ri/x/lYz
repaint	ri/pent
routine	ru/tin
seafood	si/fud
shoelace	Su/les
snowflakes	sno/fleks
teaspoon	tis/pun
throughout	Tru/Wt
toenail	to/nel
toenails	to/nelz
unique	yu/nik
wipe+out	wY/pWt
china	CY/nx
coca	ko/kx
cola	ko/lx
judah	Ju/dx
kayla	ke/lx
lima	li/mx
lisa	li/sx
lola	lo/lx
noah	no/x
pina	pin/yx
pizza	pit/sx
scuba	sku/bx
sheila	Si/lx
soda	so/dx
sofa	so/fx
tuna	tu/nx
zebra	zi/brx
idea	Y/di/x
seesaw	si/sc
ancient	en/CInt
angel	en/Jxl
angels	en/Jxlz
angle	@G/gxl
ankle	@G/kxl
ankles	@G/kxlz
banging	b@G/IG
basement	bes/mInt
blanket	bl@G/kIt
blankets	bl@G/kIts
booster	bus/tR
bouncer	bWn/sR
bounces	bWn/sIz
bouncing	bWn/sIG
bounder	bWn/dR
bracelet	bres/lIt
brightness	brYt/nIs
changes	Cen/JIz
changing	Cen/JIG
coaster	kos/tR
coasters	ko/stRz
colder	kol/dR
coleman	kol/mxn
counter	kWn/tR
counting	kWn/tIG
faithful	feT/fxl
feeling	fi/lIG
feelings	fi/lIGz
finding	fYn/dIG
folded	fol/dId
folding	fol/dIG
fountain	fWn/txn
golden	gol/dIn
grateful	gret/fxl
grinding	grYn/dIG
growling	grW/lIG
hanger	h@/GR
hangers	h@G/Rz
hanging	h@G/IG
holder	hol/dR
holding	hol/dIG
hopeful	hop/fxl
language	l@G/gwIJ
lightening	lY/tx/nIG
lightning	lYt/nIG
manger	men/JR
mountain	mWn/txn
mountains	mWn/txnz
mouthful	mWT/fxl
movement	muv/mInt
ointment	On/tmInt
olden	ol/dxn
older	ol/dR
ounces	Wn/sIz
outlet	Wt/lEt
oyster	Os/tR
painful	pen/fxl
painted	pen/tId
painting	pen/tIG
pavement	pev/mInt
peaceful	pis/fxl
pointed	pOn/tId
pointer	pOn/tR
pointing	pOn/tIG
poster	pos/tR
pounding	pWn/dIG
ranger	ren/JR
rooster	rus/tR
roosters	ru/stRz
shoulder	Sol/dR
shoulders	Sol/dRz
soldier	sol/JR
soldiers	sol/JRz
sounded	sWn/dId
sounding	sWn/dIG
spoonful	spun/fxl
spoonfuls	spun/fxlz
stranger	stren/JR
tangled	t@G/gxld
thanking	T@G/kIG
toasted	to/stId
toaster	tos/tR
toothless	tuT/lIs
treatment	trit/mInt
useful	yus/fxl
useless	yu/slIs
winder	wYn/dR
yanking	y@G/kIG
baseball	bes/bcl
bean+stalk	bin/stck
clean+up	kli/n^p
downstairs	dWn/sterz
goldfish	gol/dfIS
grown+ups	gro/n^ps
holdup	hol/d^p
homework	hom/wRk
lightbulb	lYt/b^lb
mailbox	mel/baks
mailman	mel/m@n
meatballs	mit/bclz
nightshirt	nYt/SRt
outfit	Wt/fIt
raindrops	ren/draps
reindeer	ren/dir
roadblock	rod/blak
sidetracked	sYd/tr@kt
sidewalk	sYd/wck
skateboard	sket/bord
skateboards	sket/bordz
spaceship	spes/SIp
sweetheart	swit/hart
tool+box	tul/baks
toothbrush	tuT/br^S
angry	@G/gri
beastly	bis/tli
bouncy	bWn/si
bounty	bWn/ti
closely	klo/sli
county	kWn/ti
cranky	kr@G/ki
dainty	den/ti
feisty	fY/sti
frankly	fr@G/kli
goldie	gol/di
greatly	gret/li
jewelry	Jul/ri
kindly	kYn/dli
lately	let/li
likely	lYk/li
lonely	lon/li
mainly	men/li
mostly	mos/tli
neatly	nit/li
nicely	nY/sli
only	on/li
plainly	plen/li
pointy	pOn/ti
safety	sef/ti
tightly	tYt/li
toasty	to/sti
wildly	wYld/li
yankee	y@G/ki
driveway	drYv/we
firefly	fYr/flY
mango	m@G/go
raceway	re/swe
rainbow	ren/bo
tuesday	tuz/de
briefcase	brif/kes
download	dWn/lod
downstream	dWn/strim
downtown	dWn/tWn
grapefruit	grep/frut
house+coat	hW/skot
meantime	min/tYm
meanwhile	min/wYl
meat+loaf	mit/lof
moonlight	mun/lYt
mouthpiece	mWT/pis
nightgown	nYt/gWn
nighttime	nYt/tYm
nineteen	nYn/tin
noontime	nun/tYm
nosedives	noz/dYvz
oatmeal	ot/mil
outgrown	Wt/gron
outside	Wt/sYd
railroad	re/lrod
raincoat	ren/kot
sailboat	sel/bot
school+house	skul/hWs
sideways	sYd/wez
suitcase	sut/kes
fireplace	fYr/ples
kinda	kYn/dx
outlaw	Wt/lc
metal	mE/txl
above	x/b^v
accept	Ek/sEpt
across	x/krcs
adore	x/dor
adult	x/d^lt
advanced	@d/v@nst
afford	x/ford
again	x/gEn
against	x/gEnst
ahead	x/hEd
alarm	x/larm
along	x/lcG
among	x/m^G
apart	x/part
appeared	x/pird
appears	x/pirz
attach	x/t@C
attached	x/t@Ct
attack	x/t@k
attacked	x/t@kt
because	bx/kcz
become	bI/k^m
becomes	bI/k^mz
before	bx/for
began	bx/g@n
begin	bx/gIn
begins	bx/gInz
begun	bx/g^n
belong	bx/lcG
belongs	bx/lcGz
beyond	bi/and
cement	sx/mEnt
collapse	kx/l@ps
collect	kx/lEkt
connect	kx/nEkt
declare	dI/kler
defrost	dI/frcst
deluxe	dx/l^ks
demand	dI/m@nd
depend	dI/pEnd
deserve	dI/zRv
dessert	dI/zRt
direct	dI/rEkt
duress	dx/rEs
effects	I/fEkts
elisse	pe/lis
enough	I/n^f
garage	gx/raZ
giraffe	Jx/r@f
giraffes	Jx/r@fs
guitar	gI/tar
massage	mx/saZ
o'clock	x/klak
prefer	prI/fR
pretend	prI/tEnd
prevents	prx/vEnts
protect	prx/tEkt
relax	rx/l@ks
relaxed	rx/l@kst
report	rI/port
results	rI/z^lts
return	rI/tRn
returned	rI/tRnd
reverse	rI/vRs
reward	rI/wcrd
secure	sx/kyUr
suggest	sx/JEst
toward	tord
towards	tordz
upon	x/pcn
within	wI/DIn
adam	@/dxm
adam's	@/dxmz
added	@/dId
adding	@/dIG
airing	e/rIG
alex	@/lIks
allen	@/lIn
apple	@/pxl
apples	@/pxlz
ashes	@/SIz
asking	@/skIG
attic	@/tIk
august	c/gxst
awesome	c/sxm
awful	c/fxl
awkward	c/kwRd
babbling	b@/blIG
backward	b@/kwRd
backwards	b@/kwRdz
balance	b@/lxns
balling	bc/lIG
banner	b@/nR
baring	be/rIG
barrels	b@/rxlz
batter	b@/tR
battle	b@/txl
beggar	bE/gR
begging	bE/gIG
bigger	bI/gR
biggest	bI/gxst
bitter	bI/tR
blessing	blE/sIG
blessings	blE/sIGz
blocking	bla/kIG
blossomed	bla/sxmd
bobbing	ba/bIG
bonnet	ba/nIt
bossing	bc/sIG
boston	bc/stIn
bother	ba/DR
bothered	ba/DRd
bottle	ba/txl
bottles	ba/txlz
bottom	ba/txm
bottoms	ba/txmz
bridges	brI/JIz
brigitte	brI/JIt
bristles	brI/sxlz
britches	brI/CIz
broader	brc/dR
brother	br^/DR
brothers	br^/DRz
brushing	br^/SIG
bubble	b^/bxl
bubbles	b^/bxlz
bucket	b^/kIt
buckets	b^/kIts
buckle	b^/kxl
buckled	b^/kxld
buckles	b^/kxlz
bugging	b^/gIG
bummer	b^/mR
bumming	b^/mIG
bushel	bU/Sxl
bushes	bU/SIz
butter	b^/tR
button	b^/txn
buttons	b^/txnz
buzzing	b^/zIG
cabbage	k@/bIJ
camel	k@/mxl
camels	k@/mxlz
carol	k@/rxl
carriage	k@/rIJ
carrot	k@/rIt
carrots	k@/rIts
castle	k@/sxl
catcher	k@/CR
catches	k@/CIz
catching	k@/CIG
causing	kc/zIG
challenge	C@/lInJ
channel	C@/nxl
channels	C@/nxlz
checking	CE/kIG
chicken	CI/kIn
chickens	CI/kInz
christened	krI/sInd
citrus	sI/trIs
clapping	kl@/pIG
clever	klE/vR
clicker	klI/kR
clicking	klI/kIG
clifford	klI/fRd
clinic	klI/nIk
clippers	klI/pRz
clipping	klI/pIG
closet	klc/zIt
clutter	kl^/tR
cockle	ka/kxl
collar	ka/lR
college	ka/lIJ
color	k^/lR
colored	k^/lRd
colors	k^/lRz
column	ka/lxm
coming	k^/mIG
comment	ka/mEnt
common	ka/mxn
cooking	kU/kIG
coral	kc/rxl
corral	kx/r@l
cotton	ka/txn
coughing	kc/fIG
couple	k^/pxl
cousin	k^/zIn
cousins	k^/zInz
cover	k^/vR
covered	k^/vRd
covers	k^/vRz
crabbing	kr@/bIG
cracker	kr@/kR
crackers	kr@/kRz
crawler	krc/lR
crawling	krc/lIG
credit	krE/dIt
crickets	krI/kIts
crooked	krU/kxd
crossing	krc/sIG
cupboard	k^/bRd
cushion	kU/SIn
cushioned	kU/SInd
cushions	kU/SInz
cutting	k^/tIG
damage	d@/mIJ
daring	de/rIG
daughter	dc/tR
dennis	dE/nIs
desert	dI/zRt
devil	dE/vxl
devon	dE/vxn
diddle	dI/dxl
difference	dI/frIns
different	dI/frInt
digger	dI/gR
digging	dI/gIG
dinner	dI/nR
dinners	dI/nRz
dishes	dI/SIz
dollar	da/lR
dollars	da/lRz
donald	da/nxld
double	d^/bxl
dozen	d^/zIn
dragging	dr@/gIG
dragon	dr@/gxn
drawing	drc/IG
dresser	drE/sR
dresses	drE/sIz
dressing	drE/sIG
dripping	drI/pIG
dropping	dra/pIG
drummer	dr^/mR
drumming	dr^/mIG
during	dU/rIG
dusted	d^/stId
dusting	d^/stIG
effort	E/fRt
eric	E/rIk
erin	E/rIn
ever	E/vR
fasten	f@/sIn
fastens	f@/sInz
faster	f@/stR
father	fa/DR
father's	fa/DRz
feather	fE/DR
feathers	fE/DRz
fennel	fE/nxl
ferris	fE/rIs
fickle	fI/kxl
fiddle	fI/dxl
fiddles	fI/dxlz
figure	fI/gyR
figured	fIg/yRd
figures	fIg/yRz
finish	fI/nIS
finished	fI/nISt
fisher	fI/SR
fishes	fI/SIz
fishing	fI/SIG
fitting	fI/tIG
flashes	fl@/SIz
flipping	flI/pIG
flutter	fl^/tR
flutters	fl^/tRz
forest	fc/rIst
forum	fo/rxm
fossil	fc/sxl
freddy	frE/di
fusser	f^/sR
fussing	f^/sIG
gather	g@/DR
giggle	gI/gxl
giggles	gI/gxlz
gimmick	gI/mIk
gimmicks	gI/mIks
given	gI/vxn
giver	gI/vR
giving	gI/vIG
gladys	gl@/dIs
glasses	gl@/sIz
gobble	ga/bxl
goggles	ga/gxlz
gotten	ga/txn
grabbing	gr@/bIG
grasses	gr@/sIz
gravel	gr@/vxl
griffin	grI/fIn
habit	h@/bIt
habits	h@/bIts
hammer	h@/mR
hammock	h@/mxk
happen	h@/pxn
happened	h@/pxnd
happens	h@/pxnz
hassle	h@/sxl
having	h@/vIG
hazard	h@/zRd
headed	hE/dId
heading	hE/dIG
heaven	hE/vxn
heavens	hE/vxnz
hiccup	hI/kxp
hiccups	hI/kxps
hidden	hI/dxn
hitting	hI/tIG
hogging	hc/gIG
holler	ha/lR
hopping	ha/pIG
hugger	h^/gR
hugging	h^/gIG
humming	h^/mIG
jacket	J@/kIt
jackets	J@/kIts
jealous	JE/lIs
jogging	Ja/gIG
karen	k@/rIn
kettle	kE/txl
kevin's	kE/vInz
kicking	kI/kIG
kidding	kI/dIG
kisses	kI/sIz
kissing	kI/sIG
kitchen	kI/CIn
kitten	kI/txn
kittens	kI/txnz
knocking	na/kIG
kristen	krI/stIn
lacking	l@/kIG
ladder	l@/dR
latin	l@/txn
laughing	l@/fIG
laura's	lc/rxz
lawrence	lc/rIns
legend	lE/JInd
leggings	lE/gIGz
lemon	lE/mxn
lemons	lE/mxnz
leopard	lE/pRd
letter	lE/tR
letters	lE/tRz
letting	lE/tIG
lettuce	lE/tIs
level	lE/vxl
licking	lI/kIG
limit	lI/mIt
limits	lI/mIts
linen	lI/nIn
liquids	lI/kwIdz
listen	lI/sIn
listened	lI/sInd
litter	lI/tR
little	lI/txl
living	lI/vIG
lizard	lI/zRd
locking	la/kIG
looking	lU/kIG
lover	l^/vR
loving	l^/vIG
luggage	l^/gIJ
magic	m@/JIk
mallet	m@/lIt
mammals	m@/mxlz
manage	m@/nIJ
managed	m@/nIJd
marriage	m@/rIJ
mashing	m@/SIG
massive	m@/sIv
matter	m@/tR
matters	m@/tRz
mattress	m@/trIs
measure	mE/ZR
measures	mE/ZRz
megan	me/gxn
melon	mE/lxn
message	mE/sIJ
messer	mE/sR
messes	mE/sIz
messing	mE/sIG
method	mE/Txd
middle	mI/dxl
minutes	mI/nIts
mirror	mI/rR
missing	mI/sIG
mission	mI/SIn
missus	mI/sIz
mister	mIs/tR
mittens	mI/txnz
model	ma/dxl
mopping	ma/pIG
mother	m^/DR
mothers	m^/DRz
mother's	m^/DRz
muffin	m^/fIn
muffins	m^/fInz
muppets	m^/pIts
muscle	m^/sxl
mushing	m^/SIG
napping	n@/pIG
never	nE/vR
nibbled	nI/bxld
nickel	nI/kxl
nodded	na/dId
nodding	na/dIG
noggin	na/gIn
nothing	n^/TIG
nothing's	n^/TIGz
nugget	n^/gIt
nuggets	n^/gIts
offer	c/fR
offered	c/fRd
office	c/fIs
often	c/fxn
olive	a/lIv
olives	a/lIvz
onion	^/nyxn
onions	^n/yxnz
oral	o/rxl
orange	c/rInJ
oscar	a/skR
other	^/DR
others	^/DRz
oven	^/vxn
package	p@/kIJ
packet	p@/kIt
packing	p@/kIG
palace	p@/lIs
panicked	p@/nIkt
parents	p@/rInts
parrot	p@/rIt
patches	p@/CIz
patterns	p@/tRnz
patting	p@/tIG
pausing	pc/zIG
pedals	pE/dxlz
pepper	pE/pR
peppers	pE/pRz
pepper's	pE/pRz
petal	pE/txl
petals	pE/txlz
petted	pE/tId
petting	pE/tIG
phonics	fa/nIks
picking	pI/kIG
pickle	pI/kxl
pickles	pI/kxlz
pigeon	pI/JIn
pitcher	pI/CR
pigeons	pI/JInz
planet	pl@/nIt
platter	pl@/tR
pleasant	plE/zInt
pocket	pa/kIt
pockets	pa/kIts
polish	pa/lIS
popping	pa/pIG
porridge	pc/rIJ
possums	pa/sxmz
potter	pa/tR
pouring	po/rIG
precious	prE/SIs
presence	prE/zIns
present	prE/zInt
presents	prE/zInts
pressing	prE/sIG
problem	prab/lxm
problems	pra/blxmz
product	pra/dxkt
products	pra/dxkts
project	pra/JEkt
projects	pra/JEkts
promise	pra/mIs
promised	pra/mIst
proper	pra/pR
publish	p^b/lIS
pucker	p^/kR
pudding	pU/dIG
puddle	p^/dxl
puddles	p^/dxlz
pulling	pU/lIG
puppet	p^/pIt
pushes	pU/SIz
pushing	pU/SIG
putted	p^/tId
putting	p^/tIG
puzzle	p^/zxl
puzzles	p^/zxlz
quacking	kw@/kIG
quarrel	kwc/rxl
quitter	kwI/tR
rabbit	r@/bIt
rabbits	r@/bIts
rabbit's	r@/bIts
radish	r@/dIS
rashes	r@/SIz
rather	r@/DR
rattle	r@/txl
rattles	r@/txlz
record	rE/kRd
records	rE/kRdz
rhythm	rI/Dxm
ribbon	rI/bxn
ribbons	rI/bxnz
richard	rI/CRd
ripping	rI/pIG
risen	rI/zIn
river	rI/vR
rivers	rI/vRz
robert	ra/bRt
roberts	ra/bRts
robin	ra/bIn
rocker	ra/kR
rocking	ra/kIG
rotten	ra/txn
rougher	r^/fR
rubber	r^/bR
rubbing	r^/bIG
ruffle	r^/fxl
runner	r^/nR
running	r^/nIG
rushing	r^/SIG
russell	r^/sxl
rustles	r^/sxlz
salad	s@/lId
salmon	s@/mxn
sausage	sc/sIJ
scaring	ske/rIG
schedule	skE/JUl
scissors	sI/zRz
scottish	ska/tIS
scratching	skr@/CIG
scribble	skrI/bxl
second	sE/kxnd
seconds	sE/kxndz
seller	sE/lR
selling	sE/lIG
session	sE/SIn
setting	sE/tIG
settle	sE/txl
settled	sE/txld
seven	sE/vIn
seventh	sE/vInT
shallots	S@/lxts
sharing	Se/rIG
sharon	S@/rIn
shedding	SE/dIG
sheriff	SE/rIf
shiver	SI/vR
shopper	Sa/pR
shopping	Sa/pIG
shouldn't	SU/dxnt
should've	SU/dxv
shovel	S^/vxl
shovels	S^/vxlz
shriveled	rI/vxld
shutter	S^/tR
shutters	S^/tRz
shutting	S^/tIG
sibling	sIb/lIG
simmer	sI/mR
sitting	sI/tIG
slamming	sl@/mIG
slipper	slI/pR
slippers	slI/pRz
slipping	slI/pIG
slobber	sla/bR
slobbered	sla/bRd
slopping	sla/pIG
smacking	sm@/kIG
smaller	smc/lR
smashing	sm@/SIG
smelling	smE/lIG
snacking	sn@/kIG
snapping	sn@/pIG
snipper	snI/pR
snoring	sno/rIG
snuggle	sn^/gxl
snuggled	sn^/gxld
soccer	sa/kR
solid	sa/lId
sonic	sa/nIk
spanish	sp@/nIS
special	spE/Sxl
spelling	spE/lIG
spilling	spI/lIG
spinach	spI/nIC
spinning	spI/nIG
spirit	spI/rIt
spitting	spI/tIG
splashing	spl@/SIG
stacking	st@/kIG
staring	ste/rIG
static	st@/tIk
steering	sti/rIG
stepping	stE/pIG
sticker	stI/kR
stickers	stI/kRz
sticking	stI/kIG
stirring	stR/rIG
stocking	sta/kIG
stomach	st^/mxk
stopper	sta/pR
stopping	sta/pIG
stretches	strE/CIz
stretching	strE/CIG
stroller	stro/lR
struggled	str^/gxld
stubborn	st^/bRn
stutter	st^/tR
sucker	s^/kR
sucking	s^/kIG
sudden	s^/dxn
sugar	SU/gR
summer	s^/mR
summer's	s^/mRz
summoned	s^/mxnd
supper	s^/pR
sweater	swE/tR
sweaters	swE/tRz
swelling	swE/lIG
swimmer	swI/mR
swimming	swI/mIG
syrup	sI/rxp
talker	tc/kR
talking	tc/kIG
taller	tc/lR
tallest	tc/lIst
tearing	tE/rIG
telling	tE/lIG
tennis	tE/nIs
thicker	TI/kR
thistle	TI/sxl
thrasher	Tr@/SR
ticket	tI/kIt
tickets	tI/kIts
tickle	tI/kxl
tickled	tI/kxld
tickles	tI/kxlz
tipping	tI/pIG
topic	ta/pIk
toppings	ta/pIGz
tosses	tc/sIz
touches	t^/CIz
touching	t^/CIG
traffic	tr@/fIk
trashing	tr@/SIG
travels	tr@/vxlz
triple	trI/pxl
tripping	trI/pIG
trouble	tr^/bxl
tucker	t^/kR
tugging	t^/gIG
tunnel	t^/nxl
twiddle	twI/dxl
upper	^/pR
visit	vI/zIt
waffle	wc/fxl
waffles	wc/fxlz
wagon	w@/gxn
walker	wc/kR
walking	wc/kIG
wallet	wc/lIt
warren	wc/rIn
washer	wc/SR
washes	wc/SIz
washing	wc/SIG
watches	wa/CIz
watching	wa/CIG
water	wc/tR
water's	wc/tRz
wearing	we/rIG
weather	wE/DR
wetter	wE/tR
whipping	wI/pIG
whistle	wI/sxl
wiggins	wI/gInz
wiggle	wI/gxl
wiggles	wI/gxlz
willing	wI/lIG
wishes	wI/SIz
woman	wU/mxn
women	wI/mIn
wooden	wU/dxn
wouldn't	wU/dxnt
would've	wU/dxv
wrapper	r@/pR
wrapping	r@/pIG
wrecker	rE/kR
wrecking	rE/kIG
written	rI/txn
yawning	yc/nIG
yelling	yE/lIG
zipper	zI/pR
zippers	zI/pRz
amen	e/mEn
cannot	k@/nat
doggone	dc/gcn
minute	mY/nut
process	pra/sEs
uhhum	^/h^m
abu	a/bu
ago	x/go
agree	x/gri
ahoy	@/hoI
apply	x/plY
array	x/re
away	x/we
below	bx/lo
degree	dx/gri
deny	dI/nY
hooray	hU/re
hurray	hU/re
review	rI/vyu
today	tx/de
whoopee	wU/pi
ali	a/li
any	E/ni
ashley	@S/li
ashy	@/Si
baggy	b@/gi
batty	b@/ti
berry	bE/ri
bitty	bI/ti
bobby	ba/bi
body	ba/di
bonny	ba/ni
borrow	ba/ro
bubbly	b^/bli
buddy	b^/di
bury	bE/ri
busy	bI/zi
carrie	k@/ri
carry	k@/ri
cherry	CE/ri
chubby	C^/bi
chuckie	C^/ki
city	sI/ti
coffee	kc/fi
connie	ka/ni
cookie	kU/ki
crabby	kr@/bi
cubby	k^/bI
daddy	d@/di
daffy	d@/fi
dairy	de/ri
ditty	dI/ti
dizzy	dI/zi
doggie	dc/gi
doggy	dc/gi
dolly	dc/li
dotty	da/ti
dummy	d^/mi
dusty	d^s/ti
eddie	E/di
emmy	E/mi
every	E/vri
fanny	f@/ni
fellow	fE/lo
ferry	fE/ri
floppy	fla/pi
fluffy	fl^/fi
follow	fa/lo
funny	f^/ni
fussy	f^/si
fuzzy	f^/zi
gabby	g@/bi
galley	g@/li
ghetto	gE/to
gimme	gI/mi
golly	ga/li
goody	gU/di
grammy	gr@/mi
granny	gr@/ni
gritty	grI/ti
hairy	he/ri
happy	h@/pi
harry	h@/ri
heavy	hE/vi
hello	hE/lo
hippo	hI/po
holly	ha/li
honey	h^/ni
hoppy	S0/pI
icky	I/ki
jackie	J@/ki
jello	JE/lo
jelly	JE/li
jerry	JE/ri
jimmy	JI/mi
johnny	Ja/ni
jolly	Ja/li
kelly	kE/li
kelsey	kEl/si
kenny	kE/ni
kiddie	kI/di
kitty	kI/ti
lily	lI/li
lippie	klI/pI
lolly	la/li
lori	lc/ri
lovie	l^/vi
lucky	l^/ki
maggie	m@/gi
mammy	m@/mi
many	mE/ni
marry	m@/ri
marymary	me/ri
matthew	m@T/yu
meadow	mE/do
messy	mE/si
mickey	mI/ki
minnie	mI/ni
missy	mI/si
mommy	ma/mi
money	m^/ni
muddy	m^/di
mushy	m^/Si
nappy	n@/pi
naughty	nc/ti
nipple	nI/pxl
nutty	n^/ti
paddy	p@/di
patchy	p@/Ci
patty	p@/ti
peary	pi/ri
penny	pE/ni
picky	pI/ki
piggy	pI/gi
pillow	pI/lo
pissy	pI/si
poppy	pa/pi
potty	pa/ti
prairie	pre/ri
pretty	prI/ti
pussy	pU/si
ready	rE/di
reggie	rE/Ji
runny	r^/ni
sally	s@/li
sammy	s@/mi
scary	ske/ri
scratchy	skr@/Ci
scrubby	skr^/bi
scurry	skR/ri
shabby	S@/bi
shadow	S@/do
shaggy	S@/gi
shallow	S@/lo
sherri	SE/ri
shimmy	SI/mi
silly	sI/li
skinny	skI/ni
slippy	slI/pi
sloppy	sla/pi
smelly	smE/li
snippy	snI/pi
snotty	sna/ti
soggy	sc/gi
sonny	s^/ni
sorry	sa/ri
sparrow	sp@/ro
spotty	spa/ti
spunky	sp^G/ki
squishy	skwI/Si
steady	stE/di
sticky	stI/ki
story	sto/ri
study	st^/di
stuffy	st^/fi
sunny	s^/ni
swallow	swa/lo
sweaty	swE/ti
teddy	tE/di
telly	tE/li
terry	tE/ri
tommy	ta/mi
touchy	t^/Ci
toughie	t^/fi
tricky	trI/ki
tummy	t^/mi
veggie	vE/Ji
very	vE/ri
wacky	w@/ki
walkie	wc/ki
whoopie	wU/pi
willie	wI/li
willow	wI/lo
willy	wI/li
winnie	wI/ni
wobbly	wc/bli
woody	wU/di
woolly	wU/li
wooly	wU/li
worry	wR/ri
yellow	yE/lo
yucky	y^/ki
yummy	y^/mi
zero	zi/ro
ally	@/lY
ballet	b@/le
iago	i/a/go
popeye	pa/pY
statue	st@/Cu
tissue	tI/Su
uhoh	^/o
about	x/bWt
abuse	x/byus
account	x/kWnt
accused	x/kyuzd
achieved	x/Civd
advice	@d/vYs
afraid	x/fred
agreed	x/grid
alike	x/lYk
alive	x/lYv
allow	x/lW
allowed	x/lWd
alone	x/lon
aloud	x/lWd
amazed	x/mezd
amount	x/mWnt
approached	x/proCt
arise	x/rYz
around	x/rWnd
arrange	x/renJ
arrived	x/rYvd
ashamed	x/Semd
asleep	x/slip
assume	x/sum
assumed	x/sumd
awake	x/wek
baboon	b@/bun
became	bx/kem
behaved	bx/hevd
behind	bx/hYnd
believe	bx/liv
believed	bx/livd
beneath	bx/niT
beside	bx/sYd
besides	bx/sYdz
caboose	kx/bus
cocoon	kx/kun
decide	dI/sYd
delete	dx/lit
deprive	dI/prYv
derived	dI/rYvd
design	dI/zYn
desire	dI/zYr
device	dI/vYs
devour	dI/vW/R
erase	I/res
machine	mx/Sin
machines	mx/Sinz
nicole	nI/kol
parade	px/red
patrice	px/tris
police	px/lis
polite	px/lYt
raccoon	r@/kun
raccoons	r@/kunz
receipt	rI/sit
receive	rI/siv
refused	rI/fyuzd
rejoice	rI/JOs
released	rx/list
relieves	rx/livz
remind	rx/mYnd
reminds	rx/mYndz
remote	rx/mot
remove	rx/muv
removed	rx/muvd
renewed	rI/nud
replace	rI/ples
replied	rI/plYd
reply	rI/plY
requires	rI/kwYrz
retired	rI/tYrd
reveal	rI/vil
supplies	sx/plYz
suppose	sx/poz
supposed	sx/pozd
surprise	sR/prYz
surprised	sR/prYzd
today's	tx/dez
tonight	tx/nYt
trapeze	trx/piz
without	wI/DWt
between	bx/twin
produced	prx/dust
berries	bE/riz
borrowed	ba/rod
buddies	b^/diz
buried	bE/rid
carried	k@/rid
cherries	CE/riz
cookies	kU/kiz
copied	ka/pid
daddy's	d@/diz
doggies	dc/giz
dollies	dc/liz
duckies	d^/kiz
followed	fa/lod
fuzzies	f^/ziz
hippos	hI/poz
kitties	kI/tiz
lilies	lI/liz
married	m@/rid
mary's	me/riz
minnows	mI/noz
pennies	pE/niz
piggies	pI/giz
pillows	pI/loz
pretties	prI/tiz
puppies	p^/piz
series	si/riz
shadows	S@/doz
stories	sto/riz
swallowed	swa/lod
swallows	swa/loz
talkies	tc/kiz
teddies	tE/diz
tummies	t^/miz
worries	wR/riz
yummies	y^/miz
bellowed	bE/lod
heros	hi/roz
refuge	rE/fyuJ
tattoos	t@/tuz
tissues	tI/Suz
vacuum	v@/kyum
baba	ba/bx
debra	dE/brx
donna	da/nx
drama	dra/mx
fella	fE/lx
gonna	g^/nx
gotcha	ga/Cx
gotta	ga/tx
hannah	h@/nx
laura	lc/rx
mama	ma/mx
mamma	ma/mx
mega	mE/gx
momma	ma/mx
papa	pa/px
pasta	pa/stx
paula	pc/lx
sara	s@/rx
sarah	s@/rx
vera	vi/rx
wanna	wa/nx
gaga	ga/ga
haha	ha/ha
uhuh	^/h^
a	e
an	@n
and	@nd
are	ar
as	@z
at	@t
can	k@n
does	d^z
for	fcr
has	h@z
her	hR
him	hIm
his	hIz
is	Iz
it	It
of	^v
or	cr
our	W/R
some	s^m
than	D@n
the	D^
their	Der
to	tu
us	^s
was	w^z
we	wi
your	yUr
have	h@v
that	D@t
act	@kt
acts	@kts
ad	@d
add	@d
age	eJ
ah	a
aid	ed
aids	edz
aim	em
aimed	emd
ain't	ent
air	er
aisle	Yl
al	@l
all	cl
am	@m
ann	@n
ant	@nt
ants	@nts
arc	ark
aren't	arnt
ark	ark
arm	arm
arms	armz
arts	arts
ask	@sk
asked	@skt
ate	et
aunt	@nt
aunts	@nts
aw	c
ax	@ks
aye	Y
baa	ba
babe	beb
babes	bebz
back	b@k
backed	b@kt
backs	b@ks
bad	b@d
bag	b@g
bags	b@gz
bah	ba
bake	bek
baked	bekt
bald	bcld
ball	bcl
balls	bclz
bam	b@m
band	b@nd
bands	b@ndz
bang	b@G
banged	b@Gd
bank	b@Gk
bar	bar
bark	bark
barked	barkt
barks	barks
barn	barn
barrel	b@/rxl
bars	barz
bart	bart
be	bi
beard	bird
beer	bir
bee's	biz
beg	bEg
beings	bi/IGz
belts	bElts
beth	bET
bid	bId
big	bIg
bills	bIlz
bin	bIn
bits	bIts
blade	bled
blades	bledz
blank	bl@Gk
bleat	blit
blend	blEnd
blends	blEndz
blond	bland
blood	bl^d
bloom	blum
bob	bab
bog	bcg
bond	band
book	bUk
boost	bust
bounds	bWndz
bout	bWt
bowed	bWd
boy	bO
bra	bra
brat	br@t
breast	brEst
broad	brcd
browns	brWnz
brunch	br^nC
bucks	b^ks
buds	b^dz
builds	bIldz
bummed	b^md
bumps	b^mps
bums	b^mz
burke	bRk
burps	bRps
but	b^t
buts	b^ts
butts	b^ts
cane	ken
can't	k@nt
cares	kerz
car's	karz
caused	kczd
cell	sEl
cent	sEnt
chains	Cenz
charged	CarJd
charm	Carm
chat	C@t
checks	CEks
cheer	Cir
chews	Cuz
chimp	CImp
choice	COs
chopped	Capt
chore	Cor
cleared	klird
clipped	klIpt
cloaks	kloks
clowns	klWnz
clue	klu
clumps	kl^mps
clunk	kl^Gk
coats	kots
cob	kab
cock	kak
code	kod
coke	kok
combs	komz
come	k^m
cooked	kUkt
cracked	kr@kt
cramped	kr@mpt
crashed	kr@St
crazed	krezd
crock	krak
crooks	krUks
crossed	krcst
crowd	krWd
crud	kr^d
crumb	kr^m
crust	kr^st
cube	kyub
curb	kRb
curds	kRdz
curse	kRs
czech	CEk
damn	d@m
dan	d@n
dazed	dezd
dense	dEns
did	dId
dies	dYz
digs	dIgz
discs	dIsks
dived	dYvd
do	du
dodge	daJ
dome	dom
don't	dont
door's	dorz
dorm	dorm
dough	do
dove	d^v
down	dWn
doze	doz
drew	dru
drips	drIps
drives	drYvz
drove	drov
drown	drWn
dug	d^g
dukes	duks
dyed	dYd
dyes	dYz
earned	Rnd
eat	it
eel	il
eighth	etT
el	El
elves	Elvz
ewe	yu
faced	fest
fade	fed
fart	fart
fates	fets
fawn	fcn
feast	fist
fenced	fEnst
fifth	fIfT
fig	fIg
fins	fInz
fires	fYrz
flaps	fl@ps
fleece	flis
fleet	flit
flicked	flIkt
floors	florz
floor's	florz
flows	floz
foam	fom
fooled	fuld
forced	forst
forks	fcrks
foul	fWl
fours	forz
fourths	forTs
frank	fr@Gk
fried	frYd
frown	frWn
froze	froz
fruits	fruts
fussed	f^st
gained	gend
gasped	g@spt
gates	gets
gears	girz
gels	JElz
george	JcrJ
get	gEt
girl	gRl
girl's	gRlz
gloss	glcs
glove	gl^v
go	go
gods	gadz
good	gUd
goof	guf
got	gat
gots	gats
gown	gWn
gowns	gWnz
grabs	gr@bz
grade	gred
grain	gren
gram	gr@m
grand	gr@nd
grant	gr@nt
grate	gret
greats	grets
grind	grYnd
growth	groT
guest	gEst
guide	gYd
gun	g^n
guns	g^nz
guy's	gYz
hag	h@g
hair's	herz
hawk	hck
hawn	hcn
he	hi
heal	hil
heals	hilz
heap	hip
heaped	hipt
heart's	harts
heels	hilz
height	hYt
here	hir
hey	he
hi	hY
hinge	hInJ
hips	hIps
hired	hYrd
holds	holdz
hoop	hup
how	hW
hue	hyu
huh	h^
hump	h^mp
i	Y
ill	Il
i'm	Ym
in	In
it's	Its
jail	Jel
jarred	Jard
jaw	Jc
jaws	Jcz
jim's	JImz
johns	Janz
john's	Janz
judge	J^J
june's	Junz
just	J^st
jut	J^t
kate	ket
ken	kEn
kicks	kIks
killed	kIld
kneel	nil
knives	nYvz
knobs	nabz
knocks	naks
know	no
knox	naks
lace	les
lack	l@k
lame	lem
latch	l@C
latched	l@Ct
laughed	l@ft
lays	lez
leaned	lind
leaped	lipt
learns	lRnz
led	lEd
ledge	lEJ
lee	li
let	lEt
lets	lEts
let's	lEts
lied	lYd
like	lYk
limbs	lImz
lined	lYnd
links	lIGks
lists	lIsts
lit	lIt
loan	lon
locks	laks
log	lcg
longed	lcGd
look	lUk
loons	lunz
loop	lup
looped	lupt
loosed	lust
lop	lap
lou	lu
lowed	lod
luck	l^k
lump	l^mp
lure	lUr
mac	m@k
mails	melz
mall	mcl
map	m@p
marked	markt
mars	marz
marsh	marS
mash	m@S
mate	met
mates	mets
me	mi
meaned	mind
melts	mElts
mesh	mES
mets	mEts
mew	myu
mike's	mYks
mile	mYl
miles	mYlz
mint	mInt
mist	mIst
mo	mo
mopped	mapt
more	mor
moss	mcs
moths	mcDz
mount	mWnt
ms	mIz
my	mY
names	nemz
name's	nemz
nerve	nRv
nerves	nRvz
newt	nut
niece	nis
night's	nYts
no	no
north	ncrT
nosed	nozd
not	nat
notes	nots
now	nW
odd	ad
off	cf
oh	o
oiled	Old
on	an
one	w^n
ours	W/Rz
out	Wt
owe	o
packs	p@ks
paged	peJd
paid	ped
pairs	perz
pal	p@l
pans	p@nz
pant	p@nt
parked	parkt
paused	pczd
paw	pc
paws	pcz
peeks	piks
peel	pil
peeped	pipt
pens	pEnz
per	pR
pete	pit
phones	fonz
piles	pYlz
pipe	pYp
pit	pIt
pitched	pICt
placed	plest
plates	plets
play	ple
plops	plaps
plow	plW
plunged	pl^nJd
poem	po/xm
pole	pol
poohs	puz
pooped	pupt
pose	poz
pound	pWnd
pours	porz
pressed	prEst
price	prYs
prick	prIk
pricked	prIkt
prime	prYm
prize	prYz
proof	pruf
prove	pruv
prowl	prWl
prunes	prunz
psalm	sam
pulls	pUlz
pump	p^mp
pup	p^p
pups	p^ps
put	pUt
quail	kwel
quails	kwelz
quiz	kwIz
quote	kwot
raced	rest
rags	r@gz
rail	rel
raise	rez
rake	rek
ram	r@m
ranch	r@nC
rap	r@p
rat	r@t
rats	r@ts
rays	rez
rear	rir
rent	rEnt
rex	rEks
rhyme	rYm
rhymes	rYmz
ribs	rIbz
rides	rYdz
right	rYt
rinsed	rInst
ron	ran
rooms	rumz
room's	rumz
ross	rcs
rove	rov
rubbed	r^bd
rugs	r^gz
rules	rulz
rushed	r^St
rye	rY
saint	sent
sakes	seks
saves	sevz
say	se
scene	sin
scenes	sinz
scent	sEnt
scored	skord
scrape	skrep
screech	skriC
screw	skru
screwed	skrud
scrubbed	skr^bd
search	sRC
see	si
seemed	simd
seize	siz
sell	sEl
served	sRvd
serves	sRvz
sew	so
sewn	son
shared	Serd
sheared	Sird
shells	SElz
shifts	SIfts
shin	SIn
ships	SIps
shock	Sak
shocked	Sakt
shod	Sad
shoe's	Suz
shot	Sat
shots	Sats
shoved	S^vd
showed	Sod
sid	sId
sieve	sIv
sigh	sY
sighed	sYd
signed	sYnd
sill	sIl
sings	sIGz
sipped	sIpt
sips	sIps
sized	sYzd
skill	skIl
skills	skIlz
skirts	skRts
skull	sk^l
skunk	sk^Gk
slapped	sl@pt
slave	slev
sleek	slik
sleet	slit
slid	slId
slides	slYdz
slight	slYt
slime	slYm
slipped	slIpt
slob	slab
slosh	slaS
slouch	slWC
slug	sl^g
smelled	smEld
smiled	smYld
smiles	smYlz
smith	smIT
snail	snel
snails	snelz
snatched	sn@Ct
sneak	snik
sniff	snIf
snipped	snIpt
snoops	snups
snooze	snuz
snow's	snoz
snuck	sn^k
snuff	sn^f
so	so
soak	sok
source	sors
south	sWT
span	sp@n
specks	spEks
speed	spid
speeds	spidz
spell	spEl
spent	spEnt
sphere	fir
spike	spYk
spines	spYnz
split	splIt
spoil	spOl
spool	spul
sport	sport
sports	sports
spots	spats
sprat	spr@t
spreads	sprEdz
springs	sprIGz
sprint	sprInt
spruce	sprus
spy	spY
squares	skwerz
squashed	skwaSt
squeaked	skwikt
squeezed	skwizd
squid	skwId
stacked	st@kt
stale	stel
stance	st@ns
starch	starC
stare	ster
stash	st@S
steak	stek
steam	stim
steamed	stimd
steep	stip
steve	stiv
stile	stYl
stool	stul
stores	storz
strapped	str@pt
straps	str@ps
streaks	striks
strike	strYk
strip	strIp
stripe	strYp
striped	strYpt
struck	str^k
sub	s^b
sue	su
suits	suts
swam	sw@m
swan	swcn
swans	swcnz
swear	swEr
sweat	swEt
sweeps	swips
swell	swEl
swept	swEpt
swims	swImz
swings	swIGz
swiss	swIs
switched	swICt
tabs	t@bz
take	tek
tan	t@n
taped	tept
tapes	teps
tar	tar
tarts	tarts
tempt	tEmpt
tense	tEns
tenth	tEnT
terms	tRmz
terri	tE/ri
thank	T@Gk
thanked	T@Gkt
that'd	D@/tId
that's	D@ts
thaw	Tc
theirs	Derz
them	DEm
there	Der
there'll	Der/xl
there's	Derz
they	De
thief	Tif
thigh	TY
thighs	TYz
thing's	TIGz
think	TIGk
thirst	TRst
this	DIs
thorn	Tcrn
those	Doz
thrash	Tr@S
throne	Tron
tide	tYd
ties	tYz
tights	tYts
tile	tYl
tin	tIn
tipped	tIpt
tips	tIps
tires	tYrz
ton	t^n
tons	t^nz
too	tu
toot	tut
toots	tuts
tops	taps
torn	torn
tossed	tcst
tracks	tr@ks
trade	tred
trailed	treld
trails	trelz
trained	trend
trains	trenz
tricks	trIks
tripped	trIpt
troop	trup
trunk	tr^Gk
trunks	tr^Gks
tube	tub
tucked	t^kt
tugged	t^gd
tunes	tunz
tweaks	twiks
twelfth	twElfT
twice	twYs
twirl	twRl
up	^p
ups	^ps
van's	v@nz
vat	v@t
veils	velz
vern	vRn
verse	vRs
vests	vEsts
vin	vIn
vines	vYnz
v's	viz
wakes	weks
walls	wclz
want	w^nt
want's	wants
warmed	wcrmd
warn	wcrn
wasp	wasp
wax	w@ks
we'd	wid
weed	wid
weigh	we
weight	wet
well	wEl
whales	welz
what	w^t
what's	w^ts
when's	wEnz
where	wer
where's	werz
whey	we
whirled	wRld
whoop	wup
whoosh	wuS
why's	wYz
wick	wIk
width	wIdT
wig	wIg
winds	wIndz
wind's	wIndz
wink	wIGk
wished	wISt
with	wID
woe	wo
womb	wum
woo	wu
world's	wRldz
worms	wRmz
worried	wR/rid
worst	wRst
worth	wRT
wound	wWnd
wrist	rIst
writes	rYts
yaks	y@ks
yam	y@m
yank	y@Gk
yapped	y@pt
yarn	yarn
yawned	ycnd
yeah	yR
yeast	yist
yelled	yEld
yes	yEs
yolk	yok
you're	yur
zaps	z@ps
zeus	zus
zone	zon
base	bes
bat	b@t
bath	b@T
baths	b@Ts
bats	b@ts
bay	be
beach	biC
bead	bid
beads	bidz
beak	bik
bean	bin
beans	binz
bear	ber
bears	berz
beast	bist
beat	bit
bed	bEd
beds	bEdz
bed's	bEdz
bee	bi
beef	bif
been	bIn
beep	bip
beeps	bips
bees	biz
beet	bit
beets	bits
being	bi/IG
belch	bElC
bell	bEl
bells	bElz
belt	bElt
ben	bEn
bench	bEnC
bend	bEnd
bent	bEnt
bert	bRt
best	bEst
bet	bEt
bib	bIb
bibs	bIbz
bike	bYk
bikes	bYks
bill	bIl
bird	bRd
birds	bRdz
bird's	bRdz
birth	bRT
bit	bIt
bite	bYt
bites	bYts
black	bl@k
blah	bla
blame	blem
blast	bl@st
bleach	bliC
bleached	bliCt
bleed	blid
bless	blEs
blessed	blE/sId
blew	blu
blind	blYnd
blinds	blYndz
blink	blIGk
block	blak
blocked	blakt
blocks	blaks
blonde	bland
blow	blo
blows	bloz
blue	blu
blue's	bluz
bo	bo
board	bord
boat	bot
boats	bots
boil	bOl
boiled	bOld
bone	bon
bones	bonz
boo	bu
books	bUks
boom	bum
booms	bumz
boot	but
boots	buts
bop	bap
bored	bord
born	bcrn
both	boT
bough	bW
bought	bct
bounce	bWns
bounced	bWnst
bow	bW
bowel	bWl
bowl	bol
bowls	bolz
box	baks
boys	bOz
boy's	bOz
braid	bred
bran	br@n
branch	br@nC
brand	br@nd
brass	br@s
brave	brev
bray	bre
bread	brEd
break	brek
breaks	breks
breath	brET
breathe	briD
breeze	briz
brick	brIk
bricks	brIks
bridge	brIJ
bright	brYt
bring	brIG
brings	brIGz
broke	brok
brook	brUk
broom	brum
brooms	brumz
broth	brcT
brought	brct
brown	brWn
bruce	brus
bruise	bruz
bruised	bruzd
brush	br^S
brushed	br^St
bud	b^d
bug	b^g
bugged	b^gd
bugs	b^gz
bug's	b^gz
build	bIld
built	bIlt
bull	bUl
bum	b^m
bump	b^mp
bumped	b^mpt
bun	b^n
bunch	b^nC
burn	bRn
burned	bRnd
burnt	bRnt
burp	bRp
burped	bRpt
burt	bRt
bus	b^s
bush	bUS
bust	b^st
butt	b^t
buy	bY
buys	bYz
buzz	b^z
by	bY
bye	bY
cage	keJ
cake	kek
cakes	keks
calf	k@f
call	kcl
called	kcld
calls	kclz
calm	kclm
came	kem
camp	k@mp
cans	k@nz
cap	k@p
car	kar
card	kard
cards	kardz
care	ker
carl	karl
cars	karz
cart	kart
case	kes
casts	k@sts
cat	k@t
catch	k@C
cats	k@ts
cat's	k@ts
caught	kct
cause	kcz
cave	kev
caw	kc
cents	sEnts
chair	Cer
chairs	Cerz
chalk	Cck
chance	C@ns
change	CenJ
changed	CenJd
chap	C@p
charge	CarJ
chart	Cart
chase	Ces
chased	Cest
check	CEk
cheek	Cik
cheeks	Ciks
cheep	Cip
cheers	Cirz
cheese	Ciz
chef	SEf
chest	CEst
chew	Cu
chewed	Cud
chi	kY
chick	CIk
child	CYld
chime	CYm
chimes	CYmz
chin	CIn
chip	CIp
chips	CIps
chirp	CRp
choke	Cok
choo	Cu
choose	Cuz
chop	Cap
chris	krIs
christ	krYst
church	CRC
chute	Sut
clamp	kl@mp
clap	kl@p
claus	klWs
clean	klin
cleaned	klind
cleans	klinz
clear	klir
click	klIk
climb	klYm
climbed	klYmd
climbs	klYmz
clink	klIGk
clip	klIp
clips	klIps
clock	klak
close	klos
closed	klozd
cloth	klcT
clothes	kloDz
cloud	klWd
clouds	klWdz
clown	klWn
club	kl^b
cluck	kl^k
clues	kluz
clutch	kl^C
coat	kot
coins	kOnz
cold	kold
colts	kolts
comb	kom
combed	komd
comes	k^mz
cone	kon
cook	kUk
cooks	kUks
cool	kul
cooled	kuld
coop	kup
cord	kcrd
cords	kcrdz
cork	kcrk
corked	kcrkt
corn	kcrn
cost	kcst
costs	kcsts
couch	kWC
cough	kcf
could	kUd
count	kWnt
counts	kWnts
course	kors
cow	kW
cows	kWz
cow's	kWz
crab	kr@b
crack	kr@k
crank	kr@Gk
crap	kr@p
crash	kr@S
crawl	krcl
crawled	krcld
crawls	krclz
cream	krim
creek	krik
creep	krip
crew	kru
crib	krIb
cried	krYd
croak	krok
cross	krcs
crow	kro
crowed	krod
crown	krWn
cruise	kruz
crumbs	kr^mz
crunch	kr^nC
crush	kr^S
cry	krY
cub	k^b
cup	k^p
cups	k^ps
curl	kRl
curled	kRld
cut	k^t
cute	kyut
da	da
dab	d@b
dad	d@d
dad's	d@dz
dame	dem
damp	d@mp
dance	d@ns
dang	d@G
dare	der
dark	dark
darn	darn
dat	d@t
date	det
dawn	dcn
day	de
days	dez
day's	dez
daze	dez
dead	dEd
deal	dil
dear	dir
deck	dEk
deep	dip
deer	dir
dell	dEl
desk	dEsk
dew	du
dial	dYl
die	dY
died	dYd
dig	dIg
ding	dIG
dip	dIp
dips	dIps
dirt	dRt
disc	dIsk
dish	dIS
dive	dYv
dock	dak
dog	dcg
dogs	dcgz
dog's	dcgz
doll	dcl
dolls	dclz
don	dan
done	d^n
dong	daG
doo	du
door	dor
doors	dorz
dos	dcs
dot	dat
doubt	dWt
drag	dr@g
dragged	dr@gd
drain	dren
drank	dr@Gk
draw	drc
drawer	drcr
drawers	drcrz
draws	drcz
dream	drim
dreamed	drimd
dreams	drimz
drenched	drEnCt
dress	drEs
dressed	drEst
dried	drYd
drill	drIl
drink	drIGk
drinks	drIGks
drip	drIp
drive	drYv
drool	drul
drop	drap
dropped	drapt
drops	draps
drum	dr^m
drums	dr^mz
drunk	dr^Gk
dry	drY
dub	d^b
duck	d^k
ducks	d^ks
dude	dud
due	du
dum	d^m
dumb	d^m
dump	d^mp
dumped	d^mpt
dust	d^st
dwight	wYt
dye	dY
each	iC
ear	ir
ears	irz
earth	RT
ease	iz
eats	its
edge	EJ
egg	Eg
eggs	Egz
eight	et
else	Els
end	End
ends	Endz
eve	iv
eye	Y
eyes	Yz
face	fes
fact	f@kt
fair	fer
fake	fek
fall	fcl
falls	fclz
fan	f@n
far	far
farm	farm
fast	f@st
fat	f@t
fault	fclt
faye	fe
fear	fir
fed	fEd
fee	fi
feed	fid
feeds	fidz
feel	fil
feels	filz
feet	fit
fell	fEl
felt	fElt
fence	fEns
fetch	fEC
few	fyu
field	fild
fight	fYt
figs	fIgz
fill	fIl
filled	fIld
film	fIlm
fin	fIn
find	fYnd
finds	fYndz
fine	fYn
fir	fR
fire	fYr
first	fRst
fish	fIS
fist	fIst
fists	fIsts
fit	fIt
fits	fIts
five	fYv
fix	fIks
fixed	fIkst
flag	fl@g
flakes	fleks
flap	fl@p
flash	fl@S
flat	fl@t
fleas	fliz
flew	flu
flip	flIp
float	flot
floats	flots
floor	flor
flop	flap
flow	flo
fluff	fl^f
flush	fl^S
fly	flY
fold	fold
folks	foks
food	fud
foods	fudz
fool	ful
foot	fUt
foots	fUts
fork	fcrk
formed	fcrmd
forth	forT
found	fWnd
four	for
fourth	forT
fox	fcks
frame	frem
freak	frik
fred	frEd
free	fri
freeze	friz
french	frEnC
fresh	frES
fridge	frIJ
friend	frEnd
friends	frEndz
frill	frIl
frog	frcg
frogs	frcgz
from	fr^m
front	fr^nt
fronts	fr^nts
fruit	frut
fry	frY
full	fUl
fun	f^n
fur	fR
fuss	f^s
fuzz	f^z
game	gem
games	gemz
gap	g@p
gas	g@s
gate	get
gave	gev
gear	gir
gee	Ji
geese	gis
gene	Jin
gets	gEts
ghost	gost
gift	gIft
gifts	gIfs
girls	gRlz
give	gIv
gives	gIvz
glad	gl@d
glass	gl@s
globe	glob
gloves	gl^vz
glue	glu
glued	glud
gnat	n@t
goal	gol
goat	got
goats	gots
god	gad
god's	gadz
goes	goz
gold	gold
golf	gclf
gone	gcn
goose	gus
gosh	gaS
grab	gr@b
grabbed	gr@bd
grace	gres
graham	gre/xm
grams	gr@mz
grape	grep
grapes	greps
grass	gr@s
gray	gre
grease	gris
great	gret
greece	gris
greek	grik
green	grin
greg	grEg
grew	gru
grey	gre
grief	grif
grill	grIl
grilled	grIld
grin	grIn
grinch	grInC
grip	grIp
grit	grIt
grits	grIts
gross	gros
grouch	grWC
ground	grWnd
groups	grups
grow	gro
growl	grWl
growled	grWld
grown	gron
grunt	gr^nt
guard	gard
guards	gardz
guess	gEs
guests	gEsts
gum	g^m
gump	g^mp
gums	g^mz
gus	g^s
guy	gY
guys	gYz
gym	JIm
ha	ha
had	h@d
hair	her
haired	herd
hairs	herz
half	h@f
hall	hcl
ham	h@m
hand	h@nd
hands	h@ndz
hand's	h@ndz
hang	h@G
hangs	h@Gz
hard	hard
hare	her
hash	h@S
hat	h@t
hate	het
hats	h@ts
hay	he
head	hEd
heads	hEdz
health	hElT
hear	hir
heard	hRd
hears	hirz
heart	hart
heat	hit
he'd	hid
hee	hi
held	hEld
hell	hEl
he'll	hil
help	hElp
helped	hElpt
helps	hElps
hen	hEn
hens	hEnz
here's	hirz
hers	hRz
he's	hiz
hid	hId
hide	hYd
high	hY
hike	hYk
hill	hIl
hills	hIlz
hint	hInt
hip	hIp
hit	hIt
hits	hIts
ho	ho
hoe	ho
hog	hcg
hold	hold
hole	hol
holes	holz
home	hom
honk	hcGk
hood	hUd
hook	hUk
hooked	hUkt
hoops	hups
hoot	hut
hop	hap
hope	hop
hopes	hops
hopped	hapt
hops	haps
horn	hcrn
horns	hcrnz
horse	hcrs
hose	hoz
hosts	hosts
hot	hat
hound	hWnd
hour	W/R
hours	W/Rz
house	hWz
how'd	hWd
how's	hWz
huff	h^f
huffed	h^ft
hug	h^g
huge	hyuJ
hugged	h^gd
hugs	h^gz
hum	h^m
hung	h^G
hunt	h^nt
hurt	hRt
hurts	hRts
hush	h^S
hut	h^t
ice	Ys
i'd	Yd
if	If
i'll	Yl
ink	IGk
itch	IC
its	Its
i've	Yv
jack	J@k
jacks	J@ks
jake	Jek
jam	J@m
james	Jemz
jane	Jen
jar	Jar
jars	Jarz
jay	Je
jeans	Jinz
jeez	Jiz
jeff	JEf
jerk	JRk
jig	JIg
jill	JIl
job	Jab
joe	Jo
jog	Jag
john	Jan
join	JOn
joke	Jok
joy	JO
jug	J^g
juice	Jus
jump	J^mp
jumped	J^mpt
jumps	J^mps
june	Jun
junk	J^Gk
keep	kip
keeps	kips
kept	kEpt
key	ki
keys	kiz
kick	kIk
kicked	kIkt
kid	kId
kids	kIdz
kill	kIl
kim	kIm
kind	kYnd
kinds	kYndz
king	kIG
kings	kIGz
king's	kIGz
kiss	kIs
kissed	kIst
kit	kIt
kite	kYt
knee	ni
knees	niz
knew	nu
knob	nab
knock	nak
knocked	nakt
knot	nat
known	non
knows	noz
kool	kul
la	la
lake	lek
lamb	l@m
lambs	l@mz
lamp	l@mp
land	l@nd
lane	len
lap	l@p
large	larJ
last	l@st
late	let
laugh	l@f
lawn	lcn
lay	le
layed	led
leaf	lif
lean	lin
leap	lip
learn	lRn
learned	lRnd
least	list
leave	liv
leaves	livz
left	lEft
leg	lEg
legs	lEgz
less	lEs
lick	lIk
licked	lIkt
licks	lIks
lid	lId
lids	lIdz
lie	lY
life	lYf
lift	lIft
light	lYt
lights	lYts
light's	lYts
liked	lYkt
likes	lYks
lime	lYm
line	lYn
lint	lInt
lip	lIp
lips	lIps
list	lIst
live	lIv
lived	lIvd
lives	lIvz
liz	lIz
load	lod
loads	lodz
loaf	lof
lock	lak
locked	lakt
long	lcG
looked	lUkt
looks	lUks
loops	lups
loose	lus
lord	lcrd
lord's	lcrdz
lose	luz
lost	lcst
lot	lat
lots	lats
lot's	lats
loud	lWd
love	l^v
loved	l^vd
loves	l^vz
low	lo
lunch	l^nC
lynn	lIn
ma	ma
ma'am	m@m
mad	m@d
made	med
mag	m@g
mags	m@gz
maid	med
maids	medz
mail	mel
main	men
make	mek
makes	meks
man	m@n
march	marC
mark	mark
marks	marks
mashed	m@St
mat	m@t
match	m@C
matt	m@t
max	m@ks
may	me
meal	mil
mean	min
means	minz
meant	mEnt
meat	mit
meet	mit
meg	mEg
melt	mElt
men	mEn
mess	mEs
messed	mEst
met	mEt
mice	mYs
might	mYt
mike	mYk
milk	mIlk
mind	mYnd
mine	mYn
miss	mIs
missed	mIst
mix	mIks
mixed	mIkst
moat	mot
mode	mod
mom	mam
moms	mamz
mom's	mamz
month	m^nT
months	m^nTs
moo	mu
mood	mud
moon	mun
moose	mus
mop	map
most	most
mouse	mWs
mouth	mWT
move	muv
moved	muvd
moves	muvz
mow	mo
much	m^C
mud	m^d
mug	m^g
munch	m^nC
mush	m^S
must	m^st
nah	nR
nail	nel
nails	nelz
name	nem
named	nemd
nap	n@p
near	nir
neat	nit
neck	nEk
ned	nEd
need	nid
needs	nidz
neigh	ne
nest	nEst
nests	nEsts
net	nEt
new	nu
news	nuz
next	nEkst
nice	nYs
nick	nIk
night	nYt
nights	nYts
nine	nYn
ninth	nYnT
noise	nOz
none	n^n
nope	nop
nor	ncr
nose	noz
note	not
nurse	nRs
nut	n^t
nuts	n^ts
oats	ots
oil	Ol
old	old
once	w^ns
ones	w^nz
one's	w^nz
oops	ups
ouch	WC
ought	ct
ounce	Wns
ow	W
owl	Wl
owls	Wlz
own	on
pack	p@k
packed	p@kt
pad	p@d
page	peJ
pail	pel
pain	pen
paint	pent
pair	per
pan	p@n
pants	p@nts
park	park
part	part
parts	parts
pass	p@s
passed	p@st
past	p@st
pat	p@t
patch	p@C
path	p@T
pats	p@ts
paul	pcl
pause	pcz
pay	pe
pea	pi
peace	pis
peach	piC
pear	per
pearl	pRl
pears	perz
peas	piz
pee	pi
peek	pik
peep	pip
peg	pEg
pegs	pEgz
pen	pEn
pet	pEt
phil	fIl
phone	fon
phone's	fonz
pick	pIk
picked	pIkt
picks	pIks
picture	pIk/CR
pie	pY
piece	pis
pies	pYz
pig	pIg
pigs	pIgz
pile	pYl
pin	pIn
pinch	pInC
pinched	pInCt
pine	pYn
pink	pIGk
place	ples
plain	plen
plan	pl@n
plane	plen
plant	pl@nt
plants	pl@nts
plate	plet
played	pled
plays	plez
please	pliz
pleased	plizd
plop	plap
plug	pl^g
plugged	pl^gd
plum	pl^m
plums	pl^mz
plus	pl^s
pod	pad
point	pOnt
points	pOnts
poke	pok
poked	pokt
pond	pand
poo	pu
pooh	pu
pool	pul
poop	pup
poops	pups
poor	pUr
pop	pap
popped	papt
porch	porC
post	post
pot	pat
pots	pats
pouch	pWC
pounds	pWndz
pour	por
poured	pord
pow	pW
praise	prez
praised	prezd
pray	pre
prayer	prer
prayers	prerz
press	prEs
prince	prIns
pro	pro
proud	prWd
psalms	samz
puff	p^f
puffed	p^ft
pull	pUl
pulled	pUld
punch	p^nC
purr	pR
purse	pRs
push	pUS
pushed	pUSt
puts	pUts
quack	kw@k
queen	kwin
quick	kwIk
quilt	kwIlt
quit	kwIt
quite	kwYt
race	res
rag	r@g
rain	ren
rained	rend
rains	renz
ran	r@n
range	renJ
rash	r@S
ray	re
reach	riC
reached	riCt
read	rEd
reads	ridz
real	ril
red	rEd
rest	rEst
rice	rYs
rich	rIC
rick	rIk
rid	rId
ride	rYd
ring	rIG
rings	rIGz
rinse	rIns
rip	rIp
ripe	rYp
ripped	rIpt
road	rod
roar	ror
roast	rost
rock	rak
rocks	raks
roll	rol
rolled	rold
rolls	rolz
roof	rUf
room	rum
root	rUt
rope	rop
rose	roz
rough	r^f
round	rWnd
row	rW
roy	rO
rub	r^b
rude	rud
rug	r^g
rule	rul
run	r^n
runs	r^nz
rush	r^S
sad	s@d
safe	sef
said	sEd
sailed	seld
sale	sel
salt	sclt
sam	s@m
same	sem
sand	s@nd
sang	s@G
sat	s@t
sauce	scs
save	sev
saved	sevd
saw	sc
says	sEz
scale	skel
scare	sker
scared	skerd
scarf	skarf
school	skul
scoop	skup
scoot	skut
scraped	skrept
scratch	skr@C
scratched	skr@Ct
scream	skrim
screen	skrin
scrub	skr^b
sea	si
seal	sil
sean	Scn
searched	sRCt
seat	sit
seats	sits
seed	sid
seeds	sidz
seek	sik
seem	sim
seems	simz
seen	sin
sees	siz
self	sElf
send	sEnd
sense	sEns
sent	sEnt
serve	sRv
set	sEt
seuss	sus
sewed	sod
shade	Sed
shades	Sedz
shake	Sek
shakes	Seks
shall	S@l
shame	Sem
shape	Sep
shaped	Sept
shapes	Seps
share	Ser
sharp	Sarp
she	Si
she'd	Sid
sheep	Sip
sheet	Sit
sheets	Sits
shelf	SElf
shell	SEl
she'll	Sil
she's	Siz
shield	Sild
shift	SIft
shine	SYn
ship	SIp
shirt	SRt
shirts	SRts
shoe	Su
shoes	Suz
shook	SUk
shoot	Sut
short	Scrt
shorts	Scrts
should	SUd
shout	SWt
shove	S^v
show	So
shows	Soz
shred	rEd
shrimp	rImp
shut	S^t
shy	SY
sick	sIk
side	sYd
sides	sYdz
sight	sYt
sign	sYn
since	sIns
sing	sIG
sink	sIGk
sip	sIp
sir	sR
sit	sIt
sits	sIts
six	sIks
size	sYz
skates	skets
skies	skYz
skin	skIn
skip	skIp
skipped	skIpt
skirt	skRt
sky	skY
slam	sl@m
slash	sl@S
sleep	slip
sleeps	slips
sleeve	sliv
sleeves	slivz
slept	slEpt
slice	slYs
slick	slIk
slide	slYd
slink	slIGk
slip	slIp
slot	slat
slow	slo
smack	sm@k
small	smcl
smart	smart
smell	smEl
smells	smElz
smile	smYl
smoke	smok
smooth	smuD
smush	sm^S
snack	sn@k
snacks	sn@ks
snake	snek
snakes	sneks
snap	sn@p
snapped	sn@pt
snaps	sn@ps
snatch	sn@C
sneeze	sniz
sneezed	snizd
snip	snIp
snort	sncrt
snot	snat
snow	sno
snug	sn^g
soaked	sokt
soap	sop
sock	sak
socks	saks
soft	scft
soiled	sOld
sold	sold
son	s^n
song	scG
songs	scGz
soon	sun
sopped	sapt
sore	sor
sort	scrt
sorts	scrts
sound	sWnd
sounds	sWndz
soup	sup
soups	sups
sour	sW/R
space	spes
spank	sp@Gk
spare	sper
speak	spik
spend	spEnd
spice	spYs
spill	spIl
spilled	spIld
spin	spIn
spins	spInz
spit	spIt
spits	spIts
splash	spl@S
splashed	spl@St
splat	spl@t
spoiled	spOld
spoke	spok
sponge	sp^nJ
spoon	spun
spoons	spunz
spot	spat
spout	spWt
spray	spre
spread	sprEd
spring	sprIG
spud	sp^d
square	skwer
squash	skwaS
squeak	skwik
squeaks	skwiks
squeal	skwil
squealed	skwild
squeeze	skwiz
squirm	skwRm
squirrel	skw/Rrxl
squirrels	skwR/rxlz
squirt	skwRt
squish	skwIS
stack	st@k
stain	sten
stair	ster
stairs	sterz
stall	stcl
stamp	st@mp
stand	st@nd
stands	st@ndz
star	star
stars	starz
start	start
starts	starts
stay	ste
stayed	sted
stays	stez
steal	stil
steer	stir
stem	stEm
step	stEp
stepped	stEpt
steps	stEps
stew	stu
stick	stIk
sticks	stIks
still	stIl
sting	stIG
stink	stIGk
stinks	stIGks
stir	stR
stole	stol
stomp	stamp
stomped	stampt
stones	stonz
stood	stUd
stop	stap
stopped	stapt
stops	staps
store	stor
storm	stcrm
stout	stWt
stove	stov
straight	stret
strange	strenJ
strap	str@p
straw	strc
stream	strim
street	strit
strength	strEGkT
stressed	strEst
stretch	strEC
string	strIG
strings	strIGz
stroke	strok
stroll	strol
strong	strcG
strum	str^m
stuck	st^k
stuff	st^f
stuffed	st^ft
stung	st^G
style	stYl
such	s^C
suck	s^k
sucks	s^ks
suds	s^dz
suit	sut
sun	s^n
sun's	s^nz
sure	SUr
sweep	swip
sweet	swit
sweets	swits
swim	swIm
swing	swIG
swish	swIS
switch	swIC
swoosh	swUS
ta	ta
tab	t@b
tad	t@d
tag	t@g
tags	t@gz
tail	tel
tails	telz
takes	teks
talk	tck
talked	tckt
talks	tcks
tall	tcl
tank	t@Gk
tap	t@p
tape	tep
taste	test
tastes	tests
taught	tct
tea	ti
teach	tiC
team	tim
tear	tEr
tears	tErz
tee	ti
teeth	tiT
tell	tEl
tells	tElz
ten	tEn
tent	tEnt
test	tEst
thanks	T@Gks
thee	Di
then	DEn
these	Diz
they'd	Ded
they'll	Del
they're	Der
they've	Dev
thick	TIk
thin	TIn
thing	TIG
things	TIGz
thinks	TIGks
third	TRd
thorns	Tcrnz
though	Do
thought	Tct
thread	TrEd
three	Tri
threw	Tru
throat	Trot
throats	Trots
through	Tru
throw	Tro
thrown	Tron
throws	Troz
thumb	T^m
thumbs	T^mz
thy	DY
tic	tIk
tick	tIk
tie	tY
tied	tYd
tight	tYt
tilt	tIlt
tim	tIm
time	tYm
times	tYmz
tip	tIp
tire	tYr
tired	tYrd
toast	tost
tock	tak
toe	to
toes	toz
told	told
tom	tam
tom's	tamz
tongue	t^G
took	tUk
tool	tul
tools	tulz
tooth	tuT
top	tap
tore	tor
toss	tcs
touch	t^C
touched	t^Ct
tough	t^f
tow	to
towel	tWl
towels	tWlz
town	tWn
toy	tO
toys	tOz
track	tr@k
train	tren
trapped	tr@pt
trash	tr@S
tray	tre
treat	trit
treats	trits
tree	tri
trees	triz
trick	trIk
tricked	trIkt
tried	trYd
trim	trIm
trip	trIp
trough	trcf
trout	trWt
truck	tr^k
trucks	tr^ks
trust	tr^st
truth	truT
try	trY
tub	t^b
tuck	t^k
tug	t^g
tune	tun
turn	tRn
turned	tRnd
turns	tRnz
tweet	twit
twelve	twElv
twist	twIst
two	tu
twos	tuz
ty	tY
type	tYp
ugh	^g
uh	^
um	^m
use	yus
used	yuzd
van	v@n
vane	ven
vent	vEnt
view	yu
vine	vYn
voice	vOs
vole	vol
wag	w@g
wah	wa
wait	wet
wake	wek
walk	wck
walked	wckt
walks	wcks
wall	wcl
wand	wand
wants	w^nts
war	wcr
warm	wcrm
wash	wcS
washed	wcSt
waste	west
watch	waC
watched	waCt
wave	wev
waved	wevd
waves	wevz
way	we
ways	wez
weak	wik
wear	wer
wears	werz
web	wEb
webs	wEbz
wee	wi
weeds	widz
week	wik
weeks	wiks
weird	wird
we'll	wil
went	wEnt
were	wR
we're	wir
weren't	wRnt
wet	wEt
we've	wiv
whack	w@k
whale	wel
wham	w@m
what'd	w^/tId
wheat	wit
wheel	wil
wheels	wilz
when	wEn
where'd	werd
whew	wEw
which	wIC
while	wYl
whine	wYn
whip	wIp
white	wYt
who	hu
whoa	wo
whole	hol
whom	hum
whoops	wups
who's	huz
whose	huz
why	wY
wide	wYd
wife	wYf
wild	wYld
will	wIl
win	wIn
wind	wInd
wing	wIG
wings	wIGz
wipe	wYp
wiped	wYpt
wipes	wYps
wire	wYr
wires	wYrz
wish	wIS
witch	wIC
woke	wok
wolf	wUlf
won	w^n
won't	wont
wood	wUd
woods	wUdz
woof	wUf
wool	wUl
word	wRd
words	wRdz
wore	wor
work	wRk
worked	wRkt
works	wRks
world	wRld
worm	wRm
worn	worn
worse	wRs
would	wUd
wow	wW
wrap	r@p
wreath	riT
wreck	rEk
write	rYt
wrong	rcG
wrote	rot
ya	ya
yak	y@k
yams	y@mz
yard	yard
yawn	ycn
yay	ye
ye	yi
yea	ye
year	yir
years	yirz
yeh	yE
yell	yEl
yep	yEp
yet	yEt
york	ycrk
you	yu
you'd	yud
you'll	yul
young	y^G
yours	yUrz
you've	yuv
yuck	y^k
yum	y^m
yup	y^p
zip	zIp
zipped	zIpt
zoo	zu
zoom	zum
chill	CIl
flour	flW/R
flower	flW/R
alice	@/lIs
peekaboo	pi/kx/bu
doggie's	dc/giz
dada	d@/d@
lonesome	lon/sxm
alice's	@/li/sIz
shena	Si/nx
loren	lc/rxn
dolly's	dc/liz
wicked	wI/kxd
zipper's	zI/pRz
mommy's	ma/miz
kiddo	kI/do
hates	hets
sissy	sI/si
destruction	dE/str^k/Sxn
fishie	fI/Si
restrained	ri/strend
mouths	mWTs
kitty's	kI/tiz
flowers	flW/Rz
spanked	sp@N/kt
chomp	Camp
dapper	d@/pR
clobber	klc/bR
brain	bren
ginger's	gIn/ZRz
gigi	Zi/Zi
gigi's	Zi/Ziz
possibly	pa/sx/bli
amelia	x/mi/li/x
earphones	ir/fonz
sneakers	sni/kRz
