a	、
a@l	、
aah	。
abc	、〃〄
abc@l	、〃〄
abcd@l	、〃〄々
abcdefg@k	、〃〄々〆〇〈
abcs	、〃〉
abigail	【】〒
able	、〓
about	〔〕
above	〔〖
absolute	〗〘〙
absolutely	〗〘〙〠
absorbent	〡〢〣
abu	。〤
abuse	〔〥
abuses	〔〦〧
accept	〨〩
acceptable	〨〰〱〓
accepted	〨〰〲
accident	〳〴〵
accidentally	〳〴〶〱〠
accidently	〳〴〷〠
accidents	〳〘〸
accordion	〔〹々぀
account	〔ぁ
accused	〔あ
accustomed	〔ぃい
achieve	〔ぅ
achieved	〔う
achieves	〔ぇ
achieving	〔えぉ
achoo	〔ぐ
acknowledge	〳けげ
acknowledged	〳けこ
acquiesced	【ごさ
acre	、ざ
across	〔し
act	じ
acting	〳す
action	〳だ
activator	〳ちぢっ
active	〳つ
activities	〳ちづて
activity	〳ちづで
actor	〳っ
actorfactormactor	〳っとっどっ
acts	ば
actual	〳ぐぱ
actually	〳ぐ〔〠
ad	ひ
adam	【び
adam's	【ぴ
add	ひ
added	【ふ
addicted	〔ぶ〲
adding	【ぷ
adds	へ
adjustable	〔べむ〓
adjustment	〔めも
adjustments	〔ゃや
adorable	〔ゅゆ〓
adore	〔ょ
adult	〔よ
adults	〔ら
advanced	ひゐ
adventure	ひゑを
advice	ひん
advises	ひゔゕ
afford	〔ゖ
afraid	〔゗
africa	【゘゙
african	【゘㄀
after	㄁っ
afternoon	㄁っ㄂
afterwards	㄁っ㄃
again	〔㄄
against	〔ㄅ
age	ㄆ
aggie	【ㄇ
aggravated	【ㄈぢ〲
aggravating	【ㄈぢす
aggressive	〔ㄉㄐ
agnes	ㄑㄒ
ago	〔ㄓ
agree	〔ㄔ
agreed	〔ㄕ
ah	。
ahab	、ㄖ
ahead	〔ㄗ
ahhah	。ㄘ
ahoy	【ㄙ
aid	ㄠ
aids	ㄡ
aim	ㄢ
aimed	ㄣ
ain't	ㄤ
air	ㄥ
airing	、ㄦ
airline	ㄥㄧ
airplane	ㄥㄨ
airplane's	ㄩ㄰
aisle	ㄱ
aisles	ㄲ
al	ㄳ
aladin	ㄴㄵㄶ
aladin's	〔ㄴㄷ
alarm	〔ㄸ
alcohol	ㄳ゙ㄹ
alex	【ㅀ
alex's	【ㅁㅂ
alexander	【ㅃㅄㅅ
alexander's	【ㅃㅄㅆ
alfredo	ㄳㅇゅ
algae	ㄳ〈
ali	。〠
alibi	【ㅈㅉ
alice	【ㅐ
alice's	【〠〧
alicia's	〔〠ㅑ
alike	〔ㅒ
alive	〔ㅓ
all	ㅔ
alldone	ㅔㅕ
allen	【ㅖ
alligator	【ㅗㅘっ
alligator's	【ㅗㅘㅙ
allow	〔ㅠ
allowed	〔ㅡ
ally	【ㅢ
almost	ㅔㅣ
alone	〔ㅤ
along	〔ㅥ
aloud	〔ㅡ
alpha	ㄳㅦ
alphabet	ㄳㅦㅧ
alphabets	ㄳㅦㅨ
already	ㅔㅩ々
alright	ㅔㅰ
alrightie	ㅔㅱで
also	ㅔㅲ
although	ㅔㅳ
altogether	ㅔ〱ㅴㅵ
always	ㅶㅷ
am	ㅸ
amazed	〔ㅹ
amazement	〔ㆀㆁ
amazing	〔ㆂㆃ
amazingly	〔ㆂㆃ〠
ambitious	ㅸ】ㆄ
ambivalence	ㅸ】ㆅㆆ
amelia	〔ㆇ〠〔
amen	、ㆈ
america	〔ㆉ㆐゙
among	〔㆑
amount	〔㆒
amused	〔㆓
amusing	〔㆔ㆃ
an	㆕
ancient	㆖㆗
and	㆘
andrea's	㆕㆙㈀
andrew's	㆕㈁
andy	㆕々
andy's	㆕㈂
angel	㆖㈃
angelica	㆕㈄ㅗ゙
angels	㆖㈅
angle	㈆㈇
angry	㈆ㄔ
animal	【㈈㈉
animals	【㈈㈐
animosity	【㈈㈑〴で
ankle	㈆㈒
ankles	㈆㈓
ann	㆕
anne	㆕
annie	【㈔
annie's	【㈕
anniversary	【㈈㈖〘㈗
annoying	〔㈘㈙
anorexic	【㈠㈡㈢
another	〔㈣ㅵ
anotherthe	〔㈣ㅵ㈤
answer	㆕㈥
answered	㆕㈦
answering	㆕〘ㄦ
answers	㆕㈧
ant	㈨
anteater	㆕でっ
antenna	㆕㈩㈠
antennaes	㆕㈩㈰
antibiotic	㆕ちㅉ。㈱
antibiotics	㆕ちㅉ。㈲
antisocial	㆕でㅲ㈳
ants	㈴
any	㈵㈔
anybody	㈵㈔㈶々
anyhow	㈵㈔㈷
anymore	㈵㈔㈸
anyone	㈵㈔㈹
anything	㈵㈔㉀
anytime	㈵㈔㉁
anyway	㈵㈔㉂
anyways	㈵㈔㉃
anywhere	㈵㈔㉄
apart	〔㉅
apartment	〔㉆も
aplenty	〔㉇で
apology	〔㉈ㅈ〈
apparent	〔㉉㉐
apparently	〔㉉㉐〠
appeals	〔㉑
appearance	〔㉒㉓
appeared	〔㉔
appetite	【㉕㉖
appiesauce	【㉒㉗
apple	【㉘
apples	【㉙
applesauce	【㉘㉗
appleses	【㉘㉠
applied	〔㉡
applies	〔㉢
apply	〔㉣
applying	〔㉣㉤
appointment	〔㉥ㆁ
appreciate	〔㉦㉧㉨
appreciates	〔㉦㉧㉩
approached	〔㉰
appropriate	〔㉱㈗㉨
apricot	【㉲㉳
apricots	【㉲㉴
apron	、㉵
apronstring	、㉵㉶
aquarium	〔㉷㈗㉸
arc	㉹
arches	㊀㊁
are	㊀
area	、㈗〔
areas	㈵㈗㊂
areil	㈵㊃ぱ
aren't	㊄
arfarf	㊀㊅
argue	㊀㊆
arguing	㊇㊈㈙
argument	㊀㊉ㆁ
arise	〔㊐
ark	㉹
arm	㊑
armadillo	㊀㊒㊓㊔
armhole	㊕㊖
arms	㊗
army	㊀ㆇ
aroonie	〔㊘㈔
around	〔㊙
arrange	〔㌀
arranged	〔㌁
arrangements	〔㌀や
arranging	〔㌂㌃
array	〔㊃
arrived	〔㌄
arriving	〔ㅱぉ
art	㌅
arthur	㊀㌆
article	㊀ち㈒
articles	㊀ち㈓
artillery	㊀ちㅈ㈗
arts	㌇
as	㌈
ashamed	〔㌉
ashes	【㌐
ashley	㌑〠
ashley's	㌑㌒
ashy	【㉧
ask	㌓
asked	㌔
asking	【㌕
asks	㌖
asleep	〔㌗
asparagus	㌘㌙ゆ㌠
aspirate	【㌡㌢
aspirated	【㌣㊃〲
aspirates	【㌡㌤
aspirating	【㌡㊃す
assemble	〔㌥〓
asserting	〔㈥す
assistance	〔㌦㌧
associate	〔ㅲ〄㉨
associated	〔ㅲ〄、〲
associates	〔ㅲ〄㉩
association	〔ㅲ〄、㌨
assortment	〔㌩ㆁ
assume	〔㌰
assumed	〔㌱
at	㌲
ate	㉨
athe	㌳
attach	〔㌴
attached	〔㌵
attaches	【〱㌶
attack	〔㌷
attacked	〔㌸
attacking	〔㌹㍀
attention	〔㍁だ
attic	【㈱
attitude	【ち㍂
attitude	【ち㍂
attractive	〔㍃つ
augmentin	㍄ㆈ㍅
august	ㅶ㍆
aunt	㈨
auntie	㆕で
aunts	㈴
autograph	ㅶ〱㍇
automatic	ㅶ〱㍈㈱
automatically	ㅶ〱㍈ち㍉
automobile	ㅶ〱㊒㍐
avenue	【ㆅ㍑
averaging	㍒㆐㌃
avocado	【ㆅ㍓ゅ
avocados	【ㆅ㍓㍔
aw	ㅶ
awake	〔㍕
awakening	〔㉂゙㍖
aware	〔㍗
away	〔㉂
awesome	ㅶ㍘
awful	ㅶ㍙
awfully	ㅶㅦ〠
awfuls	ㅶ㍠
awkward	ㅶ㍡
ax	㍢
aye	㍣
b	〃
b@l	〃
baa	㍤
baa@o	㍤
baba	㍤㍥
babac	㍤㍦
babar	㍤㍧
babars	㍤㍨
babas	㍤㍩
babble	㍰〓
babbling	㍰㍱
babe	㍲
babes	㍳
babies	㍴㍵
baboo	㍥〤
baboon	㍰㍶
baby	㍴〃
baby's	㍴㍵
babycake	㍴〃㍷
babycakes	㍴〃㍸
babydoll	㍴〃㍹
babydolls	㍴〃㎀
babysat	㍴〃㎁
babysitter	㍴〃〴っ
babysitters	㍴〃〴ㅙ
back	㎂
backdoor	㎂㎃
backed	㎄
backflips	㎂㎅
background	㎂㎆
backie	㍰㎇
backing	㍰㍀
backordered	㍰〹㎈
backs	㎉
backtwist	㎂㎐
backward	㍰㍡
backwards	㍰㎑
backwash	㍰㎒
backyard	㍰㎓
bacon	㍴㄀
bacteria	㎂ち㈗〔
bad	㎔
badido	㍥々ゅ
badly	㎔〠
baebae	㍴㍴
bag	㎕
baggie	㍰ㄇ
baggies	㍰㎖
baggy	㍰ㄇ
bags	㎗
bah	㍤
bailey	㍴〠
bake	㎘
baked	㎙
baker	㍴ざ
baker's	㍴㐀
bakers	㍴㐀
bakes	㐁
baking	㍴㍀
balance	㍰ㆆ
balcony	㐂゙㈔
bald	㐃
ball	㐄
ball's	㐅
ballerina	㍰ㅈ㈗㈠
ballerinas	㍰ㅈ㈗㈰
ballet	㍰㐆
ballgame	㐄㐇
ballie	㐈〠
balling	㐈㐉
balloon	㍥㐐
balloons	㍥㐑
balls	㐅
balmex	㐄㐒
balogna	㍥㊔㈔
baloney	㍥㊔㈔
balooga	㍥㐓㐔
baltimore	㐄ち㐕
bam	㐖
bambi	㐖〃
bambi's	㐖㍵
bambis	㐖㍵
bamboo	㐖〤
banana	㍥㐗㈠
bananas	㍥㐗㈰
band	㐘
bandana	㐙ㄵ㐠
bands	㐡
bang	㐢
banged	㐣
banging	㐢㈙
banillon	㍥㈈㐤
banjo	㐥㐦
bank	㐧
banner	㍰㐠
bantam	㐥㐨
baps	㐩
bar	㍧
barbecue	㍧㍥㐰
barbells	㍧㐱
barber	㍧㐲
barbie	㍧〃
barbies	㍧㍵
barbwire	㐳㐴
barefoot	㐵㐶
barefooted	㐵㐷〲
barely	㐵〠
baring	㍴ㄦ
bark	㐸
barked	㐹
barking	㍧㍀
barkley	㍧㍉
barks	㑀
barley	㍧〠
barn	㑁
barney	㍧㈔
barney's	㍧㈕
barrel	㍰㑂
barrels	㍰㑃
barrette	㍥㑄
barrettes	㍥㑅
barron	㑆㑇
barroon	㍥㑈
barroons	㍥㑉
bars	㍨
bart	㑐
base	㑑
baseball	㑑㐄
baseballs	㑑㐅
basement	㑑ㆁ
bashful	㑒㍙
basic	㍴㈢
basically	㍴〴㍉
basics	㍴㑓
basil	㍰㑔
basil's	㍴㑕
basket	㑖㑗
basket's	㍰㑘
basketball	㍰㑙㐄
basketballs	㍰㑙㐅
basketful	㍰㑙㍙
baskets	㍰㑘
baster	㍴㑠
basty	㍴㑡
bat	㑢
bath	㑣
bathie	㍰㑤
bathing	㍴㑥
bathingsuit	㍴㑥㑦
bathingsuits	㍴㑥㑧
bathroom	㍰㑨
bathrooms	㍰㑩
baths	㑰
bathtime	㑣㉁
bathtub	㑣㑱
batman	㑢㑲
bats	㑳
batter	㍰っ
batteries	㍰〱㑴
battery	㍰〱㈗
battery's	㍰っ㑵
battle	㍰㑶
batty	㍰で
bay	㍴
be	〃
beach	㑷
bead	㑸
beads	㑹
beady	〃々
beak	㒀
bean	㒁
beanbag	㒁㎕
beanie	〃㈔
beans	㒂
beanstalk	㒁㒃
bear	㐵
bear's	㒄
bearbrown	㒅㒆
beard	㒇
bears	㒈
beast	㒉
beastly	㒐㒑
beat	㒒
beaten	〃㒓
beaters	〃ㅙ
beating	〃す
beatrix	〃㒔
beautician	〦ちだ
beautiful	〦ち㍙
beautifully	〦ちㅦ〠
beauty	〦で
beavers	〃㒕
bebe	㍴㍴
became	㍥㒖
because	㍥㒗
become	】㒘
becomes	】㒙
becoming	】ぃ㔀
bed	㔁
bed's	㔂
beddybye	㑆々ㅉ
bedroom	㑆㔃
beds	㔂
bedspread	㔁㔄
bedtime	㔁㉁
bee	〃
bee's	㍵
beef	㔅
been	㔆
beep	㔇
beeper	〃㔈
beeps	㔉
beer	㔐
bees	㍵
beet	㒒
beetie	〃で
beetle	〃㑶
beetles	〃㔑
beets	㔒
before	㍥㔓
beg	㔔
began	㍥㔕
beggar	㑆㔖
begging	㑆㔗
begin	㍥㔘
beginner	】㔙㐠
beginning	㍥㔙㍖
begins	㍥㔠
begun	㍥㔡
behaved	㍥㔢
behavior	】㔣㔤
behind	㍥㔥
being	〃㈙
beings	〃㔦
belch	㔧
belches	㔨㊁
belief	】㔩
believe	㍥㔰
believed	㍥㔱
believes	】㔲
bell	㔨
bellies	㑆㌒
belligerent	㍥ㅗ㔳㉐
bellowed	㑆㔴
bells	㐱
belly	㑆〠
bellybutton	㑆〠㈶㒓
belong	㍥ㅥ
belongs	㍥㔵
below	㍥㊔
belt	㔶
belts	㔷
ben	㔸
ben's	㔹
bench	㕀
bend	㕁
bended	㔸ふ
bending	㔸ぷ
beneath	㍥㕂
benjamin	㔸㕃㕄
bent	㕅
berries	㑆㑴
berry	㑆㈗
bert	㕆
bert's	㕇
bertha's	㐲㕈
beside	㍥㕉
besides	㍥㕐
best	㕑
bestest	㑆㕒
bet	ㅧ
beth	㕓
better	㑆っ
betty	㑆で
between	㍥㕔
beverage	㑆ㆅ㕕
beyond	〃㕖
bib	㕗
bibbie	】〃
bible	ㅉ〓
bibs	㕘
bicycle	ㅉ〴㈒
bid	㕙
big	㕠
bigger	】㔖
biggest	】㍆
bike	㕡
bike's	㕢
bikes	㕢
bill	㕣
bills	㕤
billy	】〠
bin	㔆
bing@o	㕥
bingo	㕥ㄓ
binkie	㕥㎇
binkies	㕥㕦
binoculars	ㅉけ㕧㕨
binya	㔆㕩
bird	㕰
bird's	㕱
birdfeeder	㕰㕲ㅅ
birdie	㐲々
birdie's	㐲㈂
birdies	㐲㈂
birds	㕱
birth	㕳
birthday	㕳㕴
biscuits	】㑘
bit	㕵
bite	㕶
bites	㕷
biting	ㅉす
bits	㕸
bitsy	㕵〄
bitter	】っ
bitty	】で
black	㕹
blackberries	㕹㑆㑴
blackberry	㕹㑆㈗
blackbird	㕹㕰
blackbirds	㕹㕱
blade	㖀
blades	㖁
blah	㖂
blame	㖃
blank	㖄
blanket	㖅㑗
blanketie	㖅㖆で
blankets	㖅㖇
blankie	㖅㎇
blankies	㖅㕦
blast	㖈
bleach	㖉
bleached	㖐
bleaching	㖑㖒
bleed	㖓
blend	㖔
blends	㖕
bless	㖖
blessed	㖗㖘
blessing	㖗㖙
blessings	㖗㘀
blew	㘁
blind	㘂
blinds	㘃
blink	㘄
blinking	㍱㍀
block	㘅
block's	㘆
blockbuster	㘅㈶㑠
blocked	㘇
blockhead	㘅ㄗ
blockie	㖂㎇
blockies	㖂㕦
blocking	㖂㍀
blocks	㘆
blond	㘈
blonde	㘈
blood	㘉
bloom	㘐
blooming	㘁㔀
blossomed	㖂㘑
blouse	㘒
blow	㘓
blowing	㘓㈙
blows	㘔
blowup	㘓㘕
blue	㘁
blue's	㘖
blueberries	㘁㑆㑴
blueberry	㘁㑆㈗
blush	㘗
blustery	㘘む㈗
bo	㘙
board	㘠
boarded	㘡ふ
boat	㘢
boats	㘣
bob	㘤
bobbing	㍤㕥
bobbling	㍤㍥㐉
bobby	㍤〃
bobo	㘙㘙
boboneen	㘙㘙㘥
boboni	㘙㘙㈔
boboon	㘙㍶
boboonie	㘙〤㈔
body	㍤々
bog	㘦
bogus	㘙㌠
boil	㘧
boiled	㘨
boiling	㘩㐉
boing	㘰
bologna	㍥㊔㈔
bond	㘱
bone	㘲
boneen	㘙㘥
boneen's	㘙㘳
boneene	㘙㘥
boneeno	㘙㈔㘴
bones	㘵
bong	㘶
bongo	㘶ㄓ
bongos	㘶㘷
bonk	㘸
bonked	㘹
bonkie	㘶㎇
bonking	㘶㍀
bonnet	㍤㙀
bonny	㍤㈔
bony	㘙㈔
boo	〤
boobie	〤〃
booboo	〤〤
boobooing@n	〤〤㈙
booboon	〤㍶
booboon's	〤㙁
booboonee	〤〤㈔
boobooneen	〤〤㘥
boobooneen's	〤〤㘳
boobooneeno	〤〤㈔㘴
booboonino	〤〤㈔㘴
booboos	〤㙂
boobooshas	〤〤ㅑ
booger	㙃㔖
boogers	㙃㙄
boogie	㙃ㄇ
boogies	㙃㎖
boogyman	㙃ㄇ㑲
book	㙅
bookbag	㙅㎕
bookcase	㙅㙆
bookie	㙃㎇
bookies	㙃㕦
books	㙇
boom	㙈
boom@o	㙈
boomdie	㙈々
boomerang	〤㊒㙉
booms	㙐
boomsie	㙈㙑
booneenie	〤㈔㈔
boonie	〤㈔
boop	㙒
boops@o	㙓
boopsieboo	㙒〄〤
boosh	㙔
booshaboosh	〤㙕㙔
boost	㙖
booster	㙗っ
boot	㙘
bootiebooshas	〤で〤ㅑ
booties	〤て
boots	㙙
booty	〤で
bop	㙠
bop's	㙡
boppety	㍤㙢で
bored	㘠
boring	㘙ㄦ
born	㙣
borrowed	㍤㙤
borrowing	㍤㙥㈙
bossing	㐈㖙
boston	㐈㙦
both	㙧
bother	㍤ㅵ
bothered	㍤㙨
bothering	㍤㈤ㄦ
bothers	㍤㙩
bottle	㍤㑶
bottles	㍤㔑
bottom	㍤㐨
bottoms	㍤㙰
bough	㙱
bought	㙲
bounce	㙳
bounced	㙴
bouncer	㙵㈥
bounces	㙵〧
bouncie	㙶〄
bouncing	㙵㖙
bouncy	㙵〄
bounder	㙵ㅅ
bounds	㙷
bout	〕
bow	㙱
bowed	㙸
bowel	㙹
bowels	㚀
bowing	㙱㈙
bowl	㚁
bowls	㚂
bows	㚃
bowwow	㙱㚄
bowwow@o	㙱㚄
box	㚅
boxes	㍦〧
boy	㘩
boy's	㚆
boys	㚆
boyser	㘩㚇
boyz	㚆
bra	㚈
bracelet	㚉㚐
braid	㚑
braiding	㚒ぷ
brain	㚓
bran	㚔
branch	㚕
branches	㚔㊁
brand	㚖
brandnew	㚖㍑
brass	㚗
brat	㚘
brave	㚙
bray	㚒
bread	㜀
break	㜁
breakable	㚒゙〓
breakfast	㜂㜃
breaking	㚒㍀
breaks	㜄
breast	㜅
breath	㜆
breathe	㜇
breather	㜈ㅵ
breathing	㜈㑥
breeze	㜉
brenda	㜐㜑
brenda's	㜐㜒
brendan	㜐ㄶ
brian	㜓぀
brick	㜔
bricks	㜕
bridge	㜖
bridges	㜗㜘
briefcase	㜙㙆
bright	㜠
brighter	㜓っ
brightness	㜠ㄒ
brigitte	㜗㜡
brigitte's	㜗㜢
brilliant	㜗㜣
bring	㜤
bringing	㜤㈙
brings	㜥
brisco	㜗㜦
brisco's	㜗㜧
bristle	㜗㜨
bristles	㜗㜩
britches	㜗㊁
brittany	㜗ち㈔
brittney	㜰㈔
brittney's	㜰㈕
broad	㜱
broader	㜲ㅅ
broccoli	㚈゙〠
brocovich	㚈゙㜳
broke	㜴
broken	㜵㄀
brokenhearted	㜵㄀㜶㜷
brook	㜸
brooklyn	㜹㝀
broom	㝁
brooms	㝂
broth	㝃
brother	㝄ㅵ
brothers	㝄㙩
brought	㝅
brown	㒆
brownies	㝆㈕
browns	㝇
brows	㝈
brr	㐲
bruce	㝉
bruise	㝐
bruised	㝑
brunch	㝒
brush	㝓
brusha	㝄㙕
brushed	㝔
brushes	㝄㌐
brushing	㝄㝕
bub	㝖
bubbilicious	㈶】ㅗ㝗
bubble	㈶〓
bubbler	㈶㍥㝘
bubbles	㈶㝙
bubblicious	㈶㝠㝗
bubbly	㈶㖑
buckaroo	㈶゙㊘
bucket	㈶㑗
buckets	㈶㖇
buckle	㈶㈒
buckled	㈶㝡
buckles	㈶㈓
buckling	㈶㝢
bucks	㝣
bucky	㈶㎇
bud	㝤
buddies	㈶㈂
buddy	㈶々
buds	㝥
bug	㝦
bug's	㝧
bugged	㝨
buggie	㈶ㄇ
bugging	㈶㔗
bugs	㝧
build	㝩
builded	㕣㝰
building	㕣ぷ
buildings	㕣㝱
builds	㝲
built	㝳
bull	㝴
bullfrog	㝴㝵
bully	㙃〠
bullying	㙃〠㈙
bullys	㙃㌒
bum	㝶
bumblebee	㝶〓〃
bumblebees	㝶〓㍵
bumbling	㝶㍱
bummed	㝷
bummer	㈶㝸
bummie	㈶ㆇ
bummie's	㈶㝹
bumming	㈶㔀
bump	㞀
bumped	㞁
bumper	㝶㔈
bumping	㝶㞂
bumpity	㝶㉕で
bumps	㞃
bumpy	㝶㉒
bums	㞄
bun	㞅
bunch	㞆
bundle	㞅㞇
bungalow	㞈㐔㊔
bunnies	㈶㈕
bunnies's	㈶㈔㉠
bunny	㈶㈔
bunny's	㈶㈕
bunnyegg	㈶㈔㞉
bunnyrabbit	㈶㈔㞐㕵
bunnyrabbits	㈶㈔㞐㕸
bunnys	㈶㈕
buns	㞑
bunting	㞅す
buried	㑆㞒
burke	㞓
burn	㞔
burned	㞕
burning	㐲㍖
burnt	㞖
burp	㞗
burped	㞘
burper	㐲㔈
burpie	㐲㉒
burping	㐲㞂
burps	㞙
burrow	㐲㙥
burt	㕆
bury	㑆㈗
bus	㠀
buses	㈶〧
bush	㠁
bushed	㠂
bushel	㙃㈳
bushes	㙃㌐
business	㠃ㄒ
businesses	㠃㈠ㅂ
bust	㠄
busted	㈶㠅
buster	㠀っ
busting	㈶㠆
busts	㠇
busy	】㙑
but	㠈
but's	㠉
buts	㠉
butt	㠈
butter	㈶っ
butterball	㈶っ㐄
butterflies	㈶っ㠐
butterfly	㈶㠑ㅢ
butternut	㈶㌹㠒
butternutie@n	㈶っ㈣で
button	㈶㒓
buttoned	㈶㠓
buttonhole	㈶㒓㠔
buttoning	㈶ち㍖
buttons	㈶㠕
butts	㠉
buttsie	㠈〄
buy	ㅉ
buying	ㅉ㈙
buys	㠖
buzz	㠗
buzzing	㈶ㆃ
by	ㅉ
bye	ㅉ
byebye	ㅉㅉ
byebyes	ㅉ㠖
c	〄
c@l	〄
cabbage	㠘㠙
cabinet	㠘】㙀
cabinets	㠘】㠠
cable	㠡〓
caboose	゙㙗
cactus	㠢㠣
cage	㠤
cages	㠡㜘
cake	㍷
cake's	㍸
cakes	㍸
cakie	㠡㎇
caking@n	㠡㍀
calcium	㠥㠦
calculator	㠥㕧㐆っ
calendar	㠘ㅖㅅ
calf	㠧
california	㠘ㅈ㠨㕩
call	㠩
called	㠰
calling	㠱㐉
calls	㠲
calm	㠳
calories	㠘ㅈ㑴
calvary	㠥ㆅ㈗
came	㒖
camel	㠘㈉
camels	㠘㈐
camera	㠘㊒ゆ
cameras	㠘㊒㠴
camp	㠵
campbell	㠶〓
camped	㠷
camping	㠶㞂
camps	㠸
can	㠹
can't	㡀
cancel	㠹㜨
candies	㠹㈂
candle	㠹㞇
candles	㠹㡁
candy	㠹々
cane	㡂
cannot	㠘㡃
cans	㡄
cantaloupe	㠹〱㡅
canton	㠹㒓
cap	㡆
capable	㠡㙢〓
capris	゙㡇
captain	㡆㍅
car	㡈
car's	㡉
carbonation	㡈㍥㡐㌨
card	㡑
cardboard	㡑㘠
cardinal	㡈㊓㡒
cardinals	㡈㊓㡓
cards	㡔
care	㡕
careening	゙㈗㍖
careful	㡕㍙
carefully	㡕ㅦ〠
cares	㡖
carl	㡗
carmen	㡈㡘
carol	㠘㑂
carpet	㡈㡙
carriage	㠘㕕
carrie	㠘㈗
carried	㠘㞒
carries	㡠㑴
carrot	㠘㡡
carrots	㠘㡢
carry	㠘㈗
carrying	㠘㈗㈙
cars	㡉
carseat	㡈㡣
cart	㡤
carton	㡈㒓
cartoon	㡈㡥
cartoons	㡈㡦
carts	㡧
case	㙆
cases	㠡〧
cassy	㠘〄
castle	㠘㜨
castles	㠘㜩
casts	㡨
cat	㡩
cat's	㡰
catalogs	㠘〱㡱
catalogue	㠘〱㡲
catastrophe	゙㡳㡴㕲
catch	㡵
catcher	㠘を
catches	㠘㊁
catching	㠘㖒
catdoor	㡩㎃
categorical	㠘ち㡶㆐㈒
categories	㠘ち㡶㑴
caterpillar	㠘っ㉕㝘
caterpillars	㠘っ㉕㕨
catnaping	㡩㐗㞂
cats	㡰
caught	㡷
cauliflower	㠱ㅗ㡸㡹
cause	㒗
causing	㠱ㆃ
cavalry	㠘ㆅ㢀
cave	㢁
caves	㢂
caw	㠱
cdefg@k	〄々〆〇〈
ceiling	〄㐉
ceilings	〄㢃
celebrate	㢄ㅈ㢅
celebrated	㢄ㅈ㚒㜷
celebrates	㢄ㅈ㢆
celebrating	㢄ㅈ㚒す
celebration	㢄ㅈ㚒㌨
celery	㢄ㅈ㈗
cell	㢇
cells	㢈
cement	〘㢉
cent	㢐
center	㢑っ
centered	㢑㢒
centering	㢑っ㈙
centers	㢑ㅙ
centipede	㢑ち㢓
cents	㢔
century	㢑㢕㈗
cereal	〴㈗ぱ
cereal's	〴㈗㢖
cereals	〴㈗㢖
certain	㈥㒓
certainly	㈥㒓〠
certificate	㈥ち㢗㑗
chafing	㢘㢙
chain	㤀
chains	㤁
chair	㤂
chairs	㤃
chalk	㤄
chalkboard	㤅㤆
challenge	㤇㤈
challenging	㤇ㅖ㌃
chance	㤉
chances	㤐ㅂ
change	㤑
changed	㤒
changes	㤀㜘
changing	㤀㌃
channel	㤇㡒
channels	㤇㡓
chap	㤓
character	㠘㤔っ
characteristic	㡠㤕〱㆐㤖
characters	㠘㤔ㅙ
charge	㤗
charged	㤘
charges	㤙㤠
charging	㤙㌃
charlie	㤙〠
charm	㤡
charming	㤙㔀
chart	㤢
chase	㤣
chased	㤤
chases	㢘〧
chasing	㢘㖙
chat	㤥
check	㤦
checkbook	㤦㙅
checkbook's	㤦㙇
checkbooks	㤦㙇
checking	㤧㍀
checkout	㤧㤨
checks	㤩
chee	え
cheek	㤰
cheekie	え㎇
cheekies	え㕦
cheeks	㤱
cheep	㤲
cheer	㤳
cheerful	㤳㍙
cheerio	㤴㆐㤵
cheerio's	㤶㈗㤷
cheerios	え㈗㤷
cheers	㤸
cheery	え㈗
cheese	㤹
cheeseburger	㤹㐲㔖
cheeto	え㥀
chef	㥁
cherries	㤧㑴
cherrio	㤧㈗㥂
chest	㥃
chester	㤧㑠
chew	ぐ
chewed	㥄
chewing	ぐ㈙
chews	㥅
chewy	ぐ〆
chi	㥆
chichi	ええ
chichi's	え㤹
chick	㥇
chick's	㥈
chickadee	㤶゙々
chicken	㤶㥉
chickennoodle	㤶㄀㍑㞇
chickens	㤶㥐
chickie	㤶㎇
chickie's	㤶㕦
chickies	㤶㕦
chicks	㥈
chico	え㥑
chihuahua	㤶㥒㥒
child	㥓
children	㥔㥕
chili	㤶〠
chill	㥔
chillier	㤶〠㡹
chilling	㤶㐉
chillon	㤶㐤
chilly	㤶〠
chime	㥖
chimes	㥗
chimney	㥘㈔
chimp	㥙
chimpanzee	㥘㥠㙑
chin	㥡
china	㥢㈠
chinese	㥢㈕
chinie	㤶㈔
chinnie	㤶㈔
chip	㥣
chipmunks	㥣㥤
chips	㥥
chirp	㥦
chirping	を㞂
chitlins	㤶〱㥧
chocolate	㥨゙㚐
choice	㥩
choices	㥰〧
choke	㥱
choking	㥲㍀
cholesterol	゙㥳〱㥴
chomp	㥵
choo	ぐ
choo@o	ぐ
chooc@o	㥶
choochoo	ぐぐ
choochoo@o	ぐぐ
choose	㥅
chop	㥷
chopped	㥸
chore	㥹
chores	㦀
chose	㦁
chris	㦂
christ	㦃
christened	㦄㦅
christening	㦄〴㍖
christmas	㦄㦆
christopher	㦄む㦇
chubby	㦈〃
chuckie	㦈㎇
chugga@o	㦈㐔
chunky	㦉㎇
church	㦐
churches	を㦑
chute	㦒
cigarette	〴㐔㑄
cinderella	㦓㜑ㅩㅈ
cinderella's	㦔㜑ㅩ㦕
cindy	㦓々
cindy's	㦓㈂
cinnamon	〴㈠㡘
circle	㈥㈒
circled	㈥㝡
circles	㈥㈓
circular	㈥㕧㝘
circulation	㈥㕧㐆だ
circumstances	㈥㦖㦗〧
circus	㈥㦘
citrus	〴㦙
city	〴で
civilization	〴ㆅㅈ䀀㌨
civilized	〴づ䀁
clamp	䀂
clap	䀃
clappie	䀄㉒
clapping	䀄㞂
class	䀅
clattering	䀄〱ㄦ
claus	䀆
clay	䀇
clean	䀈
cleaned	䀉
cleaner	㍉㐠
cleaner's	㍉䀐
cleanest	㍉䀑
cleaning	㍉㍖
cleans	䀒
cleanup	㍉䀓
clear	䀔
clearance	㍉㉓
cleared	䀕
clearer	㍉䀖
clearly	䀗〠
clever	䀘㈖
click	䀙
clicker	䀠ざ
clicking	䀠㍀
clifford	䀠䀡
clifford's	䀠䀢
climb	䀣
climbed	䀤
climber	䀥㝸
climbing	䀥㔀
climbs	䀦
clings	㝢
clinic	䀠䀧
clinics	䀠䀨
clink	䀩
clinking	㝢㍀
clip	䀰
clipped	䀱
clippers	䀠䀲
clipping	䀠㞂
clips	䀳
cloaks	䀴
clobber	䀵㐲
clock	䀶
clop	䀷
close	䀸
closed	䀹
closely	䁀䁁
closer	䁀㈥
closes	䁀ゕ
closet	䀵䁂
closing	䁀ㆃ
cloth	䁃
clothes	䁄
clothing	䁀㑥
cloud	䁅
clouding	䁆ぷ
clouds	䁇
cloudy	䁆々
clover	䁀㈖
clown	䁈
clowns	䁉
club	䁐
cluck	䁑
clue	䁒
clues	䁓
clumps	䁔
clumpy	䁕㉒
clumsily	䁕䁖〠
clunk	䁗
clunky	䁘㎇
clutter	䁙っ
cluttering	䁙っ㈙
coaster	䁠っ
coasters	㥑䁡
coat	䁢
coats	䁣
cob	䁤
cobweb	㍓䁥
cobwebs	䁤䁦
coca	㥑゙
cock	䁧
cockadoodledoo	㍓゙䁨㞇䁨
cockle	㍓㈒
cocoa	㥑㥑
cocoon	゙䁩
code	䁰
coffee	㠱㕲
coins	䁱
coke	䁲
cola	㥑ㅈ
colada	㥑䁳㜑
cold	䁴
cold's	䁵
colder	䁶ㅅ
coleman	䁶㡘
collapse	゙䁷
collar	㍓㝘
collect	゙䁸
collection	゙䁹だ
college	㍓げ
color	ぃ㝘
color's	ぃ㕨
colored	ぃ䂀
colorful	ぃ㝘㍙
coloring	ぃㅈㄦ
colors	ぃ㕨
colts	䂁
column	㍓䂂
columns	㍓䂃
comb	䂄
combed	䂅
combie	䂄〃
combination	䂆】㡐だ
combine	䂆䂇
combing	㥑㔀
combs	䂈
come	㒘
comedy	㍓䂉々
comes	㒙
comfort	㒘䂐
comfortable	㒘㦇〱〓
comfortably	㒘㦇〱㖑
comforter	㒘㦇っ
comforting	㒘㦇す
comfy	㒘㕲
coming	ぃ㔀
commanded	゙㑲ふ
commander	゙㑲ㅅ
comment	㍓㢉
commercial	゙㝸㈳
commercials	゙㝸䂑
common	㍓㡘
communicate	゙㆔㈈䂒
communication	゙㆔㈈㠡だ
company	㒘㙢㈔
compared	㦖䂓
complain	㦖ㄨ
complaining	㦖䂔㍖
complains	㦖㄰
complete	㦖䂕
completed	㦖䂖〲
completely	㦖䂕〠
complicated	䂆䂗㠡〲
complication	䂆䂗㠡だ
computer	㦖䂘っ
concentrate	䂙㦓䄀
concentrating	䂙㦓䄁す
concentric	㄀㢑䄂
concept	䂙〩
concerned	㄀䄃
concerns	㄀䄄
concert	䂙䄅
concerts	䂙䄆
condensation	䂙ㄶ䄇だ
conditioner	㄀㊓䄈㐠
conditioning	㄀㊓䄈㍖
condo	䂙ゅ
condos	䂙㍔
cone	䄉
confident	䂙㢗〵
confuse	㄀䄐
confused	㄀䄑
confusing	㄀䄒ㆃ
congestion	㄀䄓㥡
congratulate	㄀䄔㢕䄕
connect	゙䄖
connecting	゙䄗す
connection	゙䄗㌨
connections	゙䄗䄘
connie	㍓㈔
connotes	゙䄙
conscious	䂙㝗
consider	㄀〴ㅅ
considerate	㄀〴㜑㡡
considered	㄀〴㎈
considering	㄀〴㜑ㄦ
considers	㄀〴ㅆ
consistent	㄀〴䄠
consistently	㄀〴䄠〠
conspiracy	㄀㌣㆐〄
constant	䂙䄡
constantly	䂙䄡〠
constellation	䂙む㐆㌨
construct	㄀䄢
contact	䂙㌸
contain	㄀䄣
containable	㄀䄤㈠〓
contained	㄀䄥
container	㄀䄤㐠
containers	㄀䄤䀐
containing	㄀䄤㍖
contains	㄀䄦
content	㄀䄧
contents	㄀䄨
context	䂙䄩
continually	㄀㍅㊈〔〠
continue	㄀ち䄰
continued	㄀㍅䄱
contrary	㄀䄲㈗
control	㄀䄳
controlled	㄀䄴
controller	㄀䄵㝘
controls	㄀䄶
convenience	㄀䄷䄸
conversation	䂙㈖䄇だ
conversations	䂙㈖䄇䄘
cook	䄹
cooked	䅀
cookie	䅁㎇
cookies	䅁㕦
cooking	䅁㍀
cooks	䅂
cool	䅃
cooled	䅄
cooler	䅅㝘
cooling	䅅㐉
coop	䅆
cooperate	㥑。㙢㌢
cooperating	㥑。㙢㊃す
cooperative	㥑。㙢㆐つ
coordinate	㥑䅇㊓䅈
coordination	㥑䅇㊓㡐だ
copied	㍓㢓
coppertone	㍓㔈䅉
cops	䅐
copyright	㍓㉒ㅰ
coral	㠱㑂
cord	䅑
cords	䅒
corduroy	〹㜑䅓
corduroy's	〹㜑䅔
cork	䅕
corked	䅖
corn	䅗
corner	〹㐠
cornfield	䅗䅘
cornish	〹䅙
corny	〹㈔
corral	゙䅠
correct	゙䅡
correctly	゙䅡〠
correspondence	㠱ゆ䅢䅣
cosby	㒗〃
cost	䅤
costs	䅥
cotton	㍓㒓
cottontail	㍓㒓䅦
couch	䅧
couches	䅨㊁
cough	䅩
coughing	㠱㢙
could	䅰
couldn't	䅁䅱
counselor	䅲〘㝘
count	ぁ
counted	䅲〲
counter	䅲っ
countertop	䅲っ䅳
counting	䅲す
countries	䅴䅵
country	䅴䅶
counts	䅷
county	䅲で
couple	ぃ㉘
coupon	䅅䅸
coupons	䅅䅹
course	䆀
courting	䆁す
cousin	ぃ䆂
cousins	ぃ䆃
cover	ぃ㈖
covered	ぃ䆄
covering	ぃㆅㄦ
covers	ぃ㒕
cow	䅨
cow's	䆅
cowabunga	䆆䆇㞅㐔
cowboy	䅨㘩
cowpokie	䅨䆈㎇
cows	䆅
cozy	㥑㙑
crab	䆉
crabbie	䆐〃
crabbing	䆐㕥
crabby	䆐〃
crack	䆑
cracked	䆒
cracker	䆐ざ
crackers	䆐㐀
crackery	䆐ざ〆
cracky	䆐㎇
cradle	䆓㞇
cradles	䆓㡁
cramped	䆔
cranberries	䆕㑆㑴
cranberry	䆕㑆㈗
crane	䆖
cranium	䆓㈔㉸
crank	䆗
crankiness	䆘㎇䆙
cranky	䆘㎇
crap	䈀
crash	䈁
crashed	䈂
crashes	䆐ㅑ
crashing	䆐㝕
crawl	䈃
crawled	䈄
crawler	䈅㝘
crawling	䈅㐉
crawls	䈆
crayon	䆓䈇
crayons	䆓䈈
crazed	䈉
crazy	䆓㙑
cream	䈐
creamy	䈑ㆇ
creates	䈑㉩
creative	䈑、つ
creatively	䈑、つ〠
creature	䈑を
creatures	䈑䈒
credit	䈓䈔
credited	䈓㊓㜷
crediting	䈓㊓す
credits	䈓䈕
creek	䈖
creep	䈗
creepy	䈑㉒
crew	䈘
crib	䈙
cribbie	㦄〃
crickets	㦄㖇
cried	䈠
crinkles	䈡㈓
crinkling	䈡㝢
crinkly	䈡㍉
crispier	㦄䈢㡹
crispiest	㦄䈢さ
crispy	㦄䈢
crisscross	㦄䈣
critter	㦄っ
croakity	䈤゙で
crock	䈥
crocodile	䈦゙䈧
crocodiles	䈦゙䈨
crocodiles'	䈦゙䈨
crocuses	䈤゙〧
crooked	䈩䈰
crooks	䈱
cross	し
crossed	䈲
crossing	䈅㖙
crosss	䈳
crow	䈤
crowd	䈴
crowded	䈵ふ
crowed	䈶
crown	䈷
crud	䈸
cruise	䈹
crumb	䉀
crumble	䉀〓
crumbs	䉁
crunch	䉂
crunchies	䉃㤹
crunchy	䉃え
crush	䉄
crust	䉅
crusted	䉆〲
crusty	䉆で
cry	䉇
crybaby	䉇㍴〃
crying	䉇㈙
crystals	㦄䉈
cub	䉉
cubby	ぃ】
cube	䉐
cubes	䉑
cucumber	㐰㒘㐲
cucumbers	㐰㒘䉒
cuddly	䉓〠
cuetip	㐰䉔
cup	䉕
cupboard	ぃ㕰
cupboard's	ぃ㕱
cupcake	䉕㍷
cupcake's	䉕㍸
cupcakes	䉕㍸
cupfuls	䉕䉖
cups	䉗
cups	䉗
curb	䉘
curds	䉙
curious	䉠㈗㌘
curl	䉡
curled	䉢
curly	ざ〠
current	ざ㉐
curse	䉣
curtain	ざ㒓
curtains	ざ㠕
curvy	ざ䄷
cushion	䅁だ
cushioned	䅁䉤
cushions	䅁䉥
cut	䉦
cute	䉧
cutest	㐰䉨
cutesy	䉩〄
cutey	㐰で
cutie	㐰で
cutiepie	㐰で䉰
cutting	ぃす
cymbals	䉱㝙
czech	㤦
czechoslovakia's	㤧゙䉲䉳㎇㊂
d	々
d@l	々
da	䉴
dab	䉵
dab@c	䉵
dabby@c	䉵
dad	䉶
dad'll	䉷㞇
dad's	䉸
dada	䉷䉷
dada's	䉷䉹
dadada	䉷䉷䉷
dadada's	䉷䉷䉹
dadada@o	䉷䉷䉷
dadadada@o	䉷䉷䉷䉷
daddy	䉷々
daddy'd	䉷䊀
daddy's	䉷㈂
daffodil	䉷ㅦ䊁
daffodils	䉷ㅦ䊂
daffy	䉷㕲
daily	㕴〠
dainty	䊃で
dairy	㕴㈗
daisies	㕴䊄
daisy	㕴㙑
dakota	㜑㥑〱
dakota's	㜑㥑䊅
dale	䊆
dalmatian	䊇ㆂだ
dalmatians	䊇ㆂ䉥
damage	䉷䊈
damaged	䉷䊉
damages	䉷㊒㤠
damaging	䉷㊒㌃
dame	䊐
damn	䊑
damp	䊒
dan	䊓
dan's	䊔
dance	䊕
dances	䊓〧
dancing	䊓㖙
dandelion	䊓㜑ㅢ぀
dandy	䊓々
dang	䊖
dangerous	䊃㕃䊗
daniel	䊓䊘
dapper	䉷㔈
dare	䊙
daring	㕴ㄦ
dark	䌀
darling	䌁㐉
darn	䌂
dat	䌃
date	䌄
daughter	䌅っ
david	㕴䌆
davis	㕴䌇
dawn	䌈
dawn's	䌉
day	㕴
day's	䌐
daycare	㕴䌑
daydreaming	㕴㆙㔀
days	䌐
daytime	㕴㉁
daze	䌐
dazey	㕴㙑
dead	䌒
deal	䌓
dear	䌔
deborah	䌕㍥ゆ
debra	䌕䌖
december	㊓㌥㐲
decent	々䌗
decibels	䌕〘㝙
decide	㊓㕉
decided	㊓䌘ふ
decisions	㊓䌙䌠
deck	䌡
declare	㊓䌢
declared	㊓䌣
declares	㊓䌤
declaring	㊓䀘ㄦ
decoration	䌕゙㊃だ
decorations	䌕゙㊃䉥
deep	䌥
deepest	々䌦
deer	䌔
defender	㊓䌧ㅅ
definitely	䌕㢗㙀〠
definition	䌕㢗㈈だ
defrost	㊓䌨
degree	㜑ㄔ
degrees	㊓䌩
dehydrated	々䌰䌱〲
delay	㊓㐆
delete	㜑䌲
deleting	㜑〠す
delicious	㜑ㅗㆄ
delighted	㊓ㅢ〲
deliver	㜑ㅗ㈖
delivers	㊓ㅗ㒕
dell	䌳
deluxe	㜑䌴
demand	㊓䌵
demolition	䌕㊒ㅗだ
demonstrate	䌕㡘䌶
dennis	䌕ㄒ
dense	䌷
dentist	〶䉨
dentist's	〶䌸
deny	㊓䌹
depend	㊓䍀
depended	㊓䍁㝰
depending	㊓䍁ぷ
depends	㊓䍂
deposit	㊓㉈䁂
deprive	㊓䍃
deprived	㊓䍄
derived	㊓㌄
desert	㊓䍅
deserve	㊓䍆
design	㊓䍇
desire	㊓䍈
desitin	䌕䁖㍅
desk	䍉
despise	䍐䍑
dessert	㊓䍅
destroy	䍐䍒
destroying	㊓䍓㈙
destruction	䌕䍔㌨
destructive	䍐䍕つ
detergent	㊓っ䍖
detergents	㊓っ䍗
determine	㊓っ㕄
determined	㊓っ䍘
detour	々䍙
device	㊓ん
devil	䌕䍠
devon	䌕䍡
devotion	㊓䍢だ
devour	㊓䍣㡹
dew	䁨
dextrous	䌡䍤
dial	䈧
dialect	䍥〔䁸
dialing	䍥㐉
dials	䍥㢖
diamond	䍥䍦
diamonds	䍥䍧
diaper	䍥㔈
diapers	䍥䀲
diapie	䍥㉒
diarrhea	䍥〔㈗〔
dickory	㊓ざ〆
dictionary	ぶ䄈䍨㈗
did	ふ
diddle	㊓㞇
didey	䍥々
dideys	䍥㈂
didi@o	々々
dididi@o	々々々
didn't	㊓䅱
die	䍥
died	䍩
dieing	䍥㈙
dies	䍰
diesha	䍥〆㙕
diet	䍥䍱
dieting	䍥〔す
diets	䍥䍲
difference	㊓䍳
differences	㊓ㅦ䍴〧
different	㊓䍵
differentiate	㊓ㅦ䍶㉧㉨
differently	㊓䍷〠
difficult	㊓㢗䍸
difficulty	㊓㢗䍹で
dig	䎀
digby	䎀〃
digger	㊓㔖
digging	㊓㔗
digits	㊓㜡
digs	䎁
dillards	㊓䎂
dillon	㊓㐤
dillon's	㊓㥧
dimples	䎃㉙
ding	ぷ
dining	䍥㍖
dinner	㊓㐠
dinners	㊓䀐
dinnertime	㊓㐠㉁
dinosaur	䍥㈈䎄
dinosaur's	䍥㈠䎅
dip	䎆
dips	䎇
dipsie	䎆〄
dipsy	䎆〄
direct	㊓䅡
directing	㊓㈡す
direction	㊓㈡だ
directions	㊓㈡䉥
dirt	䎈
dirt's	䎉
dirty	ㅅで
dis	䍐
disappear	㊓〘䎐
disappeared	㊓〘㉔
disappearing	㊓〘㉕ㄦ
disappointing	㊓〘䎑す
disaster	㊓䎒っ
disc	䎓
discontent	䍐㄀䄧
discover	䍐ぃ㈖
discovered	㊓䎔䆄
discoverer	䍐ぃㆅ䀖
discovery	䍐ぃㆅ㈗
discs	䎕
discuss	䍐䎖
discussed	㊓䎗
discussion	䍐ぃだ
disguised	䍐䎘
disgust	䍐䎙
disgusted	䍐䐀㠅
disgusting	䍐䐀㠆
dish	䐁
dishes	㊓㌐
dishrag	㊓䐂
dishwasher	䐁㥒䐃
disinfected	㊓㦓䐄〲
dismantle	㊓䐅㑶
dismay	㊓䐆
disney	䐇㈔
disney's	䐇㈕
disobedient	㊓〘〃々䐈
disobey	㊓〘㍴
disposal	䍐䆈㑔
dispose	䍐䐉
disposition	䍐㙢䁖だ
distinct	㊓䐐
distinction	㊓䐑㌨
distinguishes	㊓䐒䐓㌐
distracted	㊓䐔〲
distracting	㊓䐔す
distraction	䍐㍃だ
distracts	㊓䐕
disturb	䍐䐖
ditty	㊓で
dive	䐗
dived	䐘
dives	䐙
divine	㊓䐠
diving	䍥ぉ
dizzy	㊓㙑
do	䁨
do@si	ゅ〄
dock	䐡
doctor	䐡っ
doctor's	䐡ㅙ
dodge	䐢
does	䐣
doesn't	㐙䐤
dog	䐥
dog's	䐦
doggie	䌅ㄇ
doggie's	䌅㎖
doggies	䌅㎖
doggone	䌅䐧
doggy	䌅ㄇ
doggy's	䌅㎖
doghouse	䐥䐨
dogs	䐦
doing	䁨㈙
doll	㍹
doll's	䐩
dollar	䉴㝘
dollars	䉴㕨
dollhouse	䐰䐨
dollie	䉴〠
dollie's	䉴㌒
dollies	䌅㌒
dolls	㎀
dolly	䌅〠
dolly's	䌅㌒
dolphin	䐰䐱
dolphins	㍹䐲
dome	䐳
domestic	㜑䐴㈱
don	䐵
don't	䐶
donald	䉴䐷
donald's	䉴䐸
done	ㅕ
dong	䐹
donkey	䑀㎇
donkeys	䐹㕦
donna	䉴㈠
donovan	䉴㈠䍡
donut	ゅ䑁
doo	䁨
doodle	䁨㞇
doodoo	䁨䁨
doopsie	䑂〄
door	ょ
door's	䑃
doorbell	ょ㔨
doorbells	㎃㐱
doors	䑃
doorstop	㎃䑄
doorway	ょ㉂
doozy	䁨㙑
doremifasolatido@si	ゅ㊃ㆇ䑅ㅲ䁳でゅ
dorm	䑆
dos	䑇
dot	䑈
doting	ゅす
dotty	䉴で
double	㐙〓
doubling	㐙㍱
doubt	䑉
dough	ゅ
doughnut	ゅ㠒
doughnuts	ゅ䑐
dove	䑑
dover	ゅ㈖
down	䑒
downie	䑓㈔
download	䑒㔴
downloaded	䑒㊔㝰
downstairs	䑒䑔
downstream	䑒䑕
downtown	䑒䑖
downy	䑓㈔
doze	㍔
dozen	㐙䆂
drag	䑗
dragged	䑘
dragging	䑙㔗
dragon	䑙䑠
dragon's	䑙䑡
dragonfly	䑙䑠䑢
dragons	䑙䑡
drags	䑣
drags	䑣
drain	䑤
drainage	䌱䑥
drama	䑦㊒
dramatic	䑧㍈㈱
drank	䑨
drape	䑩
draw	䑰
drawer	䑱
drawers	䑲
drawing	䑰㈙
draws	䑳
dreadful	䑴㍙
dream	䑵
dreamed	䑶
dreaming	㆙㔀
dreams	䑷
dreamy	㆙ㆇ
drenched	䑸
dress	䑹
dressed	䒀
dresser	䒁㈥
dresses	䒁〧
dressing	䒁㖙
drew	䒂
dried	䒃
drill	䒄
drink	䒅
drink's	䒆
drinkie	䒇㎇
drinking	䒇㍀
drinks	䒆
drip	䒈
dripping	䒉㞂
drippy	䒉㉒
drips	䒐
drive	䒑
driver	䒒㈖
drives	䒓
driveway	䒑㉂
driving	䒒ぉ
drool	䒔
drooling	䒂㐉
drooly	䒂〠
droopy	䒂㉒
drop	䒕
dropped	䒖
dropping	䑦㞂
drops	䒗
drove	䒘
drown	䒙
drum	䔀
drum's	䔁
drummer	䔂㝸
drumming	䔂㔀
drummond	䔂䍦
drums	䔁
drunk	䔃
drunken	䔄㄀
dry	䒒
dryer	䔅
drying	䒒㈙
drys	䔆
dub	䔇
duck	䔈
duckie	㐙㎇
duckie's	㐙㕦
duckies	㐙㕦
ducklings	㐙䔉
ducks	䔐
dude	䔑
due	䁨
dueling	䁨〔㐉
dug	䔒
dukes	䔓
dum	䔔
dumb	䔔
dumbo	䔔㘙
dummy	㐙ㆇ
dump	䔕
dumped	䔖
dumping	䔔㞂
dumpling	䔔䔗
dumpty	䔕で
dumpty's	䔕て
duplo	䁨䔘
duress	㜑䔙
during	䔠ㄦ
dust	䔡
dusted	㐙㠅
dusting	㐙㠆
dustpan	䔡㥠
dusty	䔢で
dvd	々䄷々
dwight	䔣
dya	䔤
dye	䍥
dyed	䍩
dyeisha	䍥〆㙕
dyeisha's	䍥〆ㅑ
dyes	䍰
dyiesha	䍥〆㙕
dying	䍥㈙
e	〆
e@l	〆
e@l-s	〆
each	䔥
ear	䔦
ear's	䔧
earache	〆䔨
eardrum	䔦䔀
earlier	㡹〠㡹
early	㡹〠
earned	䔩
earphones	䔦䔰
earring	䔦ㄦ
earrings	䔦䔱
ears	䔲
earth	䔳
earthquake	䔳䔴
ease	㑵
easier	〆㙑㡹
easiest	〆㙑䔵
easily	〆䔶〠
easter	〆㑠
easy	〆㙑
eat	䔷
eaten	〆㒓
eater	〆っ
eating	〆す
eats	䔸
ecosystem	〆㥑〴䔹
ecta@q	〨〱
eddie	㈵々
eden	〆䕀
edge	䕁
edges	㈵㜘
edible	㈵㜑〓
educational	㈵䕂㠡㙕㡒
edward	䕃䕄
eel	䕅
eensie	䕆〄
eeyore	〆㊀
effort	㈵䂐
efg@k	〆〇〈
egg	㞉
eggfooyung	㞉䕇䕈
eggs	䕉
eh	㈵
eight	㉨
eighteen	、䕐
eighth	䕑
either	〆ㅵ
el	䕒
elastic	䕓ㄴ㤖
elbow	䕒㘙
elbows	䕒㚃
eleanor	㈵ㅈ㐠
electrical	〔䁹䕔㈒
electrician	㈵䕕䕔だ
electricity	〔䁹䕔〴で
electrocute	䕓䕖䉧
electrocuted	〔䁹㡴㐰〲
electrolytes	〔䁹㡴䕗
electronically	䕘䁹䕙㈈㍉
elegant	㈵ㅈ䕠
elephant	㈵ㅈ䕡
elephant's	㈵ㅈ䕢
elephants	㈵ㅈ䕣
eleven	〔䕤䕥
eleventh	〔䕤䕦
elijah	〔ㅢ㕃
elisse	㉉䕧
elizabeth	〔ㅗ䔶䕨
elizabeth's	䕓ㅗ䔶䕩
ella	㈵ㅈ
ellie	㈵〠
elmo	䕒䕰
elmo's	䕒䕱
else	䕲
else's	䕒〧
eluded	䕓㐓ふ
elves	䕳
email	〆䕴
embarrassed	䕵㍰䕶
emergency	䕓㝸䕷〄
emily	㈵䂉〠
emmy	㈵ㆇ
emmy's	㈵㝹
emote	䕓䕸
emotional	䕓䕰䄈㡒
emperor's	䕵㙢䕹
empty	䕵䖀
enamel	㈵㐗㈉
encourage	䖁ざ㕕
encouraged	䖁ざ䖂
encouraging	䖁ざ䕓㌃
end	䖃
ended	䖁ふ
endlessly	䖃ㅗ䁁
ends	䖄
enemy	㈵㈈ㆇ
energy	㈵㐠〈
engine	䖁䕷
english	㈙䖅
enjoy	䖁䖆
enjoyed	䖁䖇
enjoying	䖁䖆㈙
enjoys	䖁䖈
enormous	䕓䖉䖐
enough	䕓䖑
enter	䖁っ
entered	䖁㢒
entering	䖁っ㈙
enters	䖁ㅙ
entertained	㈵㐠䄥
entertaining	㈵㐠䄤㍖
entertainment	㈵㐠䄣ㆁ
enthusiastic	䖁䖒㙑【㤖
entice	䖁䖓
entire	䖁䖔㡹
entirely	䖁䖕〠
entrance	䖁䖖
entrapment	䖁䖗ㆁ
entry	䖁䅶
envelope	䖁ㆅ㡅
envelopes	䖁ㆅ䖘
environment	䖁ゔ㑇䖙
equipment	䕓䘀ㆁ
er	㡹
eric	㈵㤕
erin	㈵䍴
ernie	㡹㈔
ernie's	㡹㈕
escape	䘁䘂
escaped	㈵䘃
especially	㈵䘄㙕〠
estate	䘁䘅
eternal	〆っ㡒
etti	㈵で
european	䘆ゆ㉒぀
evaporate	㈵䘇㙢㌢
evaporated	䕓䘇㔈、㜷
eve	䘈
even	〆䍡
evening	䘈㍖
event	䕓䘉
eventually	㈵ゑぐ〔〠
ever	㈵㈖
every	㈵䘐
everybody	㈵䘐㍤々
everybody's	䘑㈗㍤㈂
everyone	㈵䘐㈹
everyone's	㈵䘐䘒
everyplace	㈵䘐䘓
everything	㈵䘐㉀
everything's	䘑㈗䘔
everywhere	㈵䘐㉄
evil	〆䍠
ew	䘕
ewe	㊈
ewie	㊈〆
exact	㞉䘖
exactly	㞉䘖〠
exalted	㞉䘗〲
examples	䘘䘙㉙
excellent	〨〘䘠
except	〨〩
excess	〨䘡
excited	〨䌘〲
excitement	〨䘢ㆁ
exciting	〨䌘す
excuse	䘣䘤
excuses	䘥㐰〧
exercise	〨㈥䘦
exercises	〨㈥䌘ゕ
exercising	〨㈥䌘ㆃ
exersaucer	〨㈥䘧㈥
exert	䘘䍅
exhibits	㞉䁖㕸
exists	㞉䘨
exodus	〨〘䘩
expect	䘣䘰
expectations	〨䘱䄤䉥
expected	〨䘱〲
expecting	〨䘱す
expects	䘲䘳
expedition	〨㌡㊓だ
expensive	䘣䍁ㄐ
experience	䘣㉕㈗䘴
experiment	䘣䘵㆐ㆁ
explain	䘲䘶
explanation	䘣䘷㡐だ
exploded	〨䘸ふ
explore	䘣䘹
exploring	〨䘸ㄦ
explosion	䘣䔘䙀
exposed	〨䙁
express	䘣䙂
expresses	䘲䙃ㅂ
expression	䘣䙄だ
extent	䘲䙅
external	䘣っ㡒
extinguisher	䘣す䙆䐃
extra	䘣㡴
extract	〨䙇
extracted	〨䐔〲
extracting	〨䐔す
extracts	〨䐕
extraordinarily	䘲䙈㜑䍨ゆ〠
extraordinary	䘲䙈㜑䍨㈗
extremely	〨䑕〠
eye	㍣
eyeball	㍣㐄
eyebrow	㍣㝆
eyebrows	㍣㝈
eyeglass	䙉䙐
eyeglasses	㍣䙑〧
eyeore	〆㊀
eyes	䙒
eyesight	㍣䘢
eyore	〆㊀
eyore's	〆䙓
f	〇
f@l	〇
fa@si	䑅〄
fabulous	䙔䙕䙖
face	䙗
facecloth	䙗䙘
faced	䙙
faces	䙠〧
facie	䙠〄
facing	䙠㖙
fact	䙡
fade	䙢
fair	䙣
fairies	䙤㑴
fairly	䙣〠
fairy	䙠㈗
faithful	䙥㍙
fake	䙦
faked	䙧
faker	䙠ざ
fakes	䙨
faking	䙠㍀
fall	䙩
fallen	䙰㐤
falling	䙰㐉
falls	䙱
false	䙲
familiar	ㅦ䂉䙳
families	䙴㌒
family	䙔㊒〠
famous	䙠䖐
fan	䙵
fan's	䙶
fancy	䙵〄
fanny	䙔㈔
fantabalocious	䙵㌹㍥㊔㝗
fantastic	䙵㡳㈱
far	䙷
faraway	䑅ゆ㉂
farm	䙸
farmer	䙷㝸
farmer's	䙷䙹
farmyard	䙸䚀
fart	䚁
farted	䙷〲
farther	䙷ㅵ
fartie	䙷で
fascinated	䙔〴㡐〲
fascinating	䙔〴㡐す
fascination	䙔〴㡐だ
fast	䚂
fasten	䙔㦓
fastens	䙔䚃
faster	䙔㑠
fat	䚄
fates	䚅
father	䑅ㅵ
father's	䑅㙩
fathers	䑅㙩
fault	䚆
favor	䙠㈖
favorite	䙠ㆅ㡡
favorites	䙠ㆅ㡢
favoritest	䙠䚇䚈
fawn	䚉
faye	䙠
fear	䚐
feast	䚑
feather	䙤ㅵ
feathers	䙤㙩
feathery	䙤㈤㈗
fed	䚒
fee	㕲
feed	䚓
feeder	㕲ㅅ
feeding	㕲ぷ
feeds	䚔
feel	䚕
feeling	㕲㐉
feelings	㕲㢃
feels	䚖
fees	䚗
feet	䚘
feet'll	㕲㑶
feetie	㕲で
feeties	㕲て
feets	䚙
feetsies	䚘〉
feisty	䜀㑡
fell	䜁
fella	䙤ㅈ
fellow	䙤㊔
felt	䜂
fence	䜃
fenced	䜄
fennel	䙤㡒
ferocious	ㅦ㙥㝗
ferris	䙤䜅
ferry	䙤㈗
fetch	䜆
fettuccini	䙤〱え㈔
fever	㕲㈖
few	䄒
fiber	䜀㐲
fickle	㢗㈒
fiddle	㢗㞇
fiddles	㢗㡁
fido	䜀ゅ
field	䅘
fifferfefferfeff	㢗㦇䙤㦇䜇
fifteen	䜈䕐
fifteenth	䜈䜉
fifth	䜐
fiftieth	䜈で䜑
fifty	䜈で
fig	䜒
fight	䜓
fighter	䜀っ
fighting	䜀す
figs	䜔
figure	㢗䜕
figured	䜒䜖
figures	䜒䜗
figuring	䜒䜘㈙
fill	䜙
filled	䜠
filling	㢗㐉
film	䜡
filthy	䜙㑤
fin	䐱
finally	䜀㈠〠
find	䜢
finding	䜣ぷ
findow@n	䐱ゅ
finds	䜤
fine	䜣
finger	㢙㔖
fingernail	㢙㔖䜥
fingernails	㢙㔖䜦
fingerprints	㢙㔖䜧
fingers	㢙㙄
finicky	㢗㈈㎇
finish	㢗䅙
finished	㢗䜨
finishing	㢗㈈㝕
fins	䐲
fiona	㕲㥂㈠
fir	㦇
fire	䜩
firefly	䜩䑢
fireplace	䜩䘓
fires	䜰
firmly	䜱〠
first	䜲
fish	䜳
fishbowl	䜳㚁
fisher	㢗䐃
fishes	㢗㌐
fishie	㢗㉧
fishie's	㢗䜴
fishies	㢗䜴
fishing	㢗㝕
fist	䜵
fists	䜶
fit	䜷
fits	䜸
fitti	㢗で
fitting	㢗す
fittis	㢗㠣
fitzgerald	䜸㈄䜹
fitzpatrick's	䜷䝀㒔
five	䝁
fix	䝂
fixable	䝃〘〓
fixed	䝄
fixes	䝃〧
fixing	䝃㖙
fixit	䝃㎁
flag	䝅
flair	䝆
flairs	䝇
flakes	䝈
flamingo	䝉㔀ㄓ
flap	䝐
flaps	䝑
flash	䝒
flashcard	䝒㡑
flashes	䝓㌐
flashlight	䝒䝔
flat	䝕
flavor	䝖㈖
flavored	䝖䆄
flavorful	䝖㈖㍙
fleas	䝗
fleet	䝘
flew	䝙
flicked	䝠
flip	䝡
flipflop	䝡䝢
flipflops	䝡䝣
flipping	䝤㞂
flips	㎅
flirting	䝥す
float	䝦
floating	䝧す
floats	䝨
floor	䝩
floor's	䝰
floors	䝰
flop	䝢
floppy	䝱㉒
flopsy	䝢〄
flouncy	䝲〄
flour	㡸㡹
flow	䝧
flower	㡸㡹
flower's	䝳䝴
flowers	㡸䝵
flowing	䝧㈙
flows	䝶
fluff	䝷
fluffy	䝸㕲
fluids	䝙䝹
flush	䞀
flutter	䝸っ
flutters	䝸ㅙ
fly	䑢
flyer	䞁
flying	䑢㈙
flys	㠐
flyswatter	䑢䞂っ
foam	䞃
focussed	䞄䞅
fold	䞆
folded	䞇ふ
folding	䞇ぷ
folks	䞈
follow	䑅㊔
followed	䑅㔴
following	䑅㊔㈙
follows	䑅䞉
followtheleader	䑅㊔㈤〠ㅅ
food	䞐
foods	䞑
fool	䞒
fooled	䞓
fooling	䕇㐉
foot	㐶
foot's	䞔
football	㐶㐄
footie	㐷で
footprints	㐶䜧
foots	䞔
footsies	㐶〉
for	䞕
foraging	䙰㆐㌃
forbidden	䞕】䕀
forced	䞖
forcing	㔓㖙
forehead	㔓ㄗ
forest	䙰䕶
forever	ㅦㅩ㈖
forget	䞕䞗
forgets	䞕䞘
forgetting	䞕ㅴす
forgive	䞕䞙
forgot	䞕䠀
forgotten	㦇䠁㒓
fork	䠂
forks	䠃
formal	䞕㈉
formed	䠄
formula	䞕䠅ㅈ
formula's	䞕䠅㦕
formulated	䞕䠅㐆〲
forsake	䞕䠆
forth	䠇
fortune	䞕㥡
forty	䞕で
forum	䞄䠈
forward	䞕䕄
fossil	䙰㜨
foul	䠉
found	䠐
foundation	䠑㕴だ
fountain	䠑㒓
four	㔓
fours	䠒
fourteen	㔓䕐
fourteen	㔓䕐
fourteenth	㔓䜉
fourth	䠇
fourths	䠓
fox	䠔
foxes	䠕〧
frame	䠖
frank	䠗
frankly	䠘㍉
freak	䠙
freaking	䠠㍀
fred	䠡
freddy	䠢々
freddy's	䠢㈂
free	䠠
freedom	䠠び
freeze	䠣
freezer	䠠㚇
french	䠤
fresh	䠥
friction	䠦だ
friday	䠧㕴
fridge	䠨
fried	䠩
friend	䠰
friend's	䠱
friendly	䠲䠳
friends	䠱
fries	䠴
frighten	䠧㒓
frightened	䠧㠓
frill	䠵
frilly	゘〠
frilly's	゘㌒
frisbee	䠶〃
frog	䠷
frog's	䠸
froggie	䠹ㄇ
froggie's	䠹㎖
frogs	䠸
from	䡀
front	䡁
fronts	䡂
frontsies	䡁〉
froot	䡃
frosting	䠹㠆
frosty	䡄で
frown	䡅
froze	䡆
frozen	䡇䆂
fruit	䡃
fruits	䡈
frustrated	䡉䡐〲
frustrating	䡉䡐す
frutti	䡑で
fry	䠧
frying	䠧㈙
fufu@c	䕇䕇
full	䡒
fumble	䡓〓
fun	䡔
function	䡕䄘
functions	䡕䄘
funniest	䡖㈔䔵
funny	䡖㈔
fur	㦇
furby	㦇〃
furious	䡗㈗㌘
furniture	㦇㈈を
furry	㦇㈗
further	㦇ㅵ
fuss	䡘
fussbucket	䡘㈶䡙
fussed	䡠
fusser	䡖㈥
fussies	䡖〉
fussing	䡖㖙
fussings	䡖㘀
fusspot	䡖䡡
fussy	䡖〄
futon	䕇䡢
future	䄒を
fuzz	䡣
fuzzies	䡖䊄
fuzzy	䡖㙑
g@l	〈
gabby	䡤〃
gabby's	䡤㍵
gaga	䠁䠁
gail	〒
gail's	䡥
gained	䡦
galleria	䡤ㅈ㈗〔
galley	䡤〠
galoshes	㐔䁳㌐
game	㐇
games	䡧
gap	䡨
garage	㐔䡩
garbage	䡰㠙
garden	䡰䕀
garden's	䡰䡱
garland	䡰䡲
garlic	䡰䡳
garret's	ㅴ㑅
garrett	䡤㡡
gas	䡴
gasped	䡵
gastroenteritis	䡤䡶䖁〱ㅱ㠣
gat	䡷
gate	䡸
gate's	䡹
gates	䡹
gather	䡤ㅵ
gathered	䡤㙨
gatorade	ㅘ〱䢀
gave	䢁
gazing	ㅘㆃ
gear	䢂
gears	䢃
gee	〈
geese	䢄
gels	䢅
gene	䢆
general	㈄㐠ぱ
generally	㈄㐠〔〠
generate	㈄㈠㌢
generations	㈄㈠㊃䉥
generous	㈄㐠㌘
genesis	㈄㈈㌦
genie	〈㈔
genie's	〈㈕
genius	〈䢇
gentle	䢈㑶
gentleman	䢈㑶㡘
gently	䢉〠
george	䢐
georgia	䢑㕃
gerber	㔖㐲
gesundheit	㐔䢒䢓
get	䞗
getieup	ㅴで㘕
gets	䞘
getting	ㅴす
ghetto	ㅴ㥀
ghost	䢔
giant	䢕䐈
gibberish	㔳㍥䢖
giddyup	㔙々㘕
gift	䢗
gifts	䢘
gigantic	䢕㔕㈱
giggle	㔙㈇
gigglegigglegoogaga	㔙㈇㔙㈇䢙䠁䠁
gigglegigglegoogoo	㔙㈇㔙㈇䢙䢙
gigglegigglegoogooga	㔙㈇㔙㈇䢙䠁
gigglegigglegoogoogoo	㔙㈇㔙㈇䢙䢙䢙
giggles	㔙䤀
gigi	䤁䤁
gigi's	䤁䤂
gimme	㔙ㆇ
gimmick	㔙䤃
gimmicks	㔙䤄
ginger's	㔘䤅
giraffe	㕃䤆
giraffe's	㕃䤇
giraffes	㕃䤇
girded	㔖ふ
girder	㔖ㅅ
girl	䤈
girl's	䤉
girla	㔖ㅈ
girlfriend	䤈䠰
girlie	㔖〠
girls	䤉
git	䤐
give	䞙
given	㔙䍡
giver	㔙㈖
gives	䤑
giving	㔙ぉ
glad	䤒
gladys	䙑䍐
glass	䤓
glasses	䙑〧
globe	䤔
gloomy	䤕ㆇ
glorified	䤖㆐䤗
glorify	䤖㆐䜀
glorious	䤖㈗䤘
glory	䤖㈗
gloss	䤙
glosses	䤠ㅂ
glove	䤡
gloves	䤢
glubglub	䤣䤣
glue	䤕
glued	䤤
glump	䤥
gnat	䤦
go	ㄓ
goading	ㄓぷ
goal	䤧
goat	䤨
goats	䤩
gobble	䠁〓
god	䤰
god's	䤱
godmother	䤰䤲ㅵ
gods	䤱
godzilla	䤰䁖ㅈ
goers	ㄓ䝵
goes	㘷
goggles	䠁䤀
going	ㄓ㈙
gold	䤳
golden	䤧ㄶ
goldfish	䤧䤴
goldie	䤧々
goldilocks	䤧々䤵
golf	䤶
golly	䠁〠
gone	䐧
gonna	䐀㈠
gonzales	䑠䤷㥳
good	䤸
goodamus	䤹㜑䖐
goodbye	䤸ㅉ
goodest	䤹䥀
goodness	䤸ㄒ
goodnight	䤸䥁
goody	䤹々
goof	䥂
goofy	䢙㕲
goofy's	䢙䚗
google	䢙㈇
googoo	䢙䢙
googooeyed	䢙䢙䥃
googoogigglegaga	䢙䢙㔙㈇䠁䠁
googoogigglegagagiggle	䢙䢙㔙㈇䠁䠁㔙㈇
googoogoggles	䢙䢙䠁䤀
goopy	䢙㉕
goose	䥄
gooseberry	䥄㑆㈗
goosie	䢙〄
gordon	䥅ㄶ
gorgeous	䥅䥆
gorilla	㐔㆐ㅈ
gorillas	㐔㆐㦕
gosh	䥇
got	䠀
gotcha	䠁㢕
gots	䥈
gotta	䠁〱
gotten	䠁㒓
gown	䥉
gowns	䥐
grab	䥑
grabbed	䥒
grabbing	䄔㕥
grabs	䥓
grace	䥔
gracefully	䥔ㅦ〠
gracious	䥕ㆄ
grade	䥖
gradually	䄔䥗〔〠
graduation	䄔䥗、だ
graham	䥕㉸
grain	䥘
gram	䥙
grammatical	ㄈ㍈ち㈒
grammatically	ㄈ㍈ち㍉
grammie	䄔ㆇ
grammy	䄔ㆇ
gramps	䥠
grams	䥡
grand	䥢
grandad	䥣䉶
grandaddy	䥣䉷々
granddaddy	䥢䉷々
grandma	䄔㈑
grandma's	䥢䥤
grandmama	䥢㈑㊒
grandmother	䥢䤲ㅵ
grandmother's	䥣䤲ㅵ
grandpa	䥙㉈
grandpa's	䥢䥥
grandparents	䥣䘵䥦
grandpas	䥢䥥
granny	䄔㈔
granny's	䄔㈕
granola	ㄈ㘴ㅈ
grant	䥧
grape	䥨
grapefruit	䥨䡃
grapes	䥩
grasp	䥰
grass	䥱
grasses	䄔〧
grasshopper	䥱ㄘ㔈
grate	䥲
grateful	䥲㍙
gratefully	䥲ㅦ〠
grater	䥕っ
gratings	䥕䥳
gravel	䄔䍠
gravity	䄔づで
gravy	䥕䄷
gray	䥕
grayish	䥕䥴
grease	䥵
greasy	ㄔ〄
great	䥲
greatest	䥕䉨
greatly	䥲〠
greats	䥶
greece	䥵
greedy	ㄔ々
greek	䥷
green	䥸
greg	䥹
gregory	ㄉ㐔㈗
gregory's	ㄉ㡶㑴
gretel	ㄉ㑶
grew	䦀
grey	䥕
grief	䦁
griffin	䦂䐱
grill	䦃
grilled	䦄
grin	䦅
grinch	䦆
grinchie	䦅え
grind	䦇
grinding	䦈ぷ
grip	䦉
grit	䦐
grits	䦑
gritty	䦂で
groaning	䦒㍖
groceries	䦒〴㑴
grocery	䦒〴㈗
gross	䦓
grouch	䦔
groucho	䦕㥲
grouchy	䦕え
ground	㎆
groundhog	㎆䦖
group	䦗
groupings	䦀䦘
grover	䦒㈖
grow	䦒
growing	䦒㈙
growl	䦙
growled	倀
growling	䦕㐉
grown	倁
grownups	䦒倂
growth	倃
grumpy	倄㉒
grundy	倅々
grunt	倆
grunted	倅〲
grunting	倅す
grunts	倇
guard	倈
guards	倉
gucci	䢙え
guess	倐
guest	們
guests	倒
guide	倓
guilty	倔で
guitar	㔙倕
gum	倖
gummies	䐀㝹
gump	倗
gums	倘
gun	㔡
guns	候
gus	倠
guy	倡
guy's	倢
guys	倢
guzenheit@s	ㅴ倣㉖
gym	値
h@l	倥
ha	ㄘ
habit	倦㕵
habits	倦㕸
had	倧
hades	㔣㈂
hadn't	倦䅱
hafta	倨〱
hag	倩
haha	ㄘㄘ
hailey	㔣〠
hair	倰
hair's	倱
hairbrush	倰㝓
haircut	倰䉦
hairdo	倰䁨
haired	倲
hairie	倳㈗
hairies	倴㑴
hairs	倱
hairy	㔣㈗
hakunamatata@si	倵䅁㈠㊒倶〱
haley's	㔣㌒
half	倨
halfs	倷
halfsister	倨〴㑠
halfway	倨㉂
hall	ㄹ
halle@si	ㄘ䕤
hallehallehalle@si	ㄘ䕤ㄘ䕤ㄘ䕤
hallelujah	倦ㅈ㐓㕩
halloween	倦ㅈ倸
hallway	ㄹ㉂
halo	㔣㊔
ham	倹
hamburger	倹㐲㔖
hammer	倦㝸
hammock	倦偀
hand	偁
hand's	偂
handbook	偁㙅
handed	偃ふ
handfuls	偁䉖
handicapped	偃々偄
handing	偃ぷ
handkerchiefs	偅ざ偆
handle	偃㞇
handlebars	偃㞇㍨
handled	偃假
handles	偃㡁
handling	偃㜑㐉
handmedown	偁ㆇ䑒
handmedowns	偁ㆇ偈
hands	偂
handsie	偁㙑
handsies	偁䊄
handsome	偃㍘
handy	偃々
handyman	偃々㑲
hang	偅
hanger	倦偉
hanger's	偐㙄
hangers	偅䝵
hanging	偅㈙
hangs	偑
hannah	倦㈠
hannah's	倦㈰
hansel	偃㜨
happen	倦偒
happened	倦偓
happening	倦㙢㍖
happens	倦偔
happiest	倦㉒䔵
happily	倦㙢〠
happiness	倦㉒ㄒ
happy	倦㉒
happybirthday	倦㉒㕳㕴
hard	偕
harder	㜶ㅅ
hardest	㜶偖
hardheaded	偕倳㝰
hardly	偕〠
hare	倰
hare's	偗
harmful	偘㍙
harmless	偘ㅐ
harmonica	㜶㈑㈈゙
harness	㜶ㄒ
harry	倦㈗
harvard	㜶䆄
harvest	㜶偙
has	偠
hash	偡
hasn't	倦偢
hassle	倦㜨
hat	偣
hatchling	偤
hate	健
hated	㔣〲
hates	偦
hats	偧
have	偨
haven't	倦偩
having	倦ぉ
hawk	偰
hawn	偱
hay	㔣
hayley	㔣〠
haystack	㔣偲
haystacks	㔣偳
hazard	倦側
he	偵
he'd	偶
he'll	偷
he's	偸
head	ㄗ
headache	倳偹
headache	倳偹
headband	ㄗ㐘
headband	ㄗ㐘
headbutt	ㄗ㠈
headbutt	ㄗ㠈
headbutted	ㄗ㈶㜷
headbutted	ㄗ㈶㜷
headbutting	ㄗ㈶す
headbutting	ㄗ㈶す
headbutts	ㄗ㠉
headbutts	ㄗ㠉
headed	倳ふ
heading	倳ぷ
headphones	ㄗ䔰
headphones	ㄗ䔰
heads	傀
heal	偷
heal	偷
heals	傁
health	傂
health	傂
healthy	傃㑤
healthy	傃㑤
heap	傄
heap	傄
heaped	傅
heaped	傅
hear	傆
heard	傇
hearing	偵ㄦ
hearing	偵ㄦ
hears	傈
heart	傉
heart's	傐
heart's	傐
heartbeat	傉㒒
heartbeat	傉㒒
heartie	㜶で
heartie	㜶で
heat	傑
heat	傑
heated	偵〲
heated	偵〲
heater	偵っ
heater	偵っ
heater's	偵ㅙ
heater's	偵ㅙ
heating	偵す
heating	偵す
heaven	倳䍡
heaven	倳䍡
heavenly	倳䍡〠
heavenly	倳䍡〠
heavens	倳傒
heavier	倳䄷㡹
heavier	倳䄷㡹
heavy	倳䄷
hebrews	偵㝐
hebrews	偵㝐
hedgehog	傓䦖
hedgehog	傓䦖
hedgehog's	傓傔
hedgehog's	傓傔
hee	偵
hee	偵
heel's	傁
heel's	傁
heels	傁
height	䢓
height	䢓
heinie	䌰㈔
heinie	䌰㈔
held	傕
helicopter	倳ㅗ傖っ
hell	傃
hello	倳㊔
helmet	傃傗
help	傘
helped	備
helper	傃㔈
helpful	傘㍙
helping	傃㞂
helps	儀
helter	傃っ
hen	儁
henry	儁㈗
henry's	儁㑴
hens	儂
her	儃
hera	倳ゆ
hercules	儃㕧㌒
here	傆
here're	億䀖
here's	傈
heres	儅
heros	偵儆
hers	儅
herself	儃儇
hey	㔣
heybie	㔣〃
hi	䌰
hicciuppies	億㎇䕘儈
hiccihicciuppies	億㎇億㎇䕘儈
hiccup	億儉
hiccups	億儐
hickies	億㕦
hickieuppies	億㎇䕘儈
hickory	億゙㈗
hid	儑
hidden	億䕀
hide	儒
hideandseek	䌰儓儔
hiding	䌰ぷ
high	䌰
highchair	䌰儕
highchairs	䌰儖
higher	儗
highest	䌰䔵
highfive	䌰䝁
highfives	䌰儘
hijklmnop@k	、㥢儙㠡㈵䕤ㆉ㘴㉒
hike	儠
hikers	䌰㐀
hill	儡
hills	儢
him	儣
himself	儣儇
hinge	儤
hint	儥
hip	儦
hippety	億䘵で
hippo	億䆈
hippopotamus	億㙢㉈〱䖐
hippos	億䐉
hips	儧
hired	儨
his	儩
hisself	儩儇
hit	儰
hits	儱
hitting	億す
hiya	䌰㕩
hmm	儲
hmmthat's	儲儳
ho	儴
hoe	儴
hog	䦖
hogging	儵㔗
hogwash	儶儷
hokey	儴㎇
hold	儸
holder	㠔ㅅ
holding	㠔ぷ
holds	儹
holdup	㠔兀
hole	㠔
holes	允
holey	儴〠
holiday	ㄘㅗ㕴
holler	ㄘ㝘
hollering	ㄘㅈㄦ
holly	ㄘ〠
hollyhock	ㄘ〠兂
hollywood	ㄘ〠元
holy	儴〠
home	兄
homemade	儴充
homes	兆
homework	兄兇
honestly	。䀑〠
honey	先㈔
honey's	先㈕
honeysuckle	先㈔光㈒
honk	児
honker	兑ざ
honking	兒㍀
hoo@o	兓
hoochie	兓え
hoochoo	兓ぐ
hood	兔
hook	兕
hooked	兖
hooking	兗㍀
hooks	兘
hoop	兙
hoops	兠
hooray	兗㊃
hoot	兡
hop	兢
hope	兣
hoped	兤
hopeful	兣㍙
hopefully	兣ㅦ〠
hopes	入
hophop	兢兢
hopie	儴㉒
hoping	儴㞂
hopped	兦
hoppety	ㄘ㉕で
hopping	ㄘ㞂
hoppity	ㄘ㉕で
hoppy	內㉕
hops	全
hopscotch	兢兩
horn	兰
horner	共㐠
horns	兲
horrible	儵ゆ〓
horribly	儵ゆ㖑
horse	关
horseradish	关㞐䐁
horses	共〧
horsie	共〄
horsie's	共〉
horsieback	共〴㎂
horsies	共〧
hose	兴
hospital	兵㉕㑶
hostas	儵其
hostile	兵㑶
hosts	具
hot	典
hotdog	典兹
hotmitt	典傗
hots	冀
hound	冁
hour	冂㡹
hours	冂䝵
house	冃
housecoat	㈷冄
houses	㈷〧
how	㈷
how'd	内
how're	円冇
how's	冃
however	円冈㈖
howling	㈷㐉
hows	冃
huber	冉㐲
hubers	兓䉒
hue	冉
huff	冐
huffed	冑
hug	冒
huge	冓
hugged	冔
hugger	先㔖
hugging	先㔗
huggy	先ㄇ
hugs	冕
huh	先
hum	冖
human	冉㡘
humming	先㔀
humor	冉㝸
hump	冗
humpty	冗で
hundred	冘写
hundreds	冘刀
hung	刁
hungrier	刁ㄔ㡹
hungry	刁ㄔ
hunhunh	䕘刂
hunkamunka	冘゙㆑゙
hunt	刃
hunting	冘す
hurley's	儃㌒
hurray	兗㊃
hurried	儃㞒
hurries	儃㑴
hurry	儃㈗
hurrying	儃㈗㈙
hurt	刄
hurting	儃す
hurts	刅
husband	分切
husband's	分刈
hush	刉
hut	刐
hydrant	䌰刑
hydrogen	䌰䑧䕷
hyena	䌰〆㈠
hymnal	儣㡒
hyper	䌰㔈
hypoallergenic	䌰䆈【㝘㈄䀧
i	㍣
i'd	䥃
i'll	ㄱ
i'm	划
i've	刓
i@l	㍣
iago	〆。ㄓ
ice	刔
ichabod	䕓゙刕
icie	㍣〄
icky	䕓㎇
icy	㍣〄
idea	㍣々〔
ideas	㍣々㊂
identify	㍣〶ち䜀
idiot	䕓々䍱
if	刖
ignorance	䘘㈠㉓
ignore	䘘列
ignoring	䘘㘴ㄦ
iguana	䕓刘㈠
ijklmnop@k	㍣儙㠡㈵䕤ㆉ㘴㉒
ill	则
illusory	䕓㐓䔶㈗
illustrated	䕓ㅈ䡐〲
imaginary	䕓㍈㕃䍨㈗
imagination	䕓㍈㔳㡐だ
imagine	䕓㍈䕷
imagining	䕓㍈㔳㍖
imitate	䕓䂉䘅
imitates	䕓䂉删
imitating	䕓䂉䄤す
imitative	䕓䂉䄤つ
immediately	䕓ㆇ々䍱〠
implies	刡㉢
important	刡刢刣
impossibility	刡㉈〘】ㅗで
impossible	刡㉈〘〓
imposter	刡㙢㑠
impressed	刡判
improper	刡別㔈
improperly	刡別㔈〠
in	぀
inanimate	䕓㐗㈠傗
inappropriate	䕓㈠刦㉦䍱
incessently	぀㢄刧〠
inches	぀㊁
inching	぀㖒
inchworm	刨利
including	぀䁒ぷ
income	぀㒘
increase	぀到
incredible	぀䈓㜑〓
incredibly	぀䈓㜑㖑
indeed	぀䊀
indeedie	぀々々
independent	぀㊓䍁〵
independently	぀㊓䍁〵〠
indestructible	぀䍐䍕〱〓
india	぀々〔
indian	぀々぀
indians	぀々䌠
indigo	぀㊓ㄓ
individual	぀㊓づ䥗ぱ
individuals	぀㜑づ㈅
indoors	぀䑃
inexpensive	䕓刱䍁ㄐ
infant	぀刲
infantry	぀刳䅶
infection	぀䐄だ
infections	぀䐄䉥
infinity	぀㢗㈈で
inflicting	぀刴す
influence	぀䝙䘴
inform	぀刵
informed	぀䠄
informing	぀䞕㔀
informs	぀制
infrastructures	぀刷䍔䈒
initiated	䕓㈈㉧、〲
injuries	぀券㑵
injury	぀㕃㈗
ink	刹
inning	䕓㍖
innocent	䕓㈠䌗
innovative	䕓㈠ぢつ
input	぀剀
inside	぀㕉
insist	぀剁
insistent	぀㌦剂
insists	぀剃
inspire	぀剄
instance	぀剅
instantly	぀䄡〠
instead	぀剆
instructions	぀䍔䉥
instrument	぀則ㆁ
instruments	぀則剈
intense	぀剉
intent	぀䄧
interaction	぀っ〳㌨
interest	぀〱䕶
interested	぀〱ㅩ㠅
interesting	぀〱ㅩ㠆
internet	぀っ剐
interpret	぀っ剑
interrupt	぀〱剒
into	぀剓
intrigued	぀剔
introduced	぀㡴剕
invent	぀䘉
invented	぀ゑ〲
investigate	぀剖ち䡸
investigator	぀剖ちㅘっ
invisible	぀づ䔶〓
invitation	぀づ䄤だ
invitations	぀づ䄤䄘
invited	぀ゔ〲
invites	぀剗
inviting	぀ゔす
involved	぀剘
involves	぀剙
iron	㍣剠
ironed	剡
ironing	剢㍖
irons	㍣剣
irritable	䕓㆐〱〓
irritate	䕓㆐䘅
irritated	䕓㆐䄤〲
irritates	䕓㆐删
irritating	䕓㆐䄤す
is	剤
isaac	㍣剥
isabel	䕓䔶〓
isaiah	㍣䀀〔
island	㍣䡲
island's	㍣剦
isn't	䕓偢
israel	剤剧
israelite	剤㊃䝔
it	䍱
it'd	䕓〲
it'll	䕓㑶
it's	剨
italian	䕓剩剰
italy	䕓〱〠
itch	剱
itches	䕓㊁
itching	䕓㖒
itchy	䕓え
items	㍣㙰
its	剨
itself	䍱儇
itsy	䍱〄
itty	䐓ち
ivy	㍣䄷
j	儙
j's	割
j@l	儙
jabbering	剳㐲㈙
jack	剴
jacket	剳㑗
jackets	剳㖇
jackie	剳㎇
jackrabbit	剳䆐㕵
jacks	創
jacob	儙剶
jacob's	儙剷
jafar	㕃䙷
jafar's	㕃剸
jail	剹
jake	劀
jam	劁
james	劂
jammie@s	剳ㆇ
jammies	剳㝹
jane	劃
jane's	劄
janie's	儙㈕
jar	劅
jarred	劆
jars	劇
jasmine	劈㕄
jaw	劉
jaws	劐
jay	儙
jaylen	儙㐤
jaylen's	儙㥧
jealous	㈄ㅐ
jeans	劑
jeez	劒
jeff	劓
jeff's	劔
jeffrey	㈄䠠
jeffrey's	㈄䠣
jello	㈄㊔
jelly	㈄〠
jellyfish	㈄〠䜳
jemima	㕃劕㊒
jeremiah	㈄ゆ劕〔
jeremy	㈄ゆㆇ
jerk	劖
jerome	㕃劗
jerry	㈄㈗
jesse	㈄〄
jesus	〈劘
jesus's	〈䔶ㅂ
jethro	㈄劙
jewelry	匀㈗
jewish	䥗䥴
jig	匁
jiggety	㔳㐔で
jiggling	㔳㐔㐉
jill	匂
jim	値
jim's	匃
jimmy	㔳ㆇ
jingle	㌃㈇
jingles	㌃䤀
jingly	㌃㐔〠
job	匄
jodie	㐦々
joe	㐦
joey	㐦〆
jog	包
jogging	匆㔗
john	匇
john's	匈
johnny	匆㈔
johns	匈
join	匉
joke	匐
joking	㐦㍀
jolly	匆〠
jonah	㐦㈠
jordan	䢑䕀
jordan's	䢑䡱
jordan's	䢑䡱
joseph	㐦匑
joshua	匆匒〔
joy	䖆
joyful	䖆㍙
judge	匓
judy	䥗々
judy's	䥗㈂
jug	匔
juggling	べ㐔㐉
juice	匕
juices	䥗〧
juicie	䥗〄
juicy	䥗〄
julia	匀㕩
julie	䥗〠
july	䕂ㅢ
jumble	化〓
jumbled	化北
jump	匘
jumped	匙
jumper	化㔈
jumping	化㞂
jumpingjack	化㞂剴
jumpingjacks	化㞂創
jumps	匠
june	匡
june's	匢
jungle	匣㈇
junior	䥗匤
junk	匥
junkajunka	匣゙匣゙
junky	匣㎇
just	ゃ
jut	匦
k	㠡
k@l	㠡
kaboom	゙㙈
kaboomie@o	゙〤ㆇ
kanga	匧㐔
kanga's	匧匨
kangaroo	匧㐔㊘
kangaroos	匧㐔匩
kansas	㠹劘
karate	゙匰で
karen	㠘䍴
karen's	㡠匱
kate	䂒
katherine	㠘匲
katie	㠡で
katy	㠡で
kay	㠡
kay's	匳
kayla	㠡ㅈ
keaton	㎇㒓
keaton's	㎇㠕
keep	匴
keeper	㎇㔈
keeping	㎇㞂
keeps	匵
keisha	㎇㙕
kekek@p	㠡㠡
kelly	㡠〠
kelsey	匶〄
ken	匷
kenny	㡠㈔
kept	匸
kerchief	ざ匹
kerchoo	ざぐ
ketchup	㡠區
kettle	㡠㑶
kevin's	㡠十
key	㎇
key's	㕦
keyboard	㎇㘠
keys	㕦
kick	卂
kickball	卂㐄
kicked	千
kicking	㖆㍀
kicks	卄
kid	卅
kid's	卆
kiddie	㖆々
kidding	㖆ぷ
kiddo	㖆ゅ
kidney	卅㈔
kids	卆
kids'	卆
kiki	㎇㎇
kill	升
killed	午
killing	㖆㐉
kills	卉
kim	卐
kimani	㖆㈑㈔
kind	卑
kinda	卒㜑
kindly	卒䠳
kinds	卓
king	㍀
king's	協
kingdom	㍀び
kings	協
kiss	单
kissable	㖆〘〓
kissed	卖
kisses	㖆〧
kissie	㖆〄
kissies	㖆〉
kissing	㖆㖙
kit	㑗
kitchen	㖆㥡
kite	南
kitten	㖆㒓
kittens	㖆㠕
kitties	㖆て
kitty	㖆で
kitty's	㖆て
kittycakes	㖆で㍸
kittycat	㖆で㡩
kittycats	㖆で㡰
kittykitty	㖆で㖆で
kiwi	㎇単
kleenex	㍉刱
knack	卙
knapsack	占卡
knee	㈔
kneedeep	㈔䌥
kneel	卢
kneeling	㈔㐉
knees	㈕
knew	㍑
knick	䀧
knife	卣
knifes	卤
knob	卥
knobs	卦
knock	卧
knocked	卨
knocking	け㍀
knocks	卩
knot	㡃
know	㘴
knowledge	けげ
known	印
knows	危
knox	卩
koala	㥑。ㅈ
kool	䅃
krista	㦄む
kristen	㦄㙦
kristen's	㦄卲
kristin	㦄即
kungfu	却䕇
kwanzaa	卵䔶
kyle	卶
kyle's	卷
l	䕒
l@l	䕒
la	䁳
la@si	䁳
label	㐆〓
labels	㐆㝙
lace	卸
laced	卹
laces	㐆〧
lacing	㐆㖙
lack	厀
lacking	ㄴ㍀
ladder	ㄴㅅ
ladies	㐆㈂
lady	㐆々
lady's	㐆㈂
ladybug	㐆々㝦
lake	ㅁ
lamb	厁
lambie	ㄴㆇ
lambs	厂
lame	厃
lamp	厄
land	厅
landed	历ふ
landing	历ぷ
landings	历㝱
lane	厇
language	厈厉
lantern	历厐
lap	厑
lapful	厑㍙
laps	䁷
large	厒
last	厓
latch	厔
latches	ㄴ㊁
late	䄕
lately	䄕〠
later	㐆っ
latest	㐆䉨
latin	ㄴ㒓
laugh	厕
laughed	厖
laughing	ㄴ㢙
laughs	厗
laundromat	厘䑧厙
laundry	厘㆙
laura	吀ゆ
laura's	吀㠴
lauren	吀㑇
lauren's	吀匱
law	吀
lawn	厘
lawnmower	吁䕰吂
lawrence	吀㉓
lay	㐆
layed	吃
laying	㐆㈙
lays	各
lazy	㐆㙑
leader	〠ㅅ
leading	〠ぷ
leaf	㔩
leafy	〠㕲
leaking	〠㍀
lean	吅
leaned	吆
leaning	〠㍖
leap	吇
leaped	合
leaping	〠㞂
leaps	吉
learn	吐
learned	向
learning	㝘㍖
learns	吒
leash	吓
least	吔
leave	㔰
leaves	㔲
leaving	〠ぉ
led	吕
ledge	吖
lee	〠
left	吗
leftie	吘で
leftover	吘㥀㈖
leftovers	吘㥀㒕
lefty	吘で
leg	吙
legend	䕤吠
leggie	䕤ㄇ
leggings	䕤吡
lego	䕤ㄓ
legos	䕤㘷
legs	吢
lemme	䕤ㆇ
lemon	䕤㡘
lemons	䕤吣
lena	〠㈠
lena's	〠㈰
leopard	䕤吤
less	㥳
let	吥
let's	否
lets	否
letter	䕤っ
letters	䕤ㅙ
letting	䕤す
lettuce	䕤㠣
level	䕤䍠
lever	〠㈖
levis	〠吧
lexington	䁹㖙㒓
library	ㅢ吨㈗
lick	䡳
licked	吩
licking	ㅗ㍀
licks	ㅀ
lid	吰
lid's	吱
lids	吱
lie	ㅢ
lied	吲
lies	吳
life	吴
lifesaver	吴䄇㈖
lifesavers	吴䄇㒕
lift	吵
liftie	吶で
lifting	吶す
lifts	吷
light	䝔
light's	䕗
lightbulb	䝔吸
lightbulbs	䝔吹
lighted	ㅢ〲
lightening	ㅢ〱㍖
lighter	ㅢっ
lightning	䝔㍖
lights	䕗
lightyear	䝔呀
like	ㅒ
liked	呁
likely	ㅒ〠
likes	呂
liking	ㅢ㍀
lil	呃
lilies	ㅗ㌒
lillian	ㅗ〠぀
lily	ㅗ〠
lilypad	ㅗ〠呄
lima	〠㊒
limbs	呅
lime	呆
limit	ㅗ傗
limits	ㅗ呇
linda	ㅖ㜑
lindsey's	呈䊄
line	ㄧ
lined	呉
linen	ㅗ呐
lingo	㐉ㄓ
lining	ㅢ㍖
links	呑
lint	䘠
lion	ㅢ呒
lions	ㅢ呓
lip	呔
lippie	䀠㉕
lips	呕
lipstick	呔㤖
liquid	ㅗ呖
liquids	ㅗ呗
lisa	〠〘
list	员
listen	ㅗ㦓
listened	ㅗ㦅
listening	ㅗ〴㍖
listens	ㅗ呙
lists	呠
lit	㚐
liter	〠っ
litter	ㅗっ
litters	ㅗㅙ
little	ㅗ㑶
littler	ㅗ〱㝘
littlest	ㅗ〱员
live	呡
lived	呢
liver	ㅗ㈖
lives	呣
living	ㅗぉ
liz	呤
lizard	ㅗ側
lizard's	ㅗ呥
load	㔴
loads	呦
loaf	呧
loan	ㅤ
loans	周
loaves	呩
lobster	呰㑠
lobsters	呰䁡
lock	呱
locked	呲
locking	䁳㍀
locks	䤵
log	㡲
lola	㊔ㅈ
lollipop	䁳〠味
lollipops	䁳〠呴
lolly	䁳〠
lolo	㊔㊔
london	呵䕀
lonely	ㅤ〠
lonesome	ㅤ㍘
long	ㅥ
longed	呶
longer	ㅥ㔖
longest	ㅥ呷
look	呸
looka	呹゙
looked	咀
lookee	呹㎇
lookie	呹㎇
looking	呹㍀
lookit	呹㑗
looks	咁
loom	咂
looneytoons	㐓㈔㡦
loons	㐑
loop	咃
looped	咄
loops	咅
loose	咆
loosed	咇
loosen	㐓㦓
loosens	㐓䚃
lop	咈
lopsided	咈䌘ふ
lord	咉
lord's	咐
lordie	咑々
lordy	咑々
loren	吀㑇
lori	吀㈗
lose	咒
loses	㐓ゕ
losing	㐓ㆃ
lost	咓
lot	咔
lot's	咕
lotion	㊔だ
lots	咕
lou	㐓
loud	ㅡ
louder	ㅠㅅ
loudie	ㅠ々
love	咖
loved	咗
lovely	咖〠
lover	咘㈖
loves	咙
lovie	咘䄷
loving	咘ぉ
lovings	咘唀
low	㊔
lowed	㔴
lower	㊔㡹
luck	唁
luckily	咘㖆〠
lucky	咘㎇
lucy	㐓〄
luggage	咘唂
luggages	咘㐔㤠
luis	㐓䤘
lujah@si	㐓㕩
lump	唃
lumpy	唄㉒
lunatic	㐓㈈㈱
lunatics	㐓㈠㈲
lunch	唅
lunchie	呵え
lunchmeat	唅唆
lunchtime	唅㉁
lure	唇
luther	㐓㌆
lydia	ㅗ々〔
lying	ㅢ㈙
lynn	ㅖ
lyricists	ㅗ㆐剃
lysol	ㅢ唈
m	䕵
m@l	䕵
ma	㈑
ma'am	唉
ma@q	㈑
mac	ど
macarena	㈑゙ㅩ㈠
macaroni	㍈゙㙥㈔
macaroniandcheese	㍈゙㙥㈔㆘㤹
macaronis	㍈゙㙥㈕
macdonald	偀䉴䐷
macgruff	偀唐
machine	㊒唑
machines	㊒唒
mad	唓
made	充
madman	唓㡘
mag	唔
magarina	㍈㐔㈗㈠
magazine	㍈㐔唕
magazines	㍈㐔唖
magba	唔㍥
magenta	㊒䢈〱
maggarina	㍈㐔㆐㈠
maggie	㍈ㄇ
maggie's	㍈㎖
magic	㍈唗
magical	㍈㔳㈒
magically	㍈㔳㍉
magnet	唔㙀
magnets	唔㠠
mags	唘
magsterina	唔㑠䕓㈠
maid	充
maids	唙
mail	䕴
mailbox	䕴㚅
mailboxes	䕴㍦〧
mailed	唠
mailing	ㆂ㐉
maillady	䕴㐆々
mailman	䕴㑲
mails	唡
main	唢
maine	唢
mainly	唢〠
maintenance	唢ち唣
make	唤
maked	唥
makes	唦
makeup	ㆂ䉕
making	ㆂ㍀
malfunction	唧䡕だ
malfunctioned	唧唨唩
malfunctioning	唧唨㢕㍖
malfunctions	唧唨唰
mall	唱
mallet	㍈㚐
malnutrition	唧㈠䕔だ
malt	唲
malto	唳㥀
mama	㈑㊒
mama's	㈑唴
mama@q	㈑㊒
mamama	㈑㈑㈑
mamma	㈑㊒
mammals	㍈㈐
mammy	㍈ㆇ
mamoo@q	㈑唵
man	㑲
manage	㍈䑥
managed	㍈唶
mandy	㑲々
mandy's	㑲㈂
maneuvering	㊒㍑ㆅㄦ
manger	唢券
mango	唷ㄓ
manipulate	㊒唸㕩䄕
manniken	㍈㈈㥉
manually	㑲㊈〔〠
many	ㆉ㈔
map	唹
marble	啀〓
march	啁
marcha	啀㢕
marcher	啀を
marches	啀㊁
marco	啀㥑
marco's	啀啂
margaret	啀䦐
margarine	啀㕃䍴
marianne's	㍈㆐啃
marie	㊒㈗
marie's	㊒㑴
marigolds	ㆉ㆐䤳
marino	㊒㈗㘴
mark	啄
mark	啄
marked	啅
marker	啀ざ
markers	啀㐀
market	啀㑗
marking	啀㍀
marks	商
marks	商
marmalade	啀㊒吃
marni	啀㈔
marriage	㍈㕕
married	㍈㞒
marry	㍈㈗
mars	啇
marsh	啈
marshalls	啀䂑
marshmallow	啀啉㊔
marshmallows	啈ㆉ䞉
martha	啀啐
mary	ㆂ㈗
mary's	ㆂ㑴
mash	啑
mashed	啒
mashing	㍈㝕
mason	ㆂ㦓
mass	啓
massage	㊒啔
massive	㍈ㄐ
master	啓っ
mastercard	㍈㑠㡑
masterpieces	㍈㑠㉒〧
mat	厙
match	啕
matches	㍈㊁
matching	㍈㖒
mate	啖
mates	啗
material	㊒ち㈗ぱ
matt	厙
matter	㍈っ
matters	㍈ㅙ
matthew	啘㊈
matthew's	啘啙
mattress	㍈㦙
maura	啠ゆ
maura's	啠㠴
max	啡
max's	どㅂ
maximum	ど〴啢
may	ㆂ
maybe	ㆂ〃
mayonnaise	ㆂ〔啣
mayor	ㆂ㡹
mcdonald	偀䉴䐷
mcdonalds	偀䉴䐸
mcgregor	㊒ㄉ㔖
mcgregor's	啤ㄉ㙄
mcmuffin	偀䤲䐱
me	ㆇ
me's	㝹
meadow	ㆉゅ
meal	啥
mealtime	啥㉁
mean	啦
meaned	啧
meanie	ㆇ㈔
means	啨
meant	㢉
meantime	啦㉁
meanwhile	啦啩
measure	ㆉ啰
measures	ㆉ䤅
measuring	啱〔ㄦ
meat	唆
meatballs	唆㐅
meatloaf	唆呧
meaty	ㆇで
mechanical	㊒㠘㈈㈒
meddle	ㆉ㞇
meddled	ㆉ假
meddles	ㆉ㡁
meddlesome	ㆉ㞇㍘
meddling	ㆉ㜑㐉
medical	ㆉ々㈒
medicine	ㆉ㊓㦓
medicine's	ㆉ㊓䚃
medium	ㆇ々㉸
meeko	ㆇ㥑
meet	唆
meeting	ㆇす
meets	啲
meg	啳
mega	ㆉ㐔
megablocks	ㆉ㐔啴
megan	ㆂ䑠
melanie	ㆉㅈ㈔
melissa	㊒ㅗ〘
melon	ㆉ㐤
melt	啵
meltdown	啵䑒
melted	啶〲
melting	啶す
melts	啷
membrane	啸㚓
meme	ㆂㆂ
memee	ㆇㆇ
memorize	ㆉ㊒㊐
memory	ㆉ㊒㈗
men	ㆈ
mention	ㆈだ
mentioned	ㆈ啹
meow	ㆇ冂
meow@o	ㆇ冂
merchant	㝸㆗
mercies	㝸〉
mercy	㝸〄
mermaid	㝸充
merrily	ㆉ㆐〠
mesh	喀
mess	䐴
message	ㆉ喁
messages	ㆉ〴㜘
messed	喂
messer	ㆉ㈥
messes	ㆉ〧
messing	ㆉ㖙
messy	ㆉ〄
met	喃
metal	ㆉ㑶
method	ㆉ善
mets	喅
mew	㆔
mi@si	ㆇ
mice	喆
michael	劕㈒
michael's	劕㈓
micies	劕〉
mickey	䂉㎇
mickey's	䂉㕦
mickie	䂉㎇
micky	䂉㎇
microphone	劕喇喈
microphone's	劕喇䔰
microphones	劕喇䔰
microwave	劕䈤喉
middle	䂉㞇
midmorning	喐㐕㍖
midnight	喐䥁
midwest	喐喑
might	喒
mighty	劕で
mike	喓
mike's	喔
mikey	劕㎇
mikie	劕㎇
mile	喕
miles	喖
military	䂉ㅗ㈩㈗
milk	喗
milkie	喘㎇
milkies	喘㕦
milky	喘㎇
million	䂉喙
millions	喘嘀
mimi	ㆇㆇ
mind	嘁
mine	嘂
minestrone	䂉㈈䡶㈔
minnie	䂉㈔
minnies	䂉㈕
minnows	䂉危
mint	ㆁ
minute	劕嘃
minutes	䂉㠠
miranda	䂉嘄㜑
mirror	䂉䀖
mirrors	䂉䕹
miserable	䂉䔶ゆ〓
misery	䂉䔶㈗
miss	嘅
missed	嘆
missing	䂉㖙
mission	䂉だ
missus	䂉〧
missy	䂉〄
mistake	嘅嘇
mistaken	嘅䄤㄀
mister	嘅っ
mistreat	䂉嘈
mistress	䂉嘉
mit@l	㈵劕で
mittens	䂉㠕
mix	䤄
mixed	嘐
mixer	䤃㈥
mixes	䤃ㅂ
mixing	䤃㖙
mkay	㉸㠡
mmhm	㉸儲
mm	㉸
mhm	㉸儲
ohgoodness	㥂䤸ㄒ
mygoodness	劕䤸ㄒ
ohmygoodness	㥂劕䤸ㄒ
guzenheit@snle	㐔䢒䢓
mms	嘑
mmm	㉸
mmming	〔㔀
mmms	嘑
mo	䕰
moaning	䕰㍖
moat	䕸
mobile	䕰㍐
mockingbird	㈑㍀㕰
mode	嘒
model	㈑㞇
modeling	㈑㜑㐉
moira	嘓ゆ
molar	䕰㝘
mom	嘔
mom'll	㈑㈉
mom's	嘕
moment	䕰ㆁ
moments	䕰剈
momma	㈑㊒
momma's	啠唴
mommies	㈑㝹
mommy	㈑ㆇ
mommy'll	㈑ㆇぱ
mommy's	㈑㝹
moms	嘕
monday	嘖㕴
money	䤲㈔
moneys	䤲㈔
monica	㈑㈈゙
monitor	㈑㈈っ
monkey	㆑㎇
monkey's	㆑㕦
monkeys	㆑㕦
monst	嘗
monster	嘘㑠
monster's	嘘䁡
monsters	嘘䁡
monstrous	嘙㦙
month	嘠
months	嘡
moo	唵
moo@o	唵
mooboosh	唵㙔
moocow	唵䅨
mood	嘢
moody	唵々
mookaboosh	唵゙㙔
moomoo	唵唵
moomooshas	唵唵ㅑ
moon	嘣
moonlight	嘣䝔
moose	嘤
moosh	嘥
mooshaboosh	唵㙕㙔
mooshaboosha	唵㙕〤㙕
mooshabooshas	唵㙕〤ㅑ
mooshas	唵ㅑ
mooshasboosh	唵ㅑ㙔
mooshboosh	嘥㙔
mooshbooshas	嘥〤㝗
mooshieboosh	唵㉧㙔
mooshiebooshas	唵㉧〤ㅑ
mooshmoosh	唵嘦
mooski	唵嘧
mootas	唵䊅
mootash	唵嘨
mootie	唵で
mootieboosh	唵で㙔
mootiebooshas	唵で〤ㅑ
mootiemoo	唵で唵
mootiemooshas	唵で唵ㅑ
mop	嘩
mopped	嘰
moppet	㈑嘱
mopping	㈑㞂
mops	嘲
mopsy	嘩〄
more	㈸
morgan	㈸㔘
morgan's	㈸㔠
morgie	㐕ㄇ
morgie's	㐕㎖
morning	㈸㍖
moses	䕰ゕ
mosquito	䖐㎇㥀
mosquitos	㊒嘧嘳
moss	嘴
most	ㅣ
mostest	䕰㕒
mostly	嘵㒑
mother	䤲ㅵ
mother's	䤲㙩
motherland	䤲ㅵ厅
mothers	䤲㙩
moths	嘶
motive	䕰つ
motor	䕰っ
motorbike	䕰っ㕡
motorcycle	䕰っ䌘㈒
mount	㆒
mountain	嘷㒓
mountains	嘷㠕
mountaintop	嘷㒓䅳
mouse	嘸
mouse's	嘹ㅂ
mouses	嘹〧
mousie	嘹〄
mouth	噀
mouthful	噀㍙
mouthie	嘹㑤
mouthing	嘹㑥
mouthpiece	噀噁
mouths	噂
move	噃
moved	噄
movement	噃ㆁ
movements	噃噅
moves	噆
movie	唵䄷
movies	唵噇
moving	唵ぉ
mow	䕰
mower	䕰㡹
mowing	䕰㈙
ms	噈
much	噉
mud	噐
muddy	䤲々
mufasa	唵䑅〘
muffet	䤲噑
muffin	䤲䐱
muffins	䤲䐲
mug	噒
mugs	噓
mulan	唵吁
mulberry	噔㑆㈗
mules	噕
multicolored	噔でぃ䂀
multiple	噔ち㉘
multitalented	噔で㌹㐤㜷
mum	噖
mumbling	噖㍱
mummy	䤲ㆇ
munch	噗
munchkin	噗㥉
muppet	䤲㡙
muppets	䤲噘
murphy	㝸㕲
muscleman	䤲㜨㑲
muses	㆔ゕ
museum	㆔㙑㉸
mush	噙
mushed	噠
mushing	䤲㝕
mushroom	䤲噡
mushrooms	噙噢
mushy	䤲㉧
music	㆔剥
musical	㆔䁖㈒
muskrats	䤲噣
must	噤
mustache	䤲噥
mustard	噦㢒
mustn't	䤲刧
mutilate	㆔〱䄕
my	劕
myself	劕儇
mystery	嘅〱㈗
n	䖁
n@l	䖁
nah	㐠
nail	䜥
nails	䜦
naked	㡐卅
nala	けㅈ
name	噧
name's	器
named	噩
names	器
naming	㡐㔀
nan	噰
nan's	噱
nana	㐗㈠
nana's	け㈰
nananana	け㈠け㈠
nap	占
napkin	占㥉
napkins	占㥐
nappie	㐗㉒
nappies	㐗儈
napping	㐗㞂
nappy	㐗㉒
naps	噲
naptime	占㉁
nas	噳
nasty	噴で
nathan	㡐噵
nation	㡐だ
nations	㡐䉥
natural	㐗㢕㑂
naturally	噶ゆ〠
naughty	噷で
nautilus	噷ち䙖
navigate	㐗づ䡸
navy	㡐䄷
near	噸
nearby	噸ㅉ
nearer	㈔䀖
nearly	噸〠
neat	噹
neatest	㈔䉨
neatly	噹〠
neato	㈔㥀
necessarily	䍨〘㢄ゆ〠
necessary	䍨〴㢄㈗
neck	䄗
necklace	䄗ㅐ
necklaces	䍨䀠〧
neckties	䄗嚀
ned	嚁
need	嚂
needed	㈔ふ
needing	㈔ぷ
needle	㈔㞇
needs	嚃
negative	䍨㐔つ
neglecting	㈠嚄す
neigh	㡐
neighbor	㡐㐲
neighbor's	㡐䉒
neighborhood	㡐㐲兔
neighborly	㡐㐲〠
neighbors	㡐䉒
neither	㈔ㅵ
nellie	䍨〠
neon	㈔䈇
nephew	䍨䄒
nephew's	䍨䄐
nerve	嚅
nerves	嚆
nervous	㐠嚇
nest	嚈
nesting	䍨㠆
nests	嚉
net	剐
neuter	㍑っ
neutral	㍑嚐
never	䍨㈖
new	㍑
newborns	㍑嚑
newport	㍑嚒
news	嚓
newspaper	嚓㉉㔈
newt	嘃
next	嚔
nibbled	㈈北
nice	嚕
nicely	䌹䁁
nicer	䌹㈥
nick	䀧
nickel	㈈㈒
nickelodeon	㈈゙㊔々぀
nicole	㈈䁶
niece	嚖
nigerians	䌹㔳㈗䌠
night	䥁
night's	嚗
nightgown	䥁䥉
nightgowns	䥁䥐
nightie	䌹で
nightlight	䥁䝔
nightmare	䥁嚘
nightnight	䥁䥁
nights	嚗
nightshirt	䥁嚙
nighttime	䥁㉁
nilly	㈈〠
nine	圀
nineteen	圀䕐
ninety	圀で
ninja	呐㕃
nino	㈔㘴
ninth	圁
nipple	㈈㉘
nixie	䀧〴
no	㘴
noah	㘴〔
noah's	㘴㊂
noba@c	㘴㍥
nobody	㘴㍥々
nobody's	㘴㍥㈂
nodded	けふ
nodding	けぷ
noggin	け㔘
noise	圂
noises	㈘ゕ
noisy	㈘㙑
none	刂
nonexistent	け圃䁖䄠
nono	㘴㘴
nonono@si	㘴㘴㘴
nononoing	㘴㘴㘴㈙
noodle	㍑㞇
noodles	㍑㡁
nookcase@n	圄㙆
noontime	㄂㉁
nope	圅
nopes	圆
nopie	㘴㉒
nor	䖉
normal	䖉㈉
normally	䖉㊒〠
north	圇
nose	危
nosed	圈
nosedives	危䐙
noses	㘴ゕ
nosey	圉䁖
nosie	㘴㙑
not	㡃
note	圐
notes	䄙
nothing	㈣㉀
nothing's	㈣䘔
notice	㘴㠣
noticed	㘴䉨
notices	㘴ち〧
noticing	㘴ち㖙
novelty	け䍠で
november	㘴圑㐲
now	園
nowhere	㘴㉄
nudieper	㍑々㔈
nudist	㍑偖
nugget	㈣䤐
nuggets	㈣圓
nuhuh	㈣䕘
nuisance	㍑圔
num	圕
number	圕㐲
numbers	圕䉒
nummies	㈣㝹
nummy	㈣ㆇ
numnum	圕圕
nurse	圖
nursery	㐠〘㈗
nurses	㐠〧
nursing	㐠㖙
nut	㠒
nutcracker	㠒䆐ざ
nutrient	㍑䅶䐈
nutritional	㍑䕔䄈㡒
nutritious	㍑䕔ㆄ
nuts	䑐
nutty	㈣で
o	㥂
o'clock	〔䀶
o'clocker	㥂圗ざ
o'clocks	〔團
o@l	㥂
o@l-s	㥂
oatmeal	圙啥
oats	圠
obedient	㥂〃々䐈
obekaybe	㥂〃㠡〃
obey	㥂㍴
obi	㥂〃
obi's	㥂㍵
obie	㥂〃
objects	圡圢
observed	〡圣
observing	〡㚇ぉ
obsessed	〡圤
obtained	〡䄥
obvious	圡䄷㌘
obviously	圡䄷䕓䁁
occasion	〔㠡䙀
occasionally	〔圥〔㡒
occurred	〔圦
ocean	㥂だ
octagon	圧〱在
october	圧㥀㐲
octopi	圧〱䉰
octopus	圧〱圩
odd	地
of	圱
off	圲
off@n	圳
offensive	〔䌧ㄐ
offer	ㅶ㦇
offered	ㅶ䀡
offers	ㅶ圴
offhand	圲偁
office	ㅶ圵
official	〔㢗㈳
officially	〔㢗㙕〠
often	ㅶ刳
oh	㥂
ohio	㥂䌰㥂
oil	圶
oiled	圷
oink	圸
oink@o	圸
oinkoink	圹址
ointment	坁も
ok	㥂㠡
okay	㥂㠡
okeydokey	㥂㎇ゅ㎇
old	坂
olden	坃䕀
older	坃ㅅ
olive	。呡
olives	。呣
olivia	㥂ㅗ䄷〔
omega	㥂ㆉ㐔
on	䈇
once	坄
one	㈹
one's	䘒
ones	䘒
onesie	㈹〄
onie	坅㈔
onion	䕘坆
onions	均嘀
online	䈇ㄧ
only	坈〠
onsie	㈹〄
onsies	㈹〉
onto	䈇剓
oop	坉
oops	坐
oopsadaisy	坉〘㕴㙑
oopsadaisys	坉〘㕴䊄
oopsie	坉〄
oopsiedoozies	坉〄䁨䊄
oopsiedoozy	坉〄䁨㙑
oopsies	坉䊄
op@c	坑
open	㥂偒
opened	㥂偓
opener	㥂㙢㐠
opening	㥂㙢㍖
opens	㥂偔
operation	。㙢㊃㌨
operator	。㙢㊃っ
opinion	〔㉕坒
opportunity	。㔈剓㈈で
opposed	〔坓
opposite	。㙢䁂
opposites	。㙢坔
option	坕
options	坑䉥
or	䅇
orange	ㅶ坖
oranges	ㅶ䍴㜘
orangish	ㅶ䍴块
orangutan	ㅶ㙉㐔坘
order	䅇ㅅ
ordered	䅇㎈
ordering	䅇㜑ㄦ
orderly	䅇ㅅ〠
ordinary	坙㈠㈗
organize	䅇㐔坠
organized	䅇㐔坡
originally	〔㆐㕃㈠〠
orioles	㥂㈗坢
ornaments	䅇㈠剈
orphan	䅇刳
orthodontic	䅇啐䐵㈱
orthodontics	䅇啐䐵㈲
orthodontist	䅇啐䐵䉨
orthodontist's	䅇啐䐵䌸
orthodontists	䅇啐䐵䌸
oscar	。坣
oscar's	。坤
ostrich	坥坦
otay	㥂䄤
other	䕘ㅵ
others	䕘㙩
otherwise	䕘ㅵ坧
ouch	坨
ouchie	冂え
ouchies	冂㤹
ought	坩
oughtta	ㅶ〱
ounce	坰
ounces	坱〧
our	冂㡹
ours	冂䝵
ourself	㊀儇
out	坲
outdoor	坲㎃
outdoors	坲坳
outer	冂っ
outfit	坲䜷
outgrown	坲倁
outlaw	坲吀
outlet	坲吥
outlets	坲否
outrageous	坲㊃䥆
outside	坲㕉
outtalk	坲坴
oval	㥂䍠
oven	䕘䍡
over	㥂㈖
overalls	㥂㈖坵
overboard	㥂㈖㘠
overflow	㥂㈖䝧
overflowing	㥂㈖䝧㈙
overload	㥂㈖㔴
overnight	㥂㈖䥁
overtime	㥂㈖㉁
overzealous	㥂㈖坶䙖
ow	冂
owe	㥂
owie	坷
owl	坸
owl's	坹
owls	垀
own	坈
owned	垁
owner	㥂㐠
owowow@o	冂垂
oyster	垃っ
p	㉒
p@l	㉒
pacie	㉉〄
pacifier	㌙〄䜩
pacifiers	㌙〴䜰
pack	垄
package	㌙垅
packages	㌙゙㤠
packed	垆
packet	㌙㑗
packing	㌙㍀
packs	垇
pad	呄
pad's	垈
paddy	㌙々
page	垉
paged	垐
pager	㉉券
pages	㉉㜘
paging	㉉㌃
paid	垑
pail	垒
pain	垓
painful	垓㍙
paint	垔
painted	垓〲
painting	垓す
pair	垕
pairs	垖
pajama	㙢匆㊒
pajamaies	㙢垗唴
pajamas	㙢匆唴
pal	垘
palace	㌙ㅐ
paly	㉉〠
pamper	垙㔈
pamper's	垙䀲
pampers	垙䀲
pan	㥠
pancake	㥠㍷
pancakes	㥠㍸
panda	㥠㜑
panicked	㌙堀
pans	堁
pant	堂
panther	㥠㌆
panties	㥠て
panting	㥠す
pantry	㥠䅶
pants	堃
pantsie	堂〄
pantsies	堂〉
papa	㉈㙢
papaya	㙢䉰〔
paper	㉉㔈
papers	㉉䀲
paperwork	㉉㔈兇
papou	㙢堄
parade	㙢䢀
parading	㙢㊃ぷ
paranoid	㌙ゆ堅
parcheesi	㉆え㙑
pardon	㉆䕀
parents	㌙堆
parents's	䘵堇ㅂ
park	堈
parked	堉
parkie	㉆㎇
parlor	㉆㝘
parrot	㌙㡡
parsnipie	㉆堐㉒
parsnips	㉆堑
part	㉅
participate	㉆ち〴堒
particular	㔈ち㕧㝘
particularly	㔈ち㕧㝘〠
parting	㉆す
partner	㉅㐠
parts	堓
party	㉆で
pass	堔
passed	堕
passenger	㌙㦓券
passes	㌙〧
passing	㌙㖙
password	㌙堖
past	堕
pasta	㉈む
paste	堗
pasty	堘で
pat	堙
patch	堠
patched	堡
patches	㌙㊁
patching	㌙㖒
patchy	㌙え
path	堢
patience	㉉堣
patient	㉉堤
patients	㉉堥
patio	㌙で㥂
patrice	㙢堦
patrick	㌙䄂
patricks	㌙堧
pats	堨
patted	㌙〲
patterns	㌙堩
patting	㌙す
patty	㌙で
pattycake	㌙で㍷
pattycaking	㌙で㠡㍀
pattytake	㌙で嘇
paul	堰
paul's	報
paula	堲ㅈ
pause	堳
paused	場
pausing	堲ㆃ
pavement	堵ㆁ
pavilioned	㙢堶堷
paw	堲
paws	堳
pay	㉉
paycheck	㉉㤦
payed	垑
paying	㉉㈙
payment	㉉ㆁ
payments	㉉や
payperview	㉉㔈堸
pea	㉒
peace	噁
peaceful	噁㍙
peach	堹
peaches	㉒㊁
peanut	㉒㠒
peanutbutter	㉒㠒㈶っ
peanuts	㉒䑐
pear	垕
pearie	䘵㈗
pearl	塀
pearly	㔈〠
pears	垖
peary	㉒㈗
peas	儈
pedals	䘵㡁
pedialyte	㉒々〔䝔
pee	㉒
peed	㢓
peeing	㉒㈙
peek	塁
peeka	㉒゙
peekaboo	㉒゙〤
peeks	塂
peel	塃
peeled	塄
peeling	㉒㐉
peels	㉑
peep	塅
peeped	塆
peepee	㉒㉒
peepees	㉒儈
peeping	㉒㞂
peers	塇
pees	儈
peeyou	㉒㊈
peeyoustinky	㉒㊈㠆㎇
peg	塈
pegasus	䘵㐔㌦
pegger	䘵㔖
peggie	䘵ㄇ
pegs	塉
pen	䍁
pencil	䍁㜨
pencils	䍁㜩
penguin	塐塑
penguins	塒塓
penney	䘵㈔
pennies	䘵㈕
penny	䘵㈔
pens	塔
pentagon	䍁〱在
peonies	㉒〔㈕
peony	㉒〔㈔
people	㉒㉘
people's	㉒㉙
pepe	㉉㉉
pepper	䘵㔈
pepper's	䘵䀲
peppers	䘵䀲
pepsi	塕〄
per	㔈
percent	㔈㢐
perfect	㔈塖
perfectly	㔈塗〠
perform	㔈刵
performed	㔈䠄
performer	㔈䞕㝸
performing	㔈䞕㔀
performs	㔈制
perfume	㔈塘
perhaps	㔈塙
period	㉕㈗塠
permission	㔈䂉だ
peroxide	㙢塡㕉
perpendicular	㔈偒㊓㕧㝘
persistent	㔈㌦剂
person	㔈㦓
person's	㔈呙
personal	㔈〴㡒
personality	㔈〴㐗ㅗで
personnel	㔈〴塢
perspective	㔈䘱つ
perspiration	塣㙢㊃だ
pesky	塤㎇
pester	䘵㑠
pet	塥
petal	䘵㑶
petals	䘵㔑
pete	塦
peter	㉒っ
peter's	㉒ㅙ
pets	塧
petted	䘵〲
petting	䘵す
phil	䜙
phillip	㢗呔
philosophy	㢗䁳〘㕲
phone	喈
phone's	䔰
phones	䔰
phonics	䑅䀨
phony	䞄㈔
photo	䞄㥀
photogenic	䞄〱㈄䀧
photographic	䞄〱䄔䝃
photosynthesis	䞄㥀㦓啐㌦
phrase	塨
piano	㉒【㘴
picachu	㉒㍓ぐ
pick	塩
picked	塰
picking	㉕㍀
pickle	㉕㈒
pickles	㉕㈓
picks	塱
picky	㉕㎇
picnic	塩䀧
picnics	塩䀨
picture	塩を
pictures	塩䈒
pie	䉰
piece	噁
pieces	㉒〧
pies	䍑
pig	塲
pigeon	㉕䕷
pigeons	㉕塳
piggie	㉕ㄇ
piggies	㉕㎖
piggy	㉕ㄇ
piggy's	㉕㎖
piglet	塲㚐
piglet's	㉕塴
piglets	㉕塵
pigpen	塲䍁
pigs	塶
pigtail	塲䅦
pike	塷
pile	塸
piles	塹
pillow	㉕㊔
pillows	㉕䞉
pin	墀
pina	墁㕩
pinch	墂
pinched	境
pinchie	墀え
pinching	墀㖒
pine	墄
pineapple	䉰㐗㉘
pineapples	䉰㐗㉙
pinecones	墄墅
pink	墆
pinkie	㞂㎇
pinky	墇㖆
pinnochio	㉕㘴㎇㥂
pins	墈
pinto	墀㥀
pipe	墉
piper's	䉰䀲
piping	䉰㞂
pipsqueak	墐墑
pissant@n	㉕墒
pissy	㉕〄
pit	㡙
pitched	墓
pitcher	㉕を
pitiful	㉕ち㍙
pizza	塦〘
pjs	㉒割
place	䘓
placed	墔
places	䂔〧
plain	ㄨ
plainly	ㄨ〠
plan	墕
plane	ㄨ
planet	墖㙀
planing	䂔㍖
plant	増
planted	墕〲
plants	墘
plastic	墙㈱
plate	夀
plates	夁
platinum	墖ち夂
platter	墖っ
play	䂔
played	夃
player	䂔㡹
playful	䂔㍙
playground	䂔㎆
playgroup	䂔䦗
playhouse	䂔䐨
playing	䂔㈙
playoffs	䂔处
playpen	䂔䍁
playpenie	䂔䘵㈔
playroom	䂔夅
plays	夆
playtex	䂔备
playtime	䂔㉁
pleasant	夈偢
please	変
pleased	夐
pleasure	夑㡹
plenty	㉇で
plop	夒
plops	夓
plow	夔
plug	夕
plugged	外
plugs	夗
plum	夘
plums	夙
plunged	夠
plus	夡
pluto	夢㥀
pochahontas	䆈゙夣夤
pocket	㉈㑗
pocketbook	㉈㑗㙅
pockets	㉈㖇
pod	夥
point	㉥
pointed	䎑〲
pointer	䎑っ
pointers	䎑ㅙ
pointing	䎑す
points	夦
pointy	䎑で
poison	大䆂
poisonous	夨぀䤘
poke	天
pokecenter	天㢑っ
poked	夰
pokefood	天䞐
pokemon	䆈㎇嘘
pokes	失
pokey	䆈㎇
pokie	䆈㎇
poking	䆈㍀
polar	䆈㝘
pole	夲
poles	夳
police	㙢䕧
policeman	㙢䕧㡘
policy	㉈ㅗ〄
polish	㉈头
polished	㉈夵
polishes	㉈ㅗㅑ
polishing	㉈ㅗ㝕
polite	㙢䝔
politely	㙢䝔〠
polkadot	夲゙䑈
polo	䆈㊔
polyester	㉈〠㈵㑠
pond	夶
pony	䆈㈔
ponytail	䆈㈔䅦
poo	堄
poo's	夷
poodle	堄㞇
pooh	堄
pooh's	夷
poohs	夷
pooie	堄〆
pookie	堄㎇
pool	夸
poop	夹
poopie	堄㉒、
poopied	堄奀
poopies	堄奁
pooping	堄㞂
poopoo	堄堄
poopoos	堄夷
poops	奂
poopsie	夹〄
poopsie^boo	夹〄〤
poopsieboo	夹〄〤
poor	奃
poos	夷
pop	味
popbeads	味㑹
popcorn	味䅗
popeye	㉈䉰
popped	奄
poppetypoppoppop	㉈䘵で味味味
popping	㉈㞂
poppy	㉈㉒
popsicle	味〴㈒
popular	㉈奅㝘
popup	㉈奆
porch	奇
porcupine	刢㕧墄
porridge	堲㕕
portfolio	嚒䞄〠㥂
porthole	嚒㠔
pose	䐉
poser	䆈㚇
posies	䆈䊄
position	㙢䁖だ
positive	㉈䁖つ
possible	㉈〘〓
possibly	㉈〘㖑
possums	㉈奈
post	奉
posted	䆈奐
poster	契っ
posting	䆈㠆
posts	奒
posy	䆈㙑
pot	奓
potato	㙢䄤㥀
potatos	㙢䄤嘳
potent	䆈刣
potholder	奓㠔ㅅ
potpourri	䆈奔㈗
pots	奕
potted	㉈〲
potter	㉈っ
potty	㉈で
pottytrain	㉈で奖
pouch	套
pouches	奘㦑
pouncy	奙〄
pound	奠
pounding	奡ぷ
pounds	奢
pour	奣
poured	奤
pouring	䆈ㄦ
pours	奥
pouting	奘す
pouty	奘で
pow	奘
powder	奘ㅅ
powells	奦
power	奘㡹
powerful	奘㡹㍙
practically	奧ち㍉
practice	奧㠣
practicing	奧ち㖙
prairie	奨㈗
praise	奩
praised	奰
pray	奨
prayer	奱
prayers	奲
precious	䙄ㆄ
precisely	㉲䌘䁁
prefer	㉲㦇
prefers	㉲圴
pregnant	女奴
prehistoric	㉦億奵㤕
premiums	㉦ㆇ嘑
preparation	䙄㙢㊃だ
prepare	㉲奶
preschool	㉦奷
prescription	奸她だ
prescriptions	㉲妀䉥
presence	䙄妁
present	䙄偢
presents	䙄如
preserver	㉲㚇㈖
press	䙂
pressed	判
pressing	䙄㖙
pressure	䙄䐃
pretend	㉲妃
pretending	㉲㍁ぷ
prettier	㉲で㡹
pretties	㉲て
pretty	㉲で
pretzel	妄㜨
pretzels	妄㜩
prevents	妅妆
price	妇
prick	妈
pricked	妉
prickly	妈〠
primarily	妐ㆉゆ〠
primary	妐ㆉ㈗
prime	妑
prince	妒
princess	妓䘡
principle	妓〴㉘
printed	妓〲
prior	妐㡹
priority	妐ㅶ㆐で
private	妐妔
privilege	㉲ㆅげ
prize	妕
pro	刦
probably	別㍥㖑
problem	妖䂂
problems	別妗
procedure	妅〄券
process	別䘡
produce	別妘
produced	妅剕
product	別妙
products	別怀
professor	妅䙤㈥
profiling	刦䜀㐉
program	刦䥙
project	別态
projects	別怂
promise	別嘅
promised	別嘆
promises	別䂉〧
promote	妅䕸
pronunciation	妅刂〄、㌨
proof	怃
propeller	妅䘵㝘
proper	別㔈
properly	別㔈〠
protect	妅怄
protected	妅怅〲
protecting	妅怅す
protection	妅怅だ
protein	刦䕐
protest	刦怆
protesting	妅㈩㠆
proud	怇
prove	怈
provider	妅ゔㅅ
proving	怉ぉ
prowl	怐
prunes	怑
psalm	怒
psalms	怓
psghettios	怔怕で㤷
psycho	䌘㥑
publish	怖头
pucker	怗ざ
puckering	怗゙ㄦ
pudding	奔ぷ
puddle	怗㞇
puddleduck	怗㞇䔈
puddles	怗㡁
puddy	怗々
puff	怘
puffed	怙
pull	怠
pulled	怡
pulling	奔㐉
pullover	奔㊔㈖
pulls	怢
pumba	怣㍥
pump	怤
pumpkin	急怦
pumpkins	怤㥐
punch	性
punishment	怗䅙ㆁ
punkin	怨㥉
punky	怨㎇
pup	奆
puppet	怗㡙
puppets	怗噘
puppies	怗儈
puppy	怗㉒
puppy's	怗儈
puppydog	怗㉒䐥
pups	怩
purchase	㔈怰
purifier	怱㆐䜩
purple	㔈㉘
purpose	㔈圩
purr	㔈
purse	塣
push	怲
pushed	怳
pushes	奔㌐
pushing	奔㝕
pushovers	奔怴㒕
pussycat	奔〄㡩
put	剀
puts	怵
putted	怗〲
putting	怗す
puzzle	怗㑔
puzzles	怗怶
q@l	㐰
qrs@k	㐰。䔙
quack	怷
quackeroo	怸゙㊘
quacking	怸㍀
quackquack	怷怷
quail	怹
quails	恀
quality	恁ㅗで
quarrel	恂㑂
quarter	恃っ
quarters	恃ㅙ
quasimodo	恁㙑䕰ゅ
queeka	恄゙
queekie	恄㎇
queekiemoo	恄㎇唵
queekola	恄㥑ㅈ
queekster	恅㑠
queen	恆
quesadillas	㡠〘々恇
question	恈㥡
questionable	恈㢕㈠〓
questioning	恈㤶㍖
quick	恉
quickly	ご㍉
quiet	恐䍱
quieter	恐䕓っ
quietly	恐䍱〠
quietness	恐䍱ㄒ
quilt	恑
quilts	恒
quincy	恓〄
quit	恔
quite	恕
quitter	ごっ
quiver	ご㈖
quivering	ごㆅㄦ
quiz	恖
quizzed	恗
quote	恘
r	㊀
r@l	㊀
rabbit	㞐㕵
rabbit's	㞐㕸
rabbits	㞐㕸
raccoon	㞐䁩
raccoon's	㞐恙
raccoons	㞐恙
race	恠
raced	恡
races	㊃〧
raceway	㊃恢
racing	㊃㖙
radiator	㊃々、っ
radio	㊃々㥂
radio's	㊃々㤷
radios	㊃々㤷
radish	㞐䐁
rag	恣
raggedy	㞐㔙々
rags	恤
rahab	ゆ恥
rail	恦
railing	㊃㐉
railroad	㊃恧
rain	㌂
rainbow	㌂㘙
raincoat	㌂䁢
raindrops	㌂䒗
rained	恨
raineth	㊃恩
raining	㊃㍖
rains	恰
rainy	㊃㈔
raise	恱
raisin	㊃䆂
raisinbran	㊃䆂㚔
raising	㊃ㆃ
raisins	㊃䆃
rake	䔨
ram	恲
ramble	恲〓
rambling	恲㍥㐉
ramen	匰㡘
ramshacking	恲恳㍀
ran	嘄
ranch	恴
rang	㙉
range	㌀
rap	恵
rap's	恶
rapped	恷
rapping	㞐㞂
raps	恶
rarely	恸〠
rascal	恹㈒
rash	悀
rashes	㞐㌐
raspberry	悁㑆㈗
rat	悂
rather	㞐ㅵ
rats	悃
rattle	㞐㑶
rattles	㞐㔑
rattly	悂〠
raven	㊃䍡
ravens	㊃十
ray	㊃
raying	㊃㈙
raymond	㊃䍦
rays	恱
razor	㊃㚇
re@si	㊃
reach	悄
reached	悅
reaches	㈗㊁
reaching	㈗㖒
react	㈗じ
read	悆
reading	ㅩぷ
reads	悇
ready	ㅩ々
real	剧
realistic	㈗〔ㅗ㤖
realize	㈗〔吳
realized	㈗〔䀁
really	㈗〔〠
reapplied	㈗。㉡
rear	悈
rearrange	㈗〔㌀
rearranged	㈗䕘㌁
rearranges	㈗䕘㌂㤠
rearranging	㈗〔㌂㌃
reason	㈗䆂
reassured	㈗〔悉
reattach	㈗〔㌴
rebuild	㈗㝩
receipt	㆐㡣
receipts	㆐悐
receive	㆐悑
received	㆐悒
receiver	㆐〄㈖
receives	㆐悓
receiving	㆐〄ぉ
recently	㈗刧〠
recharges	㈗㤙㤠
recite	㆐䘢
recognize	ㅩ悔坠
recognizes	ㅩ悔䌹ゕ
recognizing	ㅩ悔䌹ㆃ
recommended	ㅩ゙ㆈふ
record	ㅩ圦
recorded	㆐〹ふ
recorder	㆐〹ㅅ
recorder's	ㅩ〹ㅆ
recordie	ㅩ〹々
recording	㆐〹ぷ
recordings	㆐〹㝱
records	ㅩ䉙
recovered	㆐ぃ䆄
rectangle	㈡悕㈇
recyclable	㆐䌘悖〓
recycling	㆐䌘゙㐉
red	悆
redhead	悆ㄗ
redid	㈗ふ
redo	㈗䁨
reference	ㅩ悗
refill	㈗䜙
reflection	㆐悘だ
refraction	㆐悙だ
refrigerant	㆐゘㕃㉐
refrigerator	㆐゘㕃㊃っ
refuge	ㅩ愀
refused	㆐䄑
regarding	㆐䡰ぷ
reggie	ㅩ〈
register	ㅩ䥆っ
registered	ㅩ㔳愁
registering	ㅩ㔳㑠㈙
registers	ㅩ㔳䁡
regressing	㆐ㄉ㖙
regular	ㅩ㊉㝘
regularly	愂㕩㝘〠
regulate	ㅩ㊉䄕
regurgitated	㆐㔖㔳䄤〲
reindeer	㌂䌔
rejected	㆐愃〲
rejoice	㆐愄
relate	㆐䄕
related	ゆ㐆〲
relationship	㆐㐆㌨愅
relax	ゆ愆
relaxed	ゆ愇
relaxing	ゆ厀㖙
relay	㈗㐆
released	ゆ吔
relieves	ゆ㔲
religious	ゆㅗ䥆
relocate	㈗㊔䂒
remco	愈㥑
remedy	ㅩ㊒々
remember	ゆ啸㐲
remembered	ゆ啸㕰
remembers	ゆ啸䉒
remifasolatido@si	ㅩㆇ䑅ㅲ䁳でゅ
remind	ゆ嘁
reminded	㆐嘂ふ
reminding	ゆ嘂ぷ
reminds	ゆ愉
remote	ゆ䕸
remove	ゆ噃
removed	ゆ噄
renewed	㆐愐
rent	堇
rented	䍶㜷
renting	䍶す
rents	愑
repaint	㈗垔
repairman	㆐垕㑲
repeat	㆐塦
repeated	㆐㉒〲
repeating	㆐㉒す
repetition	ㅩ㉕ち㌨
replace	㆐䘓
replant	㈗増
replied	㆐㉡
reply	㆐㉣
report	㆐嚒
reported	㆐奣〲
repot	㈗奓
representative	ㅩ㉦愒〱つ
reptar	愓倕
republic	㆐怖䡳
requires	㆐愔
rescue	䔙㐰
rescued	䔙愕
rescues	䔙愖
resealable	㈗〄ㅈ〓
resistant	㆐愗剂
respect	䜅䘰
respond	㆐愘
responding	㆐䅢ぷ
response	䜅愙
rest	愠
restaurant	ㅩむ愡
resting	ㅩ㠆
restrain	䜅奖
restrained	㈗愢
result	㆐愣
resulted	㆐愤㜷
resulting	㆐愤す
results	㆐愥
retarded	㆐倕ふ
retardo	㆐倕ゅ
retired	㆐愦
return	㆐厐
returned	㆐愧
returning	㆐っ㍖
returns	㆐堩
reunion	㈗㊈坒
reveal	㆐愨
reversal	㆐㈖㜨
reverse	㆐愩
reversible	㆐㈖〘〓
review	㆐堸
reward	㆐愰
rex	愱
rhinoceros	ㅱけ〘䊗
rhinoceroses	ㅱ噷㢄ゆㅂ
rhyme	愲
rhymes	愳
rhyming	ㅱ㔀
rhythm	㆐愴
ribbet	㆐㕵
ribbon	㆐愵
ribbons	㆐愶
ribs	愷
rice	愸
rich	愹
richard	㆐慀
rick	㤕
ricky	㆐㎇
rid	慁
ride	慂
riders	ㅱㅆ
rides	慃
ridiculous	㆐㊓㕧ㅐ
riding	ㅱぷ
right	ㅰ
rightie	ㅱで
ring	ㄦ
ringer	㆐偉
ringing	ㄦ㈙
rings	䔱
rinse	㉓
rinsed	慄
rinsing	䍴㖙
rip	慅
ripe	慆
ripped	慇
ripping	㆐㞂
rips	慈
risen	㆐䆂
river	㆐㈖
rivers	㆐㒕
road	㙤
roadblock	㙤㘅
roadrunner	㙥䔂㐠
roads	慉
roaming	㙥㔀
roar	慐
roast	慑
robbin's	慒慓
robert	匰㕆
roberts	匰㕇
robin	匰㔆
robitussin	㙥】慔㦓
rock	塡
rockandroll	匰㠹慕
rocker	匰ざ
rockers	匰㐀
rocketship	匰慖愅
rockie	慒㎇
rocking	匰㍀
rockingchair	慒㍀儕
rockinghorse	慒㍀关
rocks	慗
roll	慘
rolled	慙
roller	㙥㝘
rolling	㙥㐉
rolls	慠
rolypoly	㙥〠䆈〠
rommy	匰ㆇ
romper	慡㔈
ron	慢
roo	㊘
roof	慣
roofing	慤㢙
room	夅
room's	噢
rooms	噢
roomy	㊘ㆇ
roosteen	㊘慥
rooster	慦っ
roosters	㊘䁡
root	慧
rope	慨
rose	儆
roses	㙥ゕ
rosey	㙥㙑
rosie	㙥㙑
rosies	㙥䊄
ross	慩
rosy	㙥㙑
rote	慰
rotten	匰㒓
rough	慱
rougher	慲㦇
round	㊙
router	慳っ
routine	㊘䕐
routines	㊘慴
rove	慵
rover	㙥㈖
row	慳
roy	䅓
rub	慶
rubbed	慷
rubber	慲㐲
rubbery	慲㍥㈗
rubbing	慲㕥
rubs	慸
ruby	㊘〃
rude	慹
ruffle	慲㍙
ruffly	慲ㅦ〠
rug	憀
rugrat	慲憁
rugrats	慲憂
rugs	憃
ruin	㊘぀
rule	憄
rules	憅
rumbling	憆㍱
run	憇
runaway	慲㈠㉂
runner	慲㐠
running	慲㍖
runny	慲㈔
runs	憈
rush	憉
rushed	憐
rushing	慲㝕
russell	慲㜨
rustles	慲㜩
rustling	慲〘㐉
rutabaga	慤〱㍴㐔
ryan	ㅱ぀
rye	ㅱ
s	䘁
s@l	䘁
sad	憑
sadly	憑〠
safe	憒
safer	䄇㦇
safest	䄇䜵
safety	憒で
said	憓
sailboat	憔㘢
sailed	憕
sailing	䄇㐉
sailor	䄇㝘
sailors	䄇㕨
saint	憖
sakes	憗
salad	憘吰
salads	憘憙
sale	憔
sally	憘〠
salmon	憘㡘
salsa	唈〘
salt	戀
salvation	戁ぢだ
sam	戂
samantha	〘㑲啐
same	戃
samich	憘戄
sammy	憘ㆇ
sample	戂㉘
sampling	戂㙢㐉
samuel	憘㆔ぱ
sand	戅
sandal	戆㞇
sandals	戆㡁
sandwich	戆戇
sandy	戆々
sang	戈
sanitize	憘㈈嚀
santa	戆〱
santas	戆䊅
sara	憘ゆ
sarah	憘ゆ
sat	戉
satisfied	憘㠣䤗
satisfies	憘ち成
satisfy	憘㠣䜀
satisfying	憘㠣䜀㈙
saturday	憘っ㕴
sauce	㉗
saucer	䘧㈥
saucers	䘧㈧
sauces	䘧ㅂ
sausage	䘧喁
save	我
saved	戒
saves	戓
saving	䄇ぉ
savings	䄇唀
saw	䘧
say	䄇
saybut	䄇㠈
saychugga@o	䄇㦈㐔
saying	䄇㈙
says	戔
scale	戕
scamper	或㔈
scare	戗
scarecrow	戗䈤
scared	战
scarf	戙
scaring	戠ㄦ
scarry	怕㈗
scary	戠㈗
scary's	怕㑴
scattering	戡〱ㄦ
scene	㦔
scenes	戢
scent	㢐
schedule	怕戣
scheduled	怕戤
schedules	怕㈅
scheduling	怕䕂㐉
schnucks	戥
school	奷
schoolhouse	奷䐨
science	䌘䘴
scissorhand	〴㚇偁
scissors	〴戦
scooby	戧〃
scoop	戨
scooping	戧㞂
scoot	戩
scooter	戧っ
scooting	戧す
scored	戰
scorpion	戱㉒぀
scott	戲
scottish	戳戴
scramble	戵〓
scrambled	戵北
scrape	戶
scraped	户
scraping	戸㞂
scratch	戹
scratch	戹
scratched	所
scratches	扁㦑
scratching	扁㖒
scratching	扁㖒
scratchy	扁え
scream	扂
screaming	扃㔀
screams	扄
screech	扅
screecher	扃扆
screen	扇
screw	扈
screwdriver	扈䒒㈖
screwed	扉
screwy	扈〆
scribble	扐〓
scribbles	扐㝙
scrub	扑
scrubbed	扒
scrubbie	打〃
scrubby	打〃
scrumbilicious@n	扔】ㅗ㝗
scrumblicious@n	扔㝠㝗
scrumptious	扔払
scuba	戧㍥
scurry	坣㈗
sea	〄
seafood	〄䞐
seagulls	〄扖
seal	扗
seal's	托
sealie	〄〠
sean	扙
search	扠
searched	扡
seashells	〄扢
seashore	〄扣
season	〄䆂
seasoning	〄䁖㍖
seasons	〄䆃
seat	㡣
seats	悐
sebastian	〘㑖㥡
sec	扤
second	㢄扥
seconds	㢄扦
secret	〄执
secrets	〄扨
sectioned	扤啹
sections	扤䄘
secure	〘扩
see	〄
seeandsay	〄㆘䄇
seed	扰
seeds	扱
seeing	〄㈙
seek	儔
seem	扲
seemed	扳
seemingly	〄㔀〠
seems	扴
seen	㦔
sees	〉
seesaw	〄䘧
segment	扵䖙
seize	〉
selection	〴䁹㌨
self	儇
sell	㢇
selling	㢄㐉
sells	㢈
seltzer	扶㈥
semicircle	㢄ㆇ㈥㈒
send	扷
sending	㢑ぷ
sends	扸
sense	批
sensitive	㢑〴つ
sent	㢐
sentence	㢑技
sentences	㢑㒓〧
separate	㢄㙢㌢
separation	㢄㙢㊃㌨
september	〰抁㐲
sequential	〴抂㈳
series	〄㑴
serious	〴㈗㌘
seriously	〴㈗䕓䁁
serpent	㈥抃
serve	抄
served	抅
serves	抆
service	㈥䌇
serving	㈥ぉ
sesame	㢄〘ㆇ
session	㢄だ
set	抇
setting	㢄す
settle	㢄㑶
settled	㢄抈
seuss	抉
seuss's	抐〧
seven	㢄䕥
seventeen	㢄䕥䕐
seventeenth	㢄䕥䜉
seventh	㢄䕦
seventy	㢄䕥で
several	㢄ㆅ㑂
sew	ㅲ
sewed	抑
sewer	ㅲ㡹
sewing	ㅲ㈙
sewingmachine	ㅲ㈙㊒唑
sewn	抒
sews	抓
sex	抔
sexual	扤匒ぱ
sexy	扤〄
sgabettios	投㑆で㤷
shabby	恳〃
shade	抖
shades	抗
shadow	恳ゅ
shadows	恳㍔
shady	折々
shaggy	恳ㄇ
shake	抙
shaked	挀
shakes	持
shaking	折㍀
shaky	折㎇
shall	挂
shallots	恳挃
shallow	恳㊔
shame	挄
shampoo	挅堄
shape	挆
shaped	指
shapes	挈
share	按
shared	挐
sharing	折ㄦ
shark	挑
sharks	挒
sharon	恳䍴
sharp	挓
shave	挔
shaving	折ぉ
she	㉧
she'd	挕
she'll	挖
she's	䜴
sheared	挗
shedding	挘ぷ
sheedy	㉧々
sheep	挙
sheet	挠
sheets	挡
sheila	㉧ㅈ
shelby	挢〃
shelf	挣
shell	挢
shells	扢
shena	㉧㈠
shepherd	挘吤
sheriff	挘挤
sherri	挘㈗
sherry	挘㈗
shes	䜴
shh	挥
shield	挦
shielded	挖ふ
shift	挧
shifts	挨
shimmering	䄈㊒ㄦ
shimmy	䄈ㆇ
shin	だ
shine	挩
shining	挰㍖
shiny	挰㈔
ship	愅
ships	挱
shirt	嚙
shirt's	挲
shirts	挲
shiver	䄈㈖
shock	挳
shocked	挴
shod	挵
shoe	匒
shoe's	挶
shoelace	匒卸
shoelaces	匒㐆〧
shoeless	匒ㅐ
shoes	挶
shoesies	匒䊄
shoestring	匒㉶
shoestrings	匒挷
shook	挸
shoot	㦒
shooting	匒す
shop	挹
shopper	捀㔈
shopping	捀㞂
short	捁
shorter	捂っ
shortly	捁〠
shorts	捃
shot	捄
shots	捅
should	捆
should've	捇捈
shoulda	捇㜑
shoulder	捉ㅅ
shoulders	捉ㅆ
shouldn't	捇䅱
shout	捐
shouted	捑〲
shouting	捑す
shove	捒
shoved	捓
shovel	捔䍠
shoveled	捕䍠
shoveling	捔ㆅ㐉
shovels	捔捖
show	怴
showed	捗
shower	捑㡹
showing	怴㈙
shows	捘
shred	悆
shrimp	捙
shriveled	㆐捠
shut	捡
shutter	捔っ
shutters	捔ㅙ
shutting	捔す
shy	挰
sibling	换㐉
sick	㈢
sickie	〴㎇
sid	㖘
side	㕉
sides	㕐
sidewalk	㕉捣
sidewalks	䌘捤
sideways	㕉㉃
sidney	㖘㈔
sidney's	㖘㈕
sieve	ㄐ
sigh	䌘
sighed	㕉
sight	䘢
sign	捥
signal	捦㡒
signed	捧
signs	捨
silence	䌘捩
silent	䌘䘠
silky	捰㎇
sill	捰
sillier	〴〠㡹
silly	〴〠
sillywilly	〴〠䐓〠
silver	捰㈖
silverware	捰㈖㉄
simba	䉱㍥
simmer	〴㝸
simmered	〴捱
simmering	〴㝸㈙
simmers	〴䙹
simple	䉱㉘
simply	䉱䂖
since	圔
sing	㖙
singing	㖙㈙
sings	㘀
sink	捲
sip	捳
sipped	捴
sipper	〴㔈
sippie	〴㉒
sips	捵
sir	㈥
siree	㈥〆
siren	䌘䍴
sirree	㈥㈗
sissy	〴〄
sister	㌦っ
sister's	〴䁡
sisters	〴䁡
sit	㎁
sits	捶
sitting	〴す
situation	〴ぐ、だ
six	㑓
sixpence	㈢捷
sixteen	㑓䕐
sixteenth	㑓䜉
sixty	㈢㑡
size	䘦
sized	捸
skanky	捹㎇
skateboard	掀㘠
skateboards	掀掁
skates	掂
skating	戠す
skelter	掃っ
skies	掄
skill	掅
skills	掆
skin	掇
skinnier	授㈔㡹
skinny	授㈔
skip	掉
skipped	掐
skips	掑
skirt	排
skirts	掓
skull	掔
skunk	掕
sky	掖
slam	掗
slammed	掘
slamming	掙㔀
slams	搀
slapped	搁
slash	搂
slave	搃
sleek	搄
sleep	㌗
sleeper	䁁㔈
sleepie	䁁㉒
sleepies	䁁儈
sleeping	䁁㞂
sleeps	搅
sleepy	䁁㉒
sleepyhead	䁁㉒ㄗ
sleet	搆
sleeting	䁁す
sleets	搇
sleeve	搈
sleeves	搉
slept	搐
slew	搑
slice	搒
slick	搓
slid	搔
slide	搕
slides	搖
sliding	搗ぷ
slight	搘
slightest	搗䉨
slime	搙
slimy	搗ㆇ
slink	搠
slinky	搡㎇
slip	搢
slipped	搣
slipper	搤㔈
slipper's	搤䀲
slippers	搤䀲
slippery	搤㙢㈗
slippies	搤儈
slipping	搤㞂
slippy	搤㉒
slips	搥
slob	搦
slobber	搧㐲
slobbered	搧㕰
slobbering	搧㍥ㄦ
slobbers	搧䉒
slobingslobingdobbin	搧㕥搧㕥㐙愵
slopping	搧㞂
sloppy	搧㉒
slosh	搨
slot	搩
slouch	搰
slouching	搱㖒
slow	搲
slower	搲㡹
slowing	搲搳
slowly	搲〠
slows	搴
slug	搵
slumber	搶㐲
slumbers	搶䉒
slurping	搷㞂
smack	搸
smackerel	搹ざぱ
smackerel@c	搹ざぱ
smacking	搹㍀
smakerel@c	搹ざぱ
small	摀
smaller	摁㝘
smallness	摀ㄒ
smart	摂
smarter	摃っ
smartest	摃䉨
smartie	摃で
smarty	摃で
smartypants	摃で堃
smashing	搹㝕
smell	摄
smelled	摅
smelling	摆㐉
smells	摇
smelly	摆〠
smile	摈
smiled	摉
smiles	摐
smiley	摑〠
smiling	摑㐉
smith	摒
smoke	摓
smoky	摔㎇
smooth	摕
smoother	摖ㅵ
smorgasbord	摗㌠㘠
smuch	摘
smush	摙
smushed	摠
smushing	摡㝕
snack	摢
snack's	摣
snackie	摤㎇
snacking	摤㍀
snacks	摣
snail	摥
snails	摦
snake	摧
snakes	摨
snakie	摩㎇
snap	摰
snapped	摱
snappie	摤㉒
snapping	摤㞂
snaps	摲
snatch	摳
snatched	摴
sneak	摵
sneakers	摶㐀
sneaking	摶㍀
sneaky	摶㎇
sneeze	摷
sneezed	摸
sneezes	摶ゕ
sneezing	摶ㆃ
sniff	摹
snip	撀
snipped	撁
snipper	堐㔈
snippers	堐䀲
snippy	堐㉒
snoops	撂
snooze	撃
snoring	撄ㄦ
snort	撅
snorting	撆す
snot	撇
snotty	撈で
snow	撄
snow's	撉
snowballs	撄㐅
snowblower	撄㘓㡹
snowed	撐
snowflakes	撄䝈
snowing	撄㈙
snowman	撄㑲
snowman's	撄吣
snowmen	撄ㆈ
snows	撉
snowsuit	撄㑦
snowy	撄〆
snuck	撑
snuff	撒
snuffy	撓㕲
snug	撔
snuggle	撓㈇
snuggled	撓撕
snuggly	撓撖
so	ㅲ
so@si	ㅲ
soak	撗
soaked	撘
soaking	ㅲ㍀
soaky	ㅲ㎇
soap	撙
soappies	ㅲ儈
soapy	ㅲ㉒
soccer	攀ざ
sock	攁
sockie	攀㎇
sockies	攀㕦
socks	攂
socksies	攁〉
soda	ㅲ㜑
sodas	ㅲ㜒
sodium	ㅲ々㉸
sofa	ㅲㅦ
soft	攃
softball	攃㐄
softest	攄䉨
softly	攃〠
software	攄攅
soggy	䘧ㄇ
soiled	攆
sold	攇
soldier	攈券
soldiers	攈攉
solid	攀吰
solidified	〘ㅗ㊓䤗
solomon	攀ㅈ㡘
some	攐
somebody	攐㈶々
somebody's	攐㈶㈂
someday	攐㕴
somehow	攐㈷
someone	光攑
someone's	攐䘒
someplace	攐䘓
somersault	光㝸戀
somersaults	光㝸攒
something	攐㉀
something's	攐䘔
sometime	攐㉁
sometimes	攐攓
somewhat	光攔
somewhere	光攕
son	攖
song	攗
songlike	攘ㅒ
songs	攙
sonic	攀䀧
sonny	光㈔
sonogram	攀㈠䥙
sons	攠
soon	攡
sooner	抐㐠
sophie	ㅲ㕲
sophisticated	〘㢗攢㠡〲
sopped	攣
sorcerer	䎄〘䀖
sore	攤
sorry	攀㈗
sort	㌩
sorted	䎄〲
sorter	䎄っ
sorts	攥
sound	攦
sounded	攧ふ
sounding	攧ぷ
sounds	攨
soup	攩
soups	攰
soupy	抐㉒
sour	攱㡹
source	攲
south	攳
space	攴
spaceship	攴愅
spaghetti	㌡ㅴで
spaghettio	㌡ㅴで㥂
spaghettios	㌡ㅴで㤷
span	攵
spanish	䝀䅙
spank	收
spanked	攷攸
spare	改
sparkle	敀㈒
sparkly	敀㍉
sparky	敀㎇
sparrow	䝀㙥
speak	敁
speaker	䈢ざ
speaking	䈢㍀
speaks	敂
special	䘄㈳
specific	㌣〴䝃
specks	敃
specter	䘱っ
spectrum	䘱敄
speed	故
speeds	敆
speedy	䈢々
spell	敇
spelling	䘄㐉
spend	效
spended	敉㝰
spends	敐
spent	救
sphere	䚐
spice	敒
spices	敓〧
spider	敓ㅅ
spike	敔
spill	敕
spilled	敖
spilling	㌣㐉
spills	敗
spin	敘
spinach	㌣教
spines	敠
spinning	㌣㍖
spins	敡
spirit	㌣㡡
spit	敢
spits	散
spitting	㌣す
splash	敤
splashasplashasplasha	敥㙕敥㙕敥㙕
splashed	敦
splashie	敥㉧
splashing	敥㝕
splat	敧
splendid	敨ふ
splendor	敨ㅅ
splishiesplashie	敩㉧敥㉧
splishsplash	数敤
splishysplashy	敩㉧敥㉧
split	敱
splitsplacksplash	敱敲敤
spoil	敳
spoiled	整
spoke	敵
sponge	敶
sponges	敷㜘
spontaneously	䅢䄤㈔㌘
spool	數
spools	敹
spoon	斀
spoonful	斀㍙
spoonfuls	斀㍠
spoons	斁
sport	斂
sports	斃
spot	䡡
spot's	斄
spots	斄
spotty	斅で
spout	斆
sprat	文
spray	斈
spraying	斈㈙
spread	㔄
spreads	斉
spring	斐
springs	斑
springtime	斐㉁
sprinkler	斐斒
sprint	斓
spruce	斔
spud	斕
spunky	斖㎇
spy	敓
spying	敓㈙
square	斗
squares	斘
squarular	料㕩㝘
squash	昀
squashed	昁
squashie	昂㉧
squashies	昂䜴
squawky	昂㎇
squeak	墑
squeaked	昃
squeaker	昄ざ
squeaking	昄㍀
squeaks	昅
squeaky	昄㎇
squeal	昆
squealed	昇
squeeze	昈
squeezed	昉
squeezes	昄㉠
squeezing	昄ㆃ
squid	昐
squinting	昑す
squirm	昒
squirming	易㔀
squirmy	易ㆇ
squirrel	昔昕
squirrellie	易〔〠
squirrellies	易〔㌒
squirrels	易㑃
squirt	昖
squirted	易〲
squirting	易す
squish	昗
squished	昘
squishing	昙㝕
squishy	昙㉧
ssh	挥
stable	映〓
stack	偲
stacked	昡
stacking	昢㍀
stacks	偳
stage	昣
stages	映㜘
stain	昤
stair	春
stairs	䑔
stale	昦
stale	昦
stalking	奵㍀
stall	昧
stamp	昨
stance	昩
stand	昰
standing	㦗ぷ
standpoint	㦗昱
stands	昲
staples	映㉙
star	昳
starch	昴
stare	春
starfish	昳䜳
staring	映ㄦ
stars	昵
start	昶
started	昳〲
starting	昳す
startle	昳㑶
startled	昳抈
starts	昷
starve	昸
starved	昹
starves	晀
starving	昳ぉ
stash	噥
static	昢㈱
staticing@n	昢ち㍀
staticky	昢ち㎇
staticling@n	昢㈱㝢
station	映だ
statue	昢ぐ
stay	映
stayed	晁
staying	映㈙
stays	時
steadfast	剆䚂
steadier	晃々㡹
steady	晃々
steak	晄
steak's	晅
steal	晆
stealing	㑡㐉
steals	晇
steam	晈
steamed	晉
steep	晐
steer	晑
steering	㑡ㄦ
stegosaurus	晃㐔䘧䊗
stem	晒
step	晓
stephanie	晃ㅦ㈔
stepped	晔
stepping	晃㞂
steps	晕
stereo	晃㈗㥂
stereos	晃㈗㤷
steve	晖
steven	㑡䍡
stew	晗
stick	㤖
sticker	攢ざ
stickers	攢㐀
stickie	攢㎇
stickies	攢㕦
sticking	攢㍀
stickle	攢㈒
stickleback	攢晘㎂
sticks	晙
sticky	攢㎇
stikle	攢㈒
stile	晠
still	晡
stimulated	攢䠅㐆〲
sting	㠆
stingy	㙦〈
stink	䐑
stinkaroosies	㠆゙㊘䊄
stinker	㠆ざ
stinkier	㠆㎇㡹
stinkies	㠆㕦
stinkiest	㠆㎇晢
stinking	㠆㍀
stinkpot	䐑奓
stinks	晣
stinky	㠆㎇
stir	㑠
stirring	㑠ㄦ
stitches	攢㊁
stock	㒃
stocking	晤㍀
stole	晥
stomach	晦偀
stomachache	晦㊒㍷
stomp	晧
stomped	晨
stomping	晩㞂
stoneham	晰夂
stones	晱
stood	晲
stool	晳
stop	䑄
stopped	晴
stopper	晤㔈
stopping	晤㞂
stops	晵
store	晶
stores	晷
stories	晰㑴
storm	晸
stormy	晹ㆇ
story	晰㈗
storybook	晰㈗㙅
stout	暀
stove	暁
straight	䌶
straighten	䡐㒓
straightened	䡐㠓
straightens	䡐㠕
straining	䡐㍖
strange	暂
stranger	暃券
strap	暄
strapped	暅
straps	暆
straw	暇
strawberries	暇㑆㑴
strawberry	暇㑆㈗
streaks	暈
stream	䑕
street	嘈
streetlight	嘈䝔
streetlights	嘈䕗
streets	暉
strength	暐
strengthening	暑啐㍖
stress	暒
stressed	暓
stretch	暔
stretches	暕㊁
stretching	暕㖒
strike	暖
string	㉶
stringing	㉶㈙
strings	挷
strip	暗
stripe	暘
striped	暙
stroke	最
stroll	朁
stroller	䡶㝘
strong	朂
stronger	朂㡹
struck	䍔
structure	䍔を
struggle	會㈇
struggled	會撕
strum	朄
stubborn	晦㞔
stuck	朅
studies	晦㈂
studio	晗々㥂
study	晦々
studying	晦々㈙
stuff	朆
stuffed	朇
stuffy	晦㕲
stung	月
stupid	晗奀
sturdy	㑠々
stutter	晦っ
style	晠
styling	有㐉
stylish	有头
styrofoam	有ゆ䞃
sub	朐
subject	朐朑
substitute	朐攢朒
substituted	朐攢剓〲
succeed	朓扰
successful	朓㢄朔
successfully	朓䘡ㅦ〠
such	朕
suchi	抐え
suck	朖
sucked	朗
sucker	光ざ
sucking	光㍀
sucks	朘
suction	朖だ
sudden	光䕀
suddenly	光䕀〠
suds	朙
sudsies	朠〉
sudsy	朠〄
sue	抐
sued	朡
sues	朢
sugar	捇㔖
sugarpie	捇㔖䉰
suggest	〘朣
suggestion	〘䄓㥡
suing	抐㈙
suit	㑦
suitcase	㑦㙆
suits	㑧
sultan	朤㍅
sultan's	朤㠕
sultans	朤㠕
sultans's	朤㒓㉠
summer	光㝸
summer's	光䙹
summers	光䙹
summertime	光㝸㉁
summoned	光䍦
sumpin	攐墀
sun	攖
sun's	攠
sunblock	攖朥
sunburn	攖㞔
sunday	攖㕴
sunflower	攖㡸㡹
sunflowers	攖㡸䝵
sunglasses	攖䙑〧
sunny	光㈔
sunscreen	攖扇
sunscreens	攖朦
sunshine	攖挩
suntan	攖坘
super	抐㔈
superman	抐㔈㑲
supper	光㔈
supper's	光䀲
supplement	朧ㅈㆁ
supplies	〘㉢
supply	〘㉣
suppose	〘䐉
supposed	〘坓
sure	木
surely	木〠
surface	㈥圵
surprise	㈥妕
surprised	㈥朩
surprising	㈥妐ㆃ
surrounded	〘朰ふ
survey	㈥ぢ
survive	㈥朱
survivor	㈥ゔ㈖
susan	抐䆂
susie	抐㙑
suspender	朲䍁ㅅ
suspenders	〘敉ㅆ
suspicious	朲㉕ㆄ
susy	抐㙑
suzie	抐㙑
suzy	抐㙑
swallow	朳㊔
swallowed	朳㔴
swallowing	朳㊔搳
swallows	朳䞉
swam	朴
swan	朵
swans	朶
swear	朷
swearie	朸㈗
sweat	朹
sweater	朸っ
sweaters	朸ㅙ
sweatpants	朹堃
sweatshirt	朸杀
sweatshirts	朸杁
sweatsuit	朹㑦
sweaty	朸で
sweep	杂
sweeped	权
sweepie	杄㉒
sweeping	杄㞂
sweeps	杅
sweet	杆
sweeta	杄〱
sweeterpeters	杄っ㉒ㅙ
sweeters	杄ㅙ
sweeterspeters	杄ㅙ㉒ㅙ
sweetest	杄䉨
sweetheart	杆傉
sweetie	杄で
sweetiepie	杄で䉰
sweetiepies	杄で䍑
sweeties	杄て
sweetiest	杄でさ
sweetpea	杆㉒
sweets	杇
sweetsies	杆〉
sweetum	杄杈
sweetums	杄杉
swell	材
swell	材
swelling	朸㐉
swelling	朸㐉
swept	村
swim	杒
swimmer	杓㝸
swimming	杓㔀
swimmingpool	杓㔀夸
swims	杔
swimsuit	杒㑦
swing	杕
swingie	杕ㄇ
swinging	杕㈙
swings	杖
swish	杗
switch	杘
switched	杙
swollen	杠ㅖ
swoosh	条
sydney's	㖘㈕
sylvester	捰杢㑠
symbiotic	䉱〃。㈱
symphony	䉱ㅦ㈔
syndrome	㦓杣
synthesized	㦓啐捸
syrup	〴杤
system	㌦㐨
t	で
t@l	で
ta	倶
tab	来
tabitha	㌹】啐
tabitha's	㌹】㕈
table	䄤〓
tablecloth	䄤〓䁃
tablespoon	䄤〓斀
tabs	杦
tad	杧
tadah	〱䉴
tag	杨
tags	杩
tail	䅦
tail's	䄤䁳
tails	杰
take	嘇
taken	䄤㄀
takes	東
taking	䄤㍀
talk	坴
talkative	杲゙つ
talked	杳
talker	杲ざ
talking	杲㍀
talks	杴
tall	杵
taller	杲㝘
tallest	杲员
tambourine	杶㍥杷
tan	坘
tangerine	坘券䕆
tangerines	坘㕃杸
tangled	悕撕
tangling	悕杹
tanish	㌹䅙
tank	枀
tantrum	坘敄
tantrums	坘极
tap	枂
tape	枃
taped	构
tapemeasure	枃ㆉ枅
taperecorded	䄤䙄枆䌒
taperecording	䄤䙄枆ぷ
tapes	枇
taping	䄤㞂
tapioca	㌹㉒㥂゙
tapped	枈
tapping	㌹㞂
taps	枉
tar	倕
target	倕䤐
tart	析
tarts	枑
tarzan	倕ㅄ
tasmanian	枒ㆂ㈔぀
taste	枓
tasted	䄤㠅
tastes	枔
tasting	䄤㠆
tasty	枕で
tata	㌹㌹
tata's	㌹枒
tata@q	杲杲
taters	䄤ㅙ
tattoos	㌹枖
taught	林
taxi	㌷〄
taxis	㌷〉
taz	枒
tea	で
teach	枘
teacher	でを
teacher's	で䈒
teaching	で㖒
team	枙
teapot	で奓
tear	栀
tearing	㈩ㄦ
tears	栁
teas	て
teasing	でㆃ
teaspoon	栂栃
teaspoonfuls	で斀㍠
technical	怅㈈㈒
technically	怅㈈゙〠
teddies	㈩㈂
teddy	㈩々
tee	で
teefers	で圴
teenager	䕐、券
teenie	で㈔
teensie	䕐〄
teeny	で㈔
teenyweeny	で㈔単㈔
teepy	で㉒
teeth	栄
teether	で㌆
teethers	で栅
teethie	で㑤
teethies	で栆
teething	で㑥
telemarketing	㈩ㅈ啀㖆す
telephone	㈩ㅈ喈
telephone's	㈩ㅈ䔰
telephones	㈩ㅈ䔰
teletubbies	㈩ㅈ慔㍵
teletubby	㈩ㅈ慔〃
television	㈩ㅈづ䙀
televisions	㈩ㅈ标呓
tell	栈
telling	㈩㐉
tells	栉
telly	㈩〠
temper	抁㔈
temperature	抁㙢ゆを
tempt	栐
ten	㍁
tend	妃
tender	㍁ㅅ
tenderness	㍁ㅅㄒ
tending	㍁ぷ
tennis	㈩ㄒ
tense	剉
tent	䄧
tenth	树
tents	䄨
term	栒
terms	栓
terri	㈩㈗
terri's	㈩㑴
terrible	㈩ゆ〓
terribly	㈩ゆ㖑
terrific	〱㆐䝃
terrorizing	㈩ゆㅱㆃ
terry	㈩㈗
terry's	㈩㑴
test	怆
tested	㈩㠅
testing	㈩㠆
than	栔
thank	栕
thanked	栖
thanking	栗㍀
thanks	栘
thankyou	栗㐰
that	栙
that'd	栠〲
that'll	栠㑶
that's	儳
thaw	校
the	栢
thee	栣
theif	栤
their	栥
theirs	栦
them	栧
them's	栨
themselves	栧栩
then	栰
theodore	㑤〔㎃
there	栥
there'll	栥ぱ
there's	栦
therefore	栥㔓
theresa	〱㈗〘
thermometer	㌆㈑㊒っ
these	栱
they	栲
they'd	栳
they'll	栴
they're	栥
they've	栵
thick	栶
thicker	样ざ
thigh	核
thighs	根
thin	桀
thing	㉀
thing's	䘔
thingamajigger	㉀〔㊒㔳㔖
thingie	㉀〆
thingies	㉀㑵
things	䘔
think	桁
thinking	㉀㍀
thinks	桂
third	桃
thirst	桄
thirsty	桅で
thirteen	㌆䕐
thirty	㌆で
this	框
thistle	样㜨
thorn	桇
thornbushes	桇㙃ㅑ
thorns	案
thorny	桉㈔
those	桐
though	ㅳ
thought	桑
thoughtful	桑㍙
thousand	桒桓
thrash	桔
thrasher	桕䐃
thread	桖
three	桗
threes	桘
threw	桙
throat	桠
throats	桡
through	桙
throughout	桙坲
throw	劙
throwing	劙㈙
thrown	桢
throws	档
thumb	桤
thumbprints	桤䜧
thumbs	桥
thumbtacks	桤桦
thumper	桤㔈
thunder	桧ㅅ
thundered	桧㎈
thursday	栅㕴
thy	桨
ti@si	で
tic	㈱
tick	㈱
ticket	ち㑗
tickets	ち㖇
tickie	ち㎇
tickle	ち㈒
tickled	ち㝡
tickler	ち斒
tickles	ち㈓
tickletickle	ち㈒ち㈒
ticklie	ち㍉
tickling	ぢ㐉
ticklish	ち㈒䥴
tickly	ち㈒䕓
ticks	㈲
tictactoe	㈱㌷㥀
tiddywinkle	ち々搳㈒
tide	桩
tie	䖔
tied	桩
ties	嚀
tiger	䖔㔖
tigers	䖔㙄
tigger	ち㔖
tiggers	ち㙄
tiggywinkle	ちㄇ搳㈒
tight	㉖
tighter	䖔っ
tightly	㉖〠
tights	桰
tile	桱
tilt	桲
tilted	桳〲
tim	桴
timber	桴㐲
timberland	桴㐲厅
timbers	桴䉒
time	㉁
timer	䖔㝸
times	攓
timing	䖔㔀
timmer	ち㝸
timmonium	ち䕰㈔㊕
timmy	ちㆇ
timmy's	ち㝹
timone	ち桵
timothy	ち㊒㑤
tims	桶
tin	㍅
tiniest	䖔㈔䔵
tinkerbell	すざ㔨
tinkle	す㈒
tinky	す㎇
tinkywink	す㎇桷
tinkywinky	す㎇搳㎇
tiny	䖔㈔
tip	䉔
tipietoe	ち㉒㥀
tipietoes	ち㉒嘳
tipped	桸
tippietoe	ち㉒㥀
tippietoes	ち㉒嘳
tipping	ち㞂
tippy	で㉒
tippy's	で儈
tips	桹
tiptoe	䉔㥀
tiptoed	䉔梀
tiptoes	䉔嘳
tire	䖕
tired	愦
tires	梁
tiring	䖔ㄦ
tissue	ち匒
tissues	ち挶
to	剓
toandfro	剓㆘䡇
toast	梂
toasted	㥀㠅
toaster	梃っ
toastest	㥀㕒
toasty	㥀㑡
tock	梄
today	〱㕴
today's	〱䌐
toddler	梅㝘
toe	㥀
toe's	嘳
toenail	㥀䜥
toenails	㥀䜦
toes	嘳
toesie	㥀㙑
toesies	㥀䊄
tofu	㥀䕇
together	〱ㅴㅵ
toilet	梆㚐
tokyo	㥀㎇㥂
told	梇
tom	梈
tom's	梉
tomato	〱ㆂ㥀
tomatos	〱ㆂ嘳
tomboy	梈㘩
tomcat	梈㡩
tommy	倶ㆇ
tomorrow	〱㈑㙥
tomorrow's	〱㈑儆
ton	梐
tonga	梑㐔
tongue	梒
tongue's	梓
tonight	〱䥁
tonka	梑゙
tonka's	梑梔
tons	梕
tonya	䡢㕩
too	剓
took	梖
tool	梗
toolbox	梗㚅
tools	梘
toolshed	梗梙
toot	朒
tootaloo	剓〱㐓
tooth	椀
toothbrush	椀㝓
toothbrushes	椀㝄㌐
toothie	剓㑤
toothies	剓栆
toothless	椀ㅐ
tooting	剓す
tootleloo	剓〱㐓
toots	椁
tootsie	椂〄
tootsies	椂〉
top	䅳
topic	倶塩
toppings	倶䦘
tops	椃
tore	椄
torn	椅
tortoise	椆㠣
torturing	椆㢕ㄦ
toss	椇
tossed	椈
tosses	杲〧
totally	㥀〱〠
totem	㥀㐨
toucan	剓㠹
touch	椉
touchdowns	椉偈
touched	椐
touches	慔㊁
touchie	慔え
touching	慔㖒
touchy	慔え
tough	椑
toughie	慔㕲
tow	㥀
toward	椒
towards	椓
towel	椔
towels	椕
tower	椖㡹
towers	椖䝵
town	䑖
toy	梆
toy'll	梆ぱ
toybox	梆㚅
toys	椗
track	㍃
tracks	椘
tractor	㍃っ
trade	椙
traditional	㡴㊓䄈㡒
traffic	椠䝃
trailed	椡
trails	椢
train	奖
trained	椣
training	䄁㍖
trains	椤
translate	椥䄕
trapeze	㡴儈
trapped	椦
trash	椧
trashed	椨
trashes	椩ㅑ
trashing	椠㝕
traumatizing	椰㊒䖔ㆃ
traveler	椠ㆅ㝘
traveling	椠ㆅ㐉
travels	椠捖
tray	䄁
treat	椱
treatment	椱ㆁ
treats	椲
tree	䅶
trees	䅵
treetop	䅶䅳
triangle	椳㈆㈇
triangles	椳㈆䤀
triangular	椳㈆㊉㝘
trick	䄂
tricked	椴
tricks	㒔
tricky	䕔㎇
tricycle	椳〴㈒
tried	椵
tries	椶
trike	椷
trim	椸
trip	椹
triple	䕔㉘
tripled	䕔楀
tripod	椳夥
tripped	楁
tripping	䕔㞂
trombone	楂㘲
troop	楃
trouble	椩〓
trough	楄
trousers	楅戦
trout	楆
truck	䍕
truckie	椩㎇
trucks	楇
true	楈
truly	楈〠
trunk	楉
trunks	楐
trust	楑
truth	楒
truthfully	楒ㅦ〠
try	椳
trying	椳㈙
trys	椶
tub	㑱
tubbie	慔〃
tube	楓
tubes	楔
tubing	剓㕥
tuck	楕
tucked	楖
tucker	慔ざ
tuesday	枖㕴
tuffet	慔噑
tug	楗
tugged	楘
tugging	慔㔗
tulip	剓呔
tulips	剓呕
tumble	杈〓
tumbled	杈北
tumbles	杈㝙
tumbling	杈㍥㐉
tummies	慔㝹
tummy	慔ㆇ
tumtum	杈杈
tuna	剓㈠
tune	㡥
tunes	㡦
tunnel	慔㡒
tupperware	慔㔈㉄
turkey	っ㎇
turkey's	っ㕦
turkeys	っ㕦
turkies	っ㕦
turn	厐
turnaround	っ㈠㊙
turned	愧
turning	っ㍖
turns	堩
turtle	っ㑶
turtle's	っ㔑
turtleneck	っ㑶䄗
turtles	っ㔑
tush	楙
tutti	剓で
tuttletuttle	慔㑶慔㑶
tutu	剓剓
tuv@k	で㊈䄷
tv	で䄷
tweaks	楠
tweedle	楡㞇
tweedlebug	楡㞇㝦
tweedledee	楡㞇々
tweedledum	楡㞇䔔
tweet	楢
tweetie	楡で
tweetie's	楡て
tweety	楡で
twelfth	楣
twelve	楤
twenty	楥で
twice	楦
twiddle	楧㞇
twiddlebug	楧㞇㝦
twinkle	楨㈒
twirl	楩
twirly	楰〠
twist	㎐
twister	楱っ
twisting	楧㠆
twisty	楱で
two	剓
twos	枖
twy	楲
twying	楲㈙
ty	䖔
tyco	䖔㥑
tying	䖔㈙
tylenol	䖔ㅈ楳
type	楴
typing	䖔㞂
tyrese	䖔極
u	㊈
u@l	㊈
ubb's	楶
ugh	楷
uglier	䕘撖㡹
ugliest	䕘撖さ
ugly	楷〠
uh	䕘
uhhuh	䕘先
uhhum	䕘冖
uhoh	䕘㥂
uhuh	䕘先
ukelele	㊈゙㐆〠
ulterior	ぱち㈗㡹
um	㊕
umbrella	㉸吨ㅈ
unbearable	均㑆ゆ〓
unbreakable	均㚒゙〓
unbuckle	呒㈶㈒
unbuckled	呒㈶㝡
unbutton	呒㈶㒓
uncheerful	均楸㍙
uncle	楹㈒
uncles	楹㈓
uncomfortable	呒㒘㦇〱〓
unconsciously	均䂙㙕䁁
uncover	呒ぃ㈖
uncovering	呒ぃㆅㄦ
uncurl	呒䉡
under	均ㅅ
underarm	均ㅅ㊑
underarms	均ㅅ㊗
underneath	均ㅅ㕂
underpants	均ㅅ堃
undershirt	均䉷榀
understand	均ㅅ昰
understandable	均ㅅ㦗㜑〓
understanding	均ㅅ㦗ぷ
understands	均ㅅ昲
understood	均ㅅ晲
underwear	均ㅅ㉄
underwears	均ㅅ榁
undies	均㈂
undo	均䁨
undone	均ㅕ
undress	均䑹
undressed	呒䒀
undressing	均䒁㖙
unfair	呒䙣
unfold	呒䞆
unfortunate	呒䞕㤶㙀
unfortunately	呒䞕㤶㙀〠
unfree	均䠠
unhappy	呒倦㉒
unhook	呒兕
unicorn	㊈㈈䅗
unicycle	概㈈榃晘
unidentifiable	〔䌹〶ち䜀〔〓
uniform	㊈㈠刵
uniforms	㊈㈈制
unique	㊈榄
unit	㊈㙀
universal	㊈㈈㈖㜨
universe	㊈㈈愩
unless	呒㥳
unlimited	呒ㅗ䂉〲
unload	均㔴
unlock	均呱
unlocked	呒呲
unorganized	〔䖉㐔坡
unpacking	呒㌙㍀
unpause	均堳
unpleasant	呒夈偢
unplug	呒夕
unplugged	呒外
unplugging	呒榅㔗
unplugs	均夗
unravels	均㞐捖
unruly	均㊘〠
unscrew	呒扈
unsnap	均摰
unsnapped	均摱
unstrap	均暄
untape	均枃
untie	呒䖔
untied	呒桩
unties	均嚀
until	呒桳
untying	均䖔㈙
unused	呒榆
unusual	呒㊈榇ぱ
unzip	呒榈
unzipped	均榉
unzipperoni	均䁖㔈㥂㈔
unzipping	均㙑㞂
up	㘕
uphill	榐儡
upieday	䕘㉒㕴
upon	〔榑
upper	䕘㔈
uppie	䕘㉒
ups	榒
ups@c	榒
upsa	㘕〘
upsadaisy	㘕〘㕴㙑
upset	㘕抇
upside	㘕㕉
upsidedown	㘕䌘䑒
upsie	㘕〄
upstairs	榐䑔
upstream	㘕䑕
uptown	㘕䑖
urchins	㡹榓
urge	榔
us	榕
use	榖
used	榆
useful	榖㍙
useless	㊈榗
uses	㊈〧
using	㊈ㆃ
usual	㊈榇ぱ
usually	榘䘕〔〠
utensil	㊈㍁㜨
utensils	㊈㍁㜩
utmost	榙ㅣ
v	䄷
v's	噇
v@l	䄷
vacation	ぢ㠡だ
vacuum	䘇瀀
vacuumed	䘇瀁
vacuums	䘇瀂
valentine	䘇ㅖ瀃
valentine's	䘇ㅖ瀄
valentines	䘇ㅖ瀄
vampire	瀅瀆
van	瀇
van's	瀈
vandross	瀇瀉
vane	瀐
vanilla	ㆅ㈈ㅈ
vans	瀈
variable	䘇㈗〔〓
variety	ㆅㅱ䕓で
vas	瀑
vaseline	䉳〘吅
vasie	ぢ㙑
vat	瀒
vegetable	瀓〱〓
vegetables	瀓〱㝙
veggie	杢〈
vehicle	䄷䕓㈒
veils	瀔
velcro	瀕䈤
velcroed	瀖䈶
velveteen	瀕ㆅ䕐
vent	䘉
vera	䄷ゆ
verbalize	㈖㍥吳
vern	瀗
versatile	㈖〴㑶
verse	愩
version	㈖䙀
versus	㈖㌦
very	杢㈗
vests	瀘
victoria	瀙㥀㈗〔
video	づ々㥂
videos	づ々㤷
view	㊈
viewpoint	堸㉥
vigorously	づ㔖㌘
vin	䕥
vine	䐠
vinegar	づ㈠㔖
vines	瀠
vinnie	づ㈔
vintage	䕥瀡
violence	ゔ〔捩
violent	ゔ〔䘠
violet	ゔ〔㚐
violin	ゔ〔ㅖ
viper	ゔ㔈
virginia	㈖䕷㕩
virtually	㈖ぐ〔〠
visit	づ䁂
visited	づ䁖㜷
visiting	づ䁖す
visits	づ坔
visual	づ榇ぱ
vitamin	ゔ〱㕄
vitamins	ゔ〱瀢
vividly	づ䌆〠
vocal	䍢㈒
voice	瀣
voices	瀤〧
volcano	瀥㠡㘴
vole	瀦
volleyball	䉳〠㐄
volunteer	䉳㐤瀧
vroom	瀨
w	㐙〓㊈
w@l	㐙〓㊈
wackwackwack@o	瀩怸怷
wacky	瀩㎇
wafer	㉂㦇
wafers	㉂圴
waffle	瀰㍙
waffles	瀰㍠
wag	瀱
wagon	瀩䑠
wahwahwah	瀩瀩瀩
wahwahwah@si	瀩瀩瀩
wait	瀲
waited	㉂〲
waiting	㉂す
wake	㍕
wakes	瀳
waking	㉂㍀
waldo	瀴ゅ
walk	捣
walkandtalk	瀰瀵坴
walked	瀶
walker	瀰ざ
walkie	瀰㎇
walkietalkie	瀰㎇杲㎇
walkietalkies	瀰㎇杲㕦
walking	瀰㍀
walks	瀷
wall	瀴
wallet	瀰㚐
wallpaper	瀴㉉㔈
walls	瀸
walt	瀹
walters	瀴ㅙ
walters's	灀っ㉠
wand	灁
wandered	灂㎈
wandering	灂㜑ㄦ
wanna	㥒㈠
want	灃
want's	灄
wanted	㈹〲
wanting	㈹す
wants	灅
war	灆
warm	灇
warmed	灈
warmer	灆㝸
warming	灆㔀
warn	灉
warning	灆㍖
warren	瀰䍴
warrior	瀰悈
was	灐
wash	灑
washcloth	灑䁃
washcloths	灑灒
washed	灓
washer	瀰䐃
washes	瀰㌐
washie	㥒㉧
washing	瀰㝕
washrag	㥒䐂
wasn't	坅偢
wasp	灔
wasps	灕
waste	灖
wasted	㉂㠅
wasting	㉂㠆
watch	灗
watched	灘
watches	㥒㊁
watching	㥒㖒
water	瀰っ
water's	瀰ㅙ
waterfall	瀰っ䙩
watering	瀰〱ㄦ
waterloo	瀰っ㐓
watermelon	瀰っㆉ㐤
watermelons	瀰っㆉ㥧
watery	瀰〱㈗
wave	喉
waved	灙
waves	灠
waving	㉂ぉ
wawa	㥒㥒
wax	灡
way	㉂
way's	㉃
ways	㉃
we	単
we'd	灢
we'll	灣
we're	灤
we've	灥
weak	灦
wear	㉄
wearable	㉂ゆ〓
wearing	㉂ㄦ
wears	灧
weasel	単㑔
weasels	単怶
weather	灨ㅵ
weaving	単ぉ
web	灩
webs	䁦
wednesday	灰㕴
wee	単
weebles	単㝙
weed	灢
weeds	灱
week	灦
weekend	単灲
weeks	灳
weens	灴
weensie	倸〄
weepee	単㉒
weepie	単㉒
weepy	単㉒
weeta	単〱
weewee	単単
weewees	単灵
weeweeweeweewee	単単単単
weigh	㉂
weight	瀲
weird	灶
weirdest	灤偖
weirdo	灤ゅ
welcome	灷㦖
well	灷
went	灸
were	吂
weren't	灹
wet	炀
wetter	灨っ
wh	冂
whack	炁
whaddya	坅䔤
whale	炂
whales	炃
wham	炄
what	炅
what'd	坅〲
what's	炆
whatcha	炇㢕
whatchamacallit	炅㢕㊒㠱㚐
whatever	炅㈵㈖
wheat	炈
wheaties	単て
whee	単
wheel	灣
wheelbarrow	炉㑆㙥
wheeling	単㐉
wheels	炐
when	炑
when's	灰
whence	炒
whenever	炑㈵㈖
where	㉄
where	㉄
where'd	炓
where're	冈䀖
where's	灧
whereas	冈悁
whereupon	冈ゆ䅸
wherever	㉂ㅩ㈖
whether	冈ㅵ
whew	炔
whey	㉂
which	炕
while	啩
whine	炖
whined	炗
whines	炘
whiney	炙㈔
whineyness	炙㈔䆙
whining	炙㍖
whip	焀
whipped	焁
whipping	䐓㞂
whips	焂
whirled	焃
whirlwind	吂焄
whisker	焅ざ
whiskers	䐓坤
whisper	焅㔈
whispered	䐓焆
whispering	䐓㌡ㄦ
whistle	䐓㜨
white	䔣
whitney	焇㈔
who	兓
who's	焈
whoa	焉
whoever	兓㈵㈖
whole	㠔
whom	焐
whoop	焑
whoopee	焒㉒
whoopie	焒㉒
whoops	焓
whoopsadaisy	焔〘㕴㙑
whoopsie	焔〄
whoopsiedoozies	焔〄䁨䊄
whoopsiedoozy	焔〄䁨㙑
whoosh	焕
whose	焈
whoville	兓堶
why	炙
why's	坧
whys	坧
wick	焖
wicked	䐓䈰
wide	焗
wider	炙ㅅ
width	焘
wife	焙
wig	焠
wiggins	䐓㔠
wiggle	䐓㈇
wiggles	䐓䤀
wiggly	焠〠
wild	無
wildly	無〠
wiled	焢
will	焣
william	焣焤
willie	䐓〠
willing	䐓㐉
willow	䐓㊔
willy	䐓〠
wilted	焣〲
wily	炙〠
win	焥
wind	焦
wind's	焧
windbreaker	焦㚒ざ
winder	炖ㅅ
window	焥ゅ
window's	焥㍔
windows	焥㍔
windowsill	焥ゅ捰
winds	焧
windshield	焦挦
windshield's	焥焨
windshields	焥焨
windy	焥々
wing	搳
wings	焩
wink	桷
winkie	搳㎇
winkle	搳㈒
winky	搳㎇
winnie	䐓㈔
winter	焥っ
wipe	焰
wiped	焱
wipeout	炙焲
wiper	炙㔈
wipers	炙䀲
wipes	焳
wipie	炙㉒
wipies	炙儈
wiping	炙㞂
wire	㐴
wires	焴
wish	焵
wishbone	焵㘲
wished	然
wishes	䐓㌐
witch	炕
with	焷
within	䐓焸
without	䐓焹
wittle	䐓㑶
wittles	䐓㔑
wobbly	瀰㖑
wocket@n	㥒䡙
woe	焉
woke	煀
wolf	煁
wolfie	煂㕲
woman	焒㡘
womb	煃
women	䐓㕄
won	㈹
won't	煄
wonder	㈹ㅅ
wondered	㈹㎈
wonderful	㈹ㅅ㍙
wonderfully	㈹ㅅㅦ〠
wondering	㈹㜑ㄦ
wonders	㈹ㅆ
woo	煅
wood	元
wooden	焒䕀
woods	煆
woody	焒々
woof	煇
woofwoof	煇煇
wool	煂
woolly	焒〠
wooly	焒〠
woowoo	煅煅
word	䕄
words	㄃
wore	煈
work	兇
worked	煉
workie	吂㎇
working	吂㍀
workout	吂㤨
workplace	兇䘓
workroom	吂煐
works	煑
world	焃
world's	煒
worm	利
worms	煓
worn	煔
worried	吂㞒
worries	吂㑴
worry	吂㈗
worse	煕
worship	吂愅
worst	煖
worth	煗
wosuits	焉㑦
would	元
would've	焒捈
wouldn't	焒䅱
wound	煘
wow	㚄
wrap	恵
wrapped	恷
wrapper	㞐㔈
wrapping	㞐㞂
wrappings	㞐䦘
wreath	煙
wreck	㈡
wrecker	ㅩざ
wrecking	ㅩ㍀
wrestle	ㅩ㜨
wrestled	ㅩ煠
wrestles	ㅩ㜩
wrestling	ㅩ〘㐉
wriggly	㆐㐔〠
wrinkled	ㄦ㝡
wrinkles	ㄦ㈓
wrinkly	ㄦ㍉
wrist	䕶
write	ㅰ
writes	煡
writing	ㅱす
writings	ㅱ䥳
written	㆐㒓
wrong	煢
wrote	慰
wuss	煣
wuzzy	坅㙑
x	䘣
x@l	䘣
x@l-s	䘣
xavier	煤䜘
xavier's	〨䄇䄷䝵
xylophone	煥ㅈ喈
y	炙
y@l	炙
ya	煦
yahtzee	照㙑
yak	煨
yaks	煩
yall	煰
yam	煱
yams	煲
yank	煳
yanked	煴
yankee	煵㎇
yanking	煵㍀
yanks	煶
yard	䚀
yarn	煷
yawn	煸
yawned	煹
yawning	熀㍖
yay	熁
yaya	煦煦
yaya's	煦熂
yayayaya	煦煦煦
ye	熃
yea	熁
yeah	䜘
year	熄
yearling	䜘㐉
years	熅
yeast	熆
yeh	熇
yell	熈
yelled	熉
yelling	熇㐉
yellow	熇㊔
yells	熐
yep	熑
yeps	熒
yes	熓
yessiriebobs	熇㈥〆熔
yesterday	熓っ㕴
yet	熕
yicky	熖㎇
yikes	熗
yipped	熘
yoda	熙㜑
yogurt	熙爀
yogurt's	熙爁
yolanda	熙吁㜑
yolk	爂
yomiko	熙ㆇ㥑
yonder	爃ㅅ
yorgensen	爄䑠爅
york	爆
you	㊈
you'd	䄱
you'll	爇
you're	爈
you've	爉
young	䕈
younger	䕈㔖
your	爐
your	爐
yours	爑
yourself	爐儇
yous	啙
youth	爒
yoyo	熙熙
yuck	爓
yucka	爔゙
yucketyyuck	爔㡠で爓
yuckies	爔㕦
yucks	爕
yucky	爔㎇
yukon	㊈䂙
yuli	㊈〠
yuli's	㊈㌒
yulibaba	㊈〠㍤㍥
yulibabaf	㊈〠㍤爖
yulibob	㊈〠㘤
yulibobs	㊈〠熔
yum	爗
yumbum	爗㝶
yummies	爔㝹
yummy	爔ㆇ
yumsie	爗㙑
yumyum	爔爘
yumyums	爔爙
yup	爠
z@l	㙑
zach	爡
zachary	爢゙㈗
zaps	爣
zealand	㙑䡲
zebra	㙑䌖
zebras	㙑爤
zenga	爥㐔
zero	㙑㙥
zeus	爦
ziggy's	䁖㎖
zigzag	爧爨
zigzagging	爧爢㔗
zinnias	䁖㈔㊂
zip	榈
ziploc	䁖爩
zipped	榉
zipper	䁖㔈
zipper's	䁖䀲
zippered	䁖吤
zippers	䁖䀲
zipping	䁖㞂
zips	爰
zipzapzuds	榈爱
zizzerzazzerzoo	䁖㚇爢㚇爲
zizzerzazzerzuzz	䁖㚇爢㚇爳
zone	爴
zoo	爲
zookeeper	爲㎇㔈
zookeeper's	爲㎇䀲
zoological	爵〔䁳㔳㈒
zoom	父
zooming	爲㔀
zoomzoom	父父
zoos	爷
zum@o	父
