	ㄵ
@	【
@G	㈆
@S	㌑
@U	㤵
@b	〗
@d	ひ
@dz	へ
@f	㄁
@g	ㄑ
@k	〳
@ks	㍢
@kt	じ
@kts	ば
@l	ㄳ
@m	ㅸ
@n	㆕
@nd	㆘
@nt	㈨
@nts	㈴
@nz	啃
@sk	㌓
@sks	㌖
@skt	㌔
@t	㌲
@v	㍒
@z	㌈
C@	㤇
C@ns	㤉
C@nt	㤐
C@p	㤓
C@t	㤥
CE	㤧
CEk	㤦
CEks	㤩
CEr	儕
CErz	儖
CEst	㥃
CI	㤶
CIG	㖒
CIf	匹
CIfs	偆
CIk	㥇
CIks	㥈
CIl	㥔
CIm	㥘
CImp	㥙
CIn	㥡
CInt	㆗
CInz	榓
CIp	㥣
CIps	㥥
CIr	楸
CIs	怰
CIz	㊁
CO	㥰
COs	㥩
CR	を
CRC	㦐
CRd	慀
CRp	㥦
CRz	䈒
CY	㥢
CYld	㥓
CYm	㥖
CYmz	㥗
C^	㦈
C^G	㦉
Cak	㤅
Camp	㥵
Cap	㥷
Capt	㥸
Car	㤙
CarJ	㤗
CarJd	㤘
Carm	㤡
Cart	㤢
Cc	㥨
Cck	㤄
Ccr	枆
Ccrz	㦀
Ce	㢘
Cen	㤀
CenJ	㤑
CenJd	㤒
Cenz	㤁
Cer	㤂
Cerz	㤃
Ces	㤣
Cest	㤤
Ci	え
Cik	㤰
Ciks	㤱
Cip	㤲
Cir	㤳
Cirz	㤸
Civ	ぅ
Civd	う
Civz	ぇ
Ciz	㤹
Co	㥲
Cok	㥱
Cor	㥹
Coz	㦁
Cu	ぐ
Cud	㥄
Cuk	㥶
Cuz	㥅
Cx	㢕
Cxnd	唩
Cxnz	唰
Cxp	區
Cxz	㦑
D@	栠
D@n	栔
D@t	栙
D@ts	儳
DEm	栧
DEmz	栨
DEn	栰
DIG	㑥
DIn	焸
DIs	框
DR	ㅵ
DRd	㙨
DRz	㙩
DWt	焹
DY	桨
D^	栢
De	栲
Ded	栳
Del	栴
Der	栥
Derz	栦
Dev	栵
Di	栣
Diz	栱
Do	ㅳ
Doz	桐
Dx	㈤
Dxm	愴
E	㈵
EJ	䕁
Ed	䕃
Ef	〇
Eg	㞉
Egz	䕉
Ek	〨
Eks	䘣
El	䕒
Els	䕲
Elvz	䕳
Em	䕵
En	䖁
End	䖃
Endz	䖄
Er	ㄩ
Es	䘁
Est	さ
Ev	䘑
GR	偉
I	䕓
IC	剱
IG	㈙
IGk	刹
IGz	㔦
IJd	䖂
IS	䥴
IT	䜑
Idz	䝹
If	刖
Ig	䘘
Ik	䘲
Iks	䘥
Il	则
Im	刡
In	぀
InC	刨
Ins	䘴
Int	䐈
Inz	䌠
Irz	䔧
Is	䤘
Ist	䔵
It	䍱
Its	剨
Iz	剤
J@	剳
J@k	剴
J@ks	創
J@m	劁
J@z	劈
JE	㈄
JEf	劓
JEfs	劔
JEk	愃
JEkt	态
JEkts	怂
JElz	䢅
JEn	䢈
JEnt	䢉
JEnts	䍗
JEs	䄓
JEst	朣
JI	㔳
JIG	㌃
JIS	块
JIg	匁
JIk	唗
JIks	圢
JIkt	朑
JIl	匂
JIm	値
JImz	匃
JIn	䕷
JInd	吠
JInt	䍖
JInz	塳
JIs	䥆
JIt	㜡
JIz	㜘
JO	䖆
JOd	䖇
JOn	匉
JOs	愄
JOz	䖈
JR	券
JRk	劖
JRz	攉
JU	䕂
JUl	戣
JY	䢕
J^	べ
J^G	匣
J^Gk	匥
J^J	匓
J^g	匔
J^m	化
J^mp	匘
J^mps	匠
J^mpt	匙
J^s	め
J^st	ゃ
J^t	匦
Ja	匆
Jab	匄
Jag	包
Jan	匇
Janz	匈
Jar	劅
Jard	劆
Jarz	劇
Jc	劉
Jcr	䢑
JcrJ	䢐
Jcz	劐
Je	儙
Jek	劀
Jel	剹
Jemz	劂
Jen	劃
Jenz	劄
Jez	割
Ji	〈
Jin	䢆
Jinz	劑
Jits	㜢
Jiz	劒
Jo	㐦
Jok	匐
Ju	䥗
Jul	匀
Jun	匡
Junz	匢
Jus	匕
Jx	㕃
Jxl	㈃
Jxld	戤
Jxlz	㈅
Jxz	㤠
OG	圹
OGk	圸
Ol	圶
Old	圷
On	坁
Os	垃
R	㡹
RJ	榔
RT	䔳
Rn	剠
Rnd	䔩
Rnz	剣
Rrxl	昕
Rz	䝵
S	挥
S0	內
S@	恳
S@l	挂
S@m	挅
SE	挘
SEf	㥁
SEl	挢
SElf	挣
SElz	扢
SI	䄈
SIG	㝕
SIft	挧
SIfts	挨
SIn	だ
SInd	䉤
SIns	堣
SInt	堤
SInts	堥
SInz	䉥
SIp	愅
SIps	挱
SIs	ㆄ
SIz	㌐
SR	䐃
SRt	嚙
SRts	挲
SU	捇
SUd	捆
SUk	挸
SUr	木
SUrd	悉
SW	捑
SWt	捐
SY	挰
SYn	挩
S^	捔
S^t	捡
S^v	捒
S^vd	捓
Sa	捀
Sad	挵
Sak	挳
Sakt	挴
Sap	挹
Sark	挑
Sarks	挒
Sarp	挓
Sat	捄
Sats	捅
ScG	攘
Scn	扙
Scr	捂
Scrt	捁
Scrts	捃
Se	折
Sed	抖
Sedz	抗
Sek	抙
Seks	持
Sekt	挀
Sem	挄
Semd	㌉
Sep	挆
Seps	挈
Sept	指
Ser	按
Serd	挐
Sev	挔
Sez	㌶
Si	㉧
Sid	挕
Sil	挖
Sild	挦
Sildz	焨
Sin	唑
Sinz	唒
Sip	挙
Sird	挗
Sit	挠
Sits	挡
Siz	䜴
SmE	啉
SmuS	嘦
Sn^ks	戥
So	怴
Sod	捗
Sol	捉
Sor	扣
Soz	捘
Sr@g	䐂
Srum	噡
St	榀
Su	匒
Sut	㦒
Suz	挶
Sx	㙕
Sxl	㈳
Sxlz	䂑
Sxn	㌨
Sxnd	啹
Sxnz	䄘
Sxs	㝗
Sxz	ㅑ
T@G	栗
T@Gk	栕
T@Gks	栘
T@Gkt	栖
TI	样
TIG	㉀
TIGk	桁
TIGks	桂
TIGz	䘔
TIf	栤
TIk	栶
TIn	桀
TR	㌆
TRd	桃
TRs	桅
TRst	桄
TRz	栅
TW	桒
TY	核
TYz	根
T^m	桤
T^mz	桥
T^n	桧
Tc	校
Tcr	桉
Tcrn	桇
Tcrnz	案
Tct	桑
Ti	㑤
Tiz	栆
Tr@	桕
Tr@S	桔
TrEd	桖
TrIn	匲
Tri	桗
Triz	桘
Tro	劙
Tron	桢
Trot	桠
Trots	桡
Troz	档
Tru	桙
Trum	㑨
Trumz	㑩
Tu	䖒
Tx	啐
Txd	善
Txn	噵
Txz	㕈
W	冂
WC	坨
WE	冈
WEns	炒
WIps	焂
WIpt	焁
WRz	䝴
WW	垂
WYnd	炗
WYnz	炘
W^t	炇
War	冇
Wi	坷
Wil	炉
Wl	坸
Wlz	垀
Wn	坱
Wns	坰
Wt	坲
Wx	䆇
Wxlz	坹
Y	㍣
Yd	䥃
Yg	䙉
Yl	ㄱ
Ylz	ㄲ
Ym	划
Yr	剢
Yrnd	剡
Ys	刔
Yv	刓
Yz	䙒
ZIn	䙀
ZR	啰
ZRz	䤅
Zi	䤁
Ziz	䤂
Zu	榇
^	䕘
^G	楹
^bz	楶
^g	楷
^m	㊕
^n	均
^p	㘕
^ps	榒
^s	榕
^t	榙
^v	圱
^z	㈀
a	。
ab	圡
ad	地
af	圳
ak	圧
an	䈇
and	㕖
anz	䈈
ap	坑
apCG	坕
ar	㊀
arg	㊇
ark	㉹
arm	㊑
armz	㊗
arnt	㊄
art	㌅
arts	㌇
arz	䙓
as	坥
b@	㍰
b@G	㐢
b@Gd	㐣
b@Gk	㐧
b@S	㑒
b@T	㑣
b@Ts	㑰
b@d	㎔
b@g	㎕
b@gz	㎗
b@k	㎂
b@ks	㎉
b@kt	㎄
b@l	㐂
b@m	㐖
b@n	㐥
b@nd	㐘
b@ndz	㐡
b@ps	㐩
b@s	㑖
b@t	㑢
b@ts	㑳
bE	㑆
bET	㕓
bETs	䕩
bEd	㔁
bEdz	㔂
bEg	㔔
bEl	㔨
bElC	㔧
bElt	㔶
bElts	㔷
bElz	㐱
bEn	㔸
bEnC	㕀
bEnd	㕁
bEnt	㕅
bEnz	㔹
bErr	㒅
bErz	㒄
bEst	㕑
bEt	ㅧ
bEts	ㅨ
bI	】
bIG	㕥
bIJ	㠙
bIb	㕗
bIbz	㕘
bId	㕙
bIg	㕠
bIl	㕣
bIld	㝩
bIldz	㝲
bIlt	㝳
bIlz	㕤
bIn	㔆
bInt	〣
bInz	慓
bIt	㕵
bIts	㕸
bIz	㠃
bO	㘩
bOG	㘰
bOl	㘧
bOld	㘨
bOz	㚆
bR	㐲
bRT	㕳
bRd	㕰
bRdz	㕱
bRk	㞓
bRn	㞔
bRnd	㞕
bRnt	㞖
bRp	㞗
bRps	㞙
bRpt	㞘
bRt	㕆
bRts	㕇
bRz	䉒
bU	㙃
bUS	㠁
bUSt	㠂
bUk	㙅
bUks	㙇
bUl	㝴
bW	㙱
bWd	㙸
bWl	㙹
bWlz	㚀
bWn	㙵
bWndz	㙷
bWns	㙳
bWnst	㙴
bWnt	㙶
bWt	〕
bY	ㅉ
bYk	㕡
bYks	㕢
bYn	䂇
bYt	㕶
bYts	㕷
bYz	㠖
b^	㈶
b^G	㞈
b^b	㝖
b^d	㝤
b^dz	㝥
b^g	㝦
b^gd	㝨
b^gz	㝧
b^ks	㝣
b^lb	吸
b^lbz	吹
b^m	㝶
b^md	㝷
b^mp	㞀
b^mps	㞃
b^mpt	㞁
b^mz	㞄
b^n	㞅
b^nC	㞆
b^nz	㞑
b^s	㠀
b^st	㠄
b^sts	㠇
b^t	㠈
b^ts	㠉
b^v	〖
b^z	㠗
ba	㍤
baG	㘶
baGk	㘸
baGkt	㘹
bab	㘤
babz	熔
bad	刕
bak	㍦
baks	㚅
band	㘱
bap	㙠
baps	㙡
bar	㍧
barb	㐳
bark	㐸
barks	㑀
barkt	㐹
barn	㑁
bart	㑐
barz	㍨
baz	㍩
bc	㐈
bcg	㘦
bcl	㐄
bcld	㐃
bclz	㐅
bcrd	㤆
bcrn	㙣
bcrnz	嚑
bct	㙲
be	㍴
beb	㍲
bebz	㍳
bek	㎘
beks	㐁
bekt	㎙
ber	㐵
berz	㒈
bes	㑑
bi	〃
biC	㑷
bid	㑸
bidz	㑹
bif	㔅
bik	㒀
bil	㍐
bin	㒁
binz	㒂
bip	㔇
bips	㔉
bir	㔐
bird	㒇
bis	㒐
bist	㒉
bit	㒒
bits	㔒
biz	㍵
bl@G	㖅
bl@Gk	㖄
bl@k	㕹
bl@st	㖈
blE	㖗
blEnd	㖔
blEndz	㖕
blEs	㖖
blI	㝠
blIG	㍱
blIGk	㘄
blWs	㘒
blYnd	㘂
blYndz	㘃
bl^	㘘
bl^S	㘗
bl^d	㘉
bl^ks	啴
bla	㖂
blak	㘅
blaks	㘆
blakt	㘇
bland	㘈
blck	朥
bled	㖀
bledz	㖁
blem	㖃
bli	㖑
bliC	㖉
bliCt	㖐
blid	㖓
blo	㘓
bloz	㘔
blu	㘁
blum	㘐
bluz	㘖
blxmz	妗
bo	㘙
boT	㙧
bol	㚁
bolz	㚂
bon	㘲
bonz	㘵
bor	㘡
bord	㘠
bordz	掁
bot	㘢
bots	㘣
boz	㚃
br@n	㚔
br@nC	㚕
br@nd	㚖
br@s	㚗
br@t	㚘
brE	吨
brET	㜆
brEd	㜀
brEk	㜂
brEn	㜐
brEst	㜅
brI	㜗
brIG	㜤
brIGz	㜥
brIJ	㜖
brIk	㜔
brIks	㜕
brIt	㜰
brU	㜹
brUk	㜸
brW	㝆
brWn	㒆
brWnz	㝇
brWz	㝈
brY	㜓
brYt	㜠
br^	㝄
br^S	㝓
br^St	㝔
br^nC	㝒
bra	㚈
brc	㜲
brcT	㝃
brcd	㜱
brct	㝅
bre	㚒
bred	㚑
brek	㜁
breks	㜄
bren	㚓
bres	㚉
bret	㢅
brets	㢆
brev	㚙
bri	㜈
briD	㜇
brif	㜙
briz	㜉
bro	㜵
brok	㜴
brum	㝁
brumz	㝂
brus	㝉
bruz	㝐
bruzd	㝑
brx	䌖
brxz	爤
bu	〤
buS	㙔
bum	㙈
bumz	㙐
bun	㍶
bunz	㙁
bup	㙒
bups	㙓
bus	㙗
bust	㙖
but	㙘
buts	㙙
buz	㙂
bwEb	䁥
bx	㍥
bxT	䕨
bxf	爖
bxl	〓
bxld	北
bxlz	㝙
bxn	愵
bxnd	切
bxndz	刈
bxnz	愶
byu	〦
byus	〥
byx	䙕
c	ㅶ
cf	圲
cfs	处
cg	㍄
cl	ㅔ
clz	坵
cr	䅇
crd	坙
ct	坩
d@	䉷
d@G	䊖
d@b	䉵
d@d	䉶
d@dz	䉸
d@l	䊇
d@m	䊑
d@mp	䊒
d@n	䊓
d@nd	儓
d@ns	䊕
d@nz	䊔
d@t	䌃
d@z	䉹
dE	䌕
dEd	䌒
dEk	䌡
dEl	䌳
dEn	〶
dEns	䌷
dEnt	〷
dEnts	〸
dEsk	䍉
dI	㊓
dIG	ぷ
dIGz	㝱
dIS	䐁
dId	ふ
dIg	䎀
dIgz	䎁
dIk	ぶ
dIl	䊁
dIlz	䊂
dIm	䎃
dIn	ㄶ
dInt	〵
dIp	䎆
dIps	䎇
dIs	䍐
dIsk	䎓
dIsks	䎕
dIst	偖
dIt	䈔
dIts	䈕
dIz	䐇
dR	ㅅ
dRd	㎈
dRt	䎈
dRts	䎉
dRz	ㅆ
dU	䔠
dW	䑓
dWn	䑒
dWnz	偈
dWt	䑉
dY	䍥
dYd	䍩
dYl	䈧
dYlz	䈨
dYv	䐗
dYvd	䐘
dYvz	䐙
dYz	䍰
d^	㐙
d^b	䔇
d^g	䔒
d^k	䔈
d^ks	䔐
d^lt	よ
d^lts	ら
d^m	䔔
d^mp	䔕
d^mpt	䔖
d^n	ㅕ
d^p	兀
d^s	䔢
d^st	䔡
d^v	䑑
d^z	䐣
da	䉴
daG	䐹
daJ	䐢
dag	兹
dak	䐡
dal	䐰
dalz	䐩
dan	䐵
dar	䌁
dark	䌀
darn	䌂
dat	䑈
dc	䌅
dcG	䑀
dcg	䐥
dcgz	䐦
dcl	㍹
dclz	㎀
dcn	䌈
dcnz	䌉
dcr	㎃
dcrz	坳
dcs	䑇
de	㕴
dek	偹
del	䊆
dem	䊐
den	䊃
der	䊙
det	䌄
dez	䌐
dfIS	䤴
di	々
did	䊀
dil	䌓
dinz	ㄷ
dip	䌥
dir	䌔
diz	㈂
dli	䠳
do	ゅ
dom	䐳
dont	䐶
dor	ょ
dorm	䑆
dorz	䑃
doz	㍔
dpOnt	昱
dr@	䑙
dr@Gk	䑨
dr@g	䑗
dr@gd	䑘
dr@gz	䑣
drE	䒁
drEd	䑴
drEnCt	䑸
drEs	䑹
drEst	䒀
drI	䒉
drIG	䒇
drIGk	䒅
drIGks	䒆
drId	写
drIdz	刀
drIl	䒄
drIn	㥕
drInt	刑
drIp	䒈
drIps	䒐
drWn	䒙
drY	䒒
drYd	䒃
drYr	䔅
drYv	䒑
drYvz	䒓
drYz	䔆
dr^	䔂
dr^G	䔄
dr^Gk	䔃
dr^m	䔀
dr^mz	䔁
dra	䑦
drap	䒕
draps	䒗
drapt	䒖
drc	䑰
drcr	䑱
drcrz	䑲
drcs	瀉
drcz	䑳
dre	䌱
dren	䑤
drep	䑩
dri	㆙
drim	䑵
drimd	䑶
drimz	䑷
drol	慕
drom	杣
drov	䒘
dru	䒂
drul	䒔
drum	㔃
druz	㈁
drx	䑧
du	䁨
dud	䔑
duks	䔓
dup	䑂
dus	妘
dust	剕
dwIC	戇
dwcks	捤
dx	㜑
dxd	㝰
dxkt	妙
dxkts	怀
dxl	㞇
dxld	假
dxlz	㡁
dxm	び
dxmz	ぴ
dxn	䕀
dxns	䅣
dxnt	䅱
dxnz	䡱
dxs	䘩
dxst	䥀
dxv	捈
dxz	㜒
dyx	䔤
e	、
eC	倥
eD	㌳
eJ	ㄆ
ed	ㄠ
edz	ㄡ
em	ㄢ
emd	ㄣ
en	㆖
ent	ㄤ
er	ㄥ
et	㉨
etT	䕑
ets	㉩
f@	䙔
f@k	と
f@kt	䙡
f@m	䙴
f@n	䙵
f@nz	䙶
f@st	䚂
f@t	䚄
fE	䙤
fEC	䜆
fEd	䚒
fEf	䜇
fEk	䐄
fEkt	塖
fEl	䜁
fElt	䜂
fEn	䌧
fEns	䜃
fEnst	䜄
fI	㢗
fIG	㢙
fIS	䜳
fIf	䜈
fIfT	䜐
fIg	䜒
fIgz	䜔
fIk	䝃
fIks	䝂
fIkst	䝄
fIkt	塗
fIl	䜙
fIld	䜠
fIlm	䜡
fIn	䐱
fInt	䕡
fInts	䕢
fInz	䐲
fIs	圵
fIst	䜵
fIsts	䜶
fIt	䜷
fIts	䜸
fR	㦇
fRd	䀡
fRdz	䀢
fRm	䜱
fRst	䜲
fRt	䂐
fRz	圴
fU	㐷
fUl	䡒
fUlz	䉖
fUt	㐶
fUts	䞔
fWl	䠉
fWn	䠑
fWnd	䠐
fY	䜀
fYd	䤗
fYn	䜣
fYnd	䜢
fYndz	䜤
fYr	䜩
fYrz	䜰
fYt	䜓
fYv	䝁
fYvz	儘
f^	䡖
f^G	唨
f^Gk	䡕
f^m	䡓
f^n	䡔
f^s	䡘
f^st	䡠
f^z	䡣
fa	䑅
far	䙷
farf	㊅
farm	䙸
fart	䚁
farz	剸
fc	䙰
fck	䠕
fcks	䠔
fcl	䙩
fcls	䙲
fclt	䚆
fclz	䙱
fcn	䚉
fcr	䞕
fcrk	䠂
fcrks	䠃
fcrm	刵
fcrmd	䠄
fcrmz	制
fcrn	㠨
fe	䙠
feT	䙥
fed	䙢
fek	䙦
feks	䙨
fekt	䙧
fer	䙣
fes	䙗
fest	䙙
fets	䚅
fi	㕲
fid	䚓
fidz	䚔
fil	䚕
fild	䅘
filz	䚖
fir	䚐
fist	䚑
fit	䚘
fits	䚙
fiz	䚗
fl	䝳
fl@	䝓
fl@S	䝒
fl@g	䝅
fl@p	䝐
fl@ps	䝑
fl@t	䝕
flEk	悘
flEr	䝆
flErz	䝇
flI	䝤
flIk	刴
flIkt	䝠
flIp	䝡
flIps	㎅
flR	䝥
flW	㡸
flWnt	䝲
flY	䑢
flYr	䞁
flYz	㠐
fl^	䝸
fl^S	䞀
fl^f	䝷
fla	䝱
flap	䝢
flaps	䝣
fle	䝖
fleks	䝈
flit	䝘
fliz	䝗
flo	䝧
flor	䝩
florz	䝰
flot	䝦
flots	䝨
floz	䝶
flu	䝙
flx	䝉
fo	䞄
foks	䞈
fol	䞇
fold	䞆
fom	䞃
fon	喈
fonz	䔰
for	㔓
forT	䠇
forTs	䠓
ford	ゖ
forst	䞖
forz	䠒
fr@G	䠘
fr@Gk	䠗
fr@k	悙
frE	䠢
frES	䠥
frEd	䠡
frEn	䠲
frEnC	䠤
frEnd	䠰
frEndz	䠱
frI	゘
frIJ	䠨
frIk	䠦
frIl	䠵
frIns	䍳
frInt	䍵
frIz	䠶
frWn	䡅
frY	䠧
frYd	䠩
frYz	䠴
fr^	䡉
fr^m	䡀
fr^nt	䡁
fr^nts	䡂
frag	㝵
frc	䠹
frcg	䠷
frcgz	䠸
frcs	䡄
frcst	䌨
fre	ㅇ
fred	゗
frem	䠖
frez	塨
fri	䠠
frik	䠙
friz	䠣
fro	䡇
froz	䡆
fru	䡑
frut	䡃
fruts	䡈
frx	刷
frxns	悗
frxnt	䍷
fu	䕇
fud	䞐
fudz	䞑
ful	䞒
fuld	䞓
fx	ㅦ
fxl	㍙
fxlz	㍠
fxn	刳
fxnt	刲
fxnts	䕣
fxst	㜃
fxt	噑
fyU	䡗
fyu	䄒
fyuJ	愀
fyum	塘
fyuz	䄐
fyuzd	䄑
g@	䡤
g@n	㔕
g@p	䡨
g@s	䡴
g@spt	䡵
g@t	䡷
gE	ㅴ
gEn	㄄
gEnst	ㄅ
gEs	倐
gEst	們
gEsts	倒
gEt	䞗
gEts	䞘
gI	㔙
gIG	㔗
gIGz	吡
gIJ	唂
gIfs	䢘
gIft	䢗
gIl	倔
gIn	㔘
gInz	㔠
gIst	呷
gIt	䤐
gIts	圓
gIv	䞙
gIvz	䤑
gR	㔖
gRl	䤈
gRlz	䤉
gRt	爀
gRts	爁
gRz	㙄
gU	䤹
gUd	䤸
gWn	䥉
gWnz	䥐
gY	倡
gYd	倓
gYz	倢
gYzd	䎘
g^	䐀
g^lz	扖
g^m	倖
g^mp	倗
g^mz	倘
g^n	㔡
g^nz	候
g^s	倠
g^st	䎙
ga	䠁
gaS	䥇
gad	䤰
gadz	䤱
gan	在
gar	䡰
gard	倈
gardz	倉
gat	䠀
gats	䥈
gc	㡶
gclf	䤶
gcn	䐧
gcr	䥅
ge	ㅘ
gel	〒
gelz	䡥
gem	㐇
gemz	䡧
gend	䡦
get	䡸
gets	䡹
gev	䢁
gi	ㄇ
gir	䢂
girz	䢃
gis	䢄
giz	㎖
gl@	䙑
gl@d	䤒
gl@s	䤓
glEk	嚄
glEts	塴
glIG	杹
glIS	䖅
glIts	塵
gl^b	䤣
gl^mp	䤥
gl^v	䤡
gl^vz	䤢
glc	䤠
glcs	䤙
gli	撖
glo	䤖
glob	䤔
glu	䤕
glud	䤤
go	ㄓ
gol	䤧
gold	䤳
gost	䢔
got	䤨
gots	䤩
goz	㘷
gr@	䄔
gr@b	䥑
gr@bd	䥒
gr@bz	䥓
gr@f	㍇
gr@m	䥙
gr@mps	䥠
gr@mz	䥡
gr@n	䥣
gr@nd	䥢
gr@nt	䥧
gr@s	䥱
gr@sp	䥰
gr@t	憁
gr@ts	憂
grE	ㄉ
grEg	䥹
grI	䦂
grIl	䦃
grIld	䦄
grIn	䦅
grInC	䦆
grIp	䦉
grIt	䦐
grIts	䦑
grW	䦕
grWC	䦔
grWl	䦙
grWld	倀
grWnd	㎆
grYn	䦈
grYnd	䦇
gr^f	唐
gr^m	倄
gr^n	倅
gr^nt	倆
gr^nts	倇
gre	䥕
gred	䥖
gren	䥘
grep	䥨
greps	䥩
gres	䥔
gret	䥲
grets	䥶
gri	ㄔ
grid	ㄕ
grif	䦁
grik	䥷
grin	䥸
gris	䥵
griz	䌩
gro	䦒
groT	倃
gron	倁
gros	䦓
gru	䦀
grup	䦗
grx	ㄈ
gu	䢙
guf	䥂
gus	䥄
gwI	䙆
gwIJ	厉
gwIn	塑
gwa	刘
gx	㐔
gxl	㈇
gxld	撕
gxlz	䤀
gxn	䑠
gxnt	䕠
gxnz	䑡
gxs	㌠
gxst	㍆
gxz	匨
gyR	䜕
gyu	㊆
gyx	㊉
h	円
h@	倦
h@CllG	偤
h@G	偅
h@Gz	偑
h@S	偡
h@Ul	㊖
h@b	ㄖ
h@d	倧
h@f	倨
h@fs	倷
h@g	倩
h@m	倹
h@n	偃
h@nd	偁
h@ndz	偂
h@ps	塙
h@t	偣
h@ts	偧
h@v	偨
h@z	偠
hE	倳
hEJ	傓
hEd	ㄗ
hEdz	傀
hEl	傃
hElT	傂
hEld	傕
hElp	傘
hElps	儀
hElpt	備
hEn	儁
hEnz	儂
hEr	倴
hErz	偗
hI	億
hId	儑
hIl	儡
hIlz	儢
hIm	儣
hInJ	儤
hInt	儥
hIp	儦
hIps	儧
hIt	儰
hIts	儱
hIz	儩
hR	儃
hRd	傇
hRt	刄
hRts	刅
hRz	儅
hU	兗
hUd	兔
hUk	兕
hUks	兘
hUkt	兖
hW	㈷
hWd	内
hWnd	冁
hWs	䐨
hWz	冃
hY	䌰
hYd	儒
hYk	儠
hYnd	㔥
hYr	儗
hYrd	儨
hYt	䢓
h^	先
h^G	刁
h^S	刉
h^f	冐
h^ft	冑
h^g	冒
h^gd	冔
h^gz	冕
h^m	冖
h^mp	冗
h^n	冘
h^nt	刃
h^t	刐
h^z	分
ha	ㄘ
haG	兑
hab	恥
hag	儶
hagz	傔
hak	兂
han	夣
hap	兢
haps	全
hapt	兦
har	㜶
hard	偕
harm	偘
hart	傉
harts	傐
has	兵
hat	典
hats	冀
hc	儵
hcG	兒
hcGk	児
hcg	䦖
hck	偰
hcl	ㄹ
hcn	偱
hcr	共
hcrn	兰
hcrnz	兲
hcrs	关
he	㔣
heG	偐
her	倰
herd	倲
herz	倱
het	健
hets	偦
hevd	㔢
hi	偵
hid	偶
hil	偷
hilz	傁
hip	傄
hipt	傅
hir	傆
hirz	傈
hit	傑
hiz	偸
ho	儴
hoI	ㄙ
hol	㠔
hold	儸
holdz	儹
holz	允
hom	兄
homz	兆
hop	兣
hops	入
hopt	兤
hosts	具
hoz	兴
hu	兓
hum	焐
hup	兙
hups	兠
hut	兡
huz	焈
hx	倵
hxm	儲
hyu	冉
hyuJ	冓
i	〆
iC	䔥
il	䕅
in	䕆
ir	䔦
irz	䔲
it	䔷
its	䔸
iv	䘈
iz	㑵
ja	垗
ju	概
k	䆆
k@	㠘
k@C	㡵
k@G	匧
k@f	㠧
k@k	㠢
k@l	㠥
k@m	㠶
k@mp	㠵
k@mps	㠸
k@mpt	㠷
k@n	㠹
k@nd	瀵
k@nt	㡀
k@nz	㡄
k@p	㡆
k@pt	偄
k@sts	㡨
k@t	㡩
k@ts	㡰
kE	㡠
kEl	匶
kEn	匷
kEnd	灲
kEpt	匸
kEr	䌑
kEt	慖
kI	㖆
kIG	㍀
kIGz	協
kIJ	垅
kId	卅
kIdz	卆
kIk	卂
kIks	卄
kIkt	千
kIl	升
kIld	午
kIlz	卉
kIm	卐
kIn	㥉
kInz	㥐
kIs	单
kIst	卖
kIt	㑗
kIts	㖇
kOGk	址
kOnz	䁱
kR	ざ
kRb	䉘
kRd	圦
kRdz	䉙
kRl	䉡
kRld	䉢
kRs	䉣
kRz	㐀
kU	䅁
kUd	䅰
kUk	䄹
kUks	䅂
kUkt	䅀
kW	䅨
kWC	䅧
kWn	䅲
kWnt	ぁ
kWnts	䅷
kWt	㤨
kWz	䆅
kY	㥆
kYl	卶
kYlz	卷
kYn	卒
kYnd	卑
kYndz	卓
kYt	南
k^	ぃ
k^G	却
k^b	䉉
k^d	䉓
k^l	䍹
k^m	㒘
k^mz	㒙
k^n	䅴
k^p	䉕
k^ps	䉗
k^s	䎖
k^st	䞅
k^t	䉦
ka	㍓
kab	䁤
kak	䁧
kam	䂆
kan	䂙
kap	傖
kaps	䅐
kar	㡈
kard	㡑
kardz	㡔
karl	㡗
kart	㡤
karts	㡧
karz	㡉
kat	㉳
kats	㉴
kc	㠱
kcf	䅩
kcl	㠩
kcld	㠰
kclm	㠳
kclz	㠲
kcr	〹
kcrd	䅑
kcrdz	䅒
kcrk	䅕
kcrkt	䅖
kcrn	䅗
kcst	䅤
kcsts	䅥
kct	㡷
kcz	㒗
ke	㠡
keJ	㠤
keZ	圥
kek	㍷
keks	㍸
kem	㒖
ken	㡂
kep	䘂
ker	㡕
kerz	㡖
kes	㙆
ket	䂒
kev	㢁
kevz	㢂
kez	匳
ki	㎇
kip	匴
kips	匵
kiz	㕦
kl	晘
kl@	䀄
kl@mp	䀂
kl@p	䀃
kl@s	䀅
klE	䀘
klErd	䌣
klErz	䌤
klI	䀠
klIG	㝢
klIGk	䀩
klIGz	䔉
klIk	䀙
klIn	㝀
klIp	䀰
klIps	䀳
klIpt	䀱
klIr	䀗
klR	斒
klW	䁆
klWd	䁅
klWdz	䁇
klWn	䁈
klWnz	䁉
klWs	䀆
klY	䀥
klYm	䀣
klYmd	䀤
klYmz	䀦
kl^	䁙
kl^G	䁘
kl^Gk	䁗
kl^b	䁐
kl^k	䁑
kl^m	䁕
kl^mps	䁔
kla	圗
klaT	䙘
klak	䀶
klaks	團
klap	䀷
klc	䀵
klcT	䁃
klcTs	灒
kle	䀇
kler	䌢
kli	㍉
klin	䀈
klind	䀉
klinz	䀒
klir	䀔
klird	䀕
klo	䁀
kloDz	䁄
kloks	䀴
klos	䀸
klozd	䀹
klu	䁒
kluz	䁓
klx	悖
ko	㥑
kod	䁰
kok	䁲
kol	䁶
kold	䁴
koldz	䁵
kolts	䂁
kom	䂄
komd	䂅
komz	䂈
kon	䄉
konz	墅
kor	䆁
kors	䆀
kos	䁠
kot	䁢
kots	䁣
koz	啂
kr@	䆐
kr@G	䆘
kr@Gk	䆗
kr@S	䈁
kr@St	䈂
kr@b	䆉
kr@k	䆑
kr@kt	䆒
kr@mpt	䆔
kr@n	䆕
kr@p	䈀
krE	䈓
krI	㦄
krIG	䈡
krIb	䈙
krIp	她
krIs	㦂
krIt	执
krIts	扨
krU	䈩
krUks	䈱
krW	䈵
krWd	䈴
krWn	䈷
krY	䉇
krYd	䈠
krYst	㦃
kr^S	䉄
kr^d	䈸
kr^m	䉀
kr^mz	䉁
kr^n	䉃
kr^nC	䉂
kr^s	䉆
kr^st	䉅
kra	䈦
krak	䈥
kras	䈳
krc	䈅
krcl	䈃
krcld	䈄
krclz	䈆
krcs	し
krcst	䈲
kre	䆓
kren	䆖
krezd	䈉
kri	䈑
krik	䈖
krim	䈐
krip	䈗
kris	到
kro	䈤
krod	䈶
kru	䈘
krum	煐
kruz	䈹
krx	喇
kt	攸
ku	䅅
kul	䅃
kuld	䅄
kun	䁩
kunz	恙
kup	䅆
kut	䉩
kw@	怸
kw@k	怷
kwE	㉷
kwEn	抂
kwEs	恈
kwI	ご
kwId	呖
kwIdz	呗
kwIk	恉
kwIlt	恑
kwIlts	恒
kwIn	恓
kwIp	䘀
kwIt	恔
kwIz	恖
kwIzd	恗
kwRd	㍡
kwRdz	㎑
kwY	恐
kwYrz	愔
kwYt	恕
kwa	恁
kwaS	㎒
kwan	卵
kwc	恂
kwcr	恃
kwek	䔴
kwel	怹
kwelz	恀
kwi	恄
kwik	恅
kwin	恆
kwot	恘
kx	゙
kxb	剶
kxbz	剷
kxd	䈰
kxg	悔
kxl	㈒
kxld	㝡
kxlt	䍸
kxlz	㈓
kxm	㦖
kxn	㄀
kxnd	扥
kxndz	扦
kxp	儉
kxps	儐
kxs	㦘
kxt	䡙
kxz	梔
kyU	䉠
kyUr	扩
kyard	㎓
kyu	㐰
kyub	䉐
kyubz	䉑
kyud	愕
kyum	瀀
kyumd	瀁
kyumz	瀂
kyus	䘤
kyut	䉧
kyuz	愖
kyuzd	あ
kyx	㕧
l@	ㄴ
l@C	厔
l@G	厈
l@f	厕
l@fs	厗
l@ft	厖
l@k	厀
l@ks	愆
l@kst	愇
l@m	厁
l@mp	厄
l@mz	厂
l@n	历
l@nd	厅
l@p	厑
l@ps	䁷
l@s	䙐
l@st	厓
lE	䕤
lEJ	吖
lEd	吕
lEf	吘
lEft	吗
lEg	吙
lEgz	吢
lEk	䁹
lEkt	䁸
lEktrp	䕖
lEs	㥳
lEt	吥
lEts	否
lI	ㅗ
lIG	㐉
lIGks	呑
lIGz	㢃
lIJ	げ
lIJd	こ
lIS	头
lISt	夵
lId	吰
lIdz	吱
lIf	吶
lIft	吵
lIfts	吷
lIg	ㅃ
lIk	䡳
lIks	ㅀ
lIkt	吩
lIl	呃
lImz	呅
lIn	ㅖ
lInJ	㤈
lInd	呈
lIns	捩
lInt	䘠
lIp	呔
lIps	呕
lIs	ㅐ
lIst	员
lIsts	呠
lIt	㚐
lIv	呡
lIvd	呢
lIvz	呣
lIz	呤
lR	㝘
lRd	䂀
lRdz	䎂
lRn	吐
lRnd	向
lRnz	吒
lRz	㕨
lU	呹
lUk	呸
lUks	咁
lUkt	咀
lUr	唇
lW	ㅠ
lWd	ㅡ
lY	ㅢ
lYd	吲
lYf	吴
lYk	ㅒ
lYks	呂
lYkt	呁
lYm	呆
lYn	ㄧ
lYnd	呉
lYt	䝔
lYts	䕗
lYv	ㅓ
lYz	吳
lYzd	䀁
l^	咘
l^k	唁
l^ks	䌴
l^m	唄
l^mp	唃
l^mz	䂃
l^n	呵
l^nC	唅
l^v	咖
l^vd	咗
l^vz	咙
la	䁳
lab	呰
lak	呱
laks	䤵
lakt	呲
lan	吁
lap	咈
larJ	厒
larm	ㄸ
lat	咔
lats	咕
lc	吀
lcG	ㅥ
lcGd	呶
lcGz	㔵
lcg	㡲
lcgz	㡱
lcn	厘
lcr	咑
lcrd	咉
lcrdz	咐
lcst	咓
le	㐆
led	吃
lek	ㅁ
lem	厃
len	厇
les	卸
lest	卹
let	䄕
lez	各
li	〠
liS	吓
lif	㔩
lin	吅
lind	吆
lip	吇
lips	吉
lipt	合
lis	䕧
list	吔
lit	䌲
liv	㔰
livd	㔱
livz	㔲
liz	㌒
lo	㊔
lod	㔴
lodz	呦
lof	呧
lon	ㅤ
lonz	周
lop	㡅
lops	䖘
lovz	呩
loz	䞉
lri	㢀
lrod	恧
lu	㐓
lum	咂
lun	㐐
lunz	㐑
lup	咃
lups	咅
lupt	咄
lus	咆
lust	咇
lut	〙
luz	咒
lwInd	焄
lwez	ㅷ
lx	ㅈ
lxdz	憙
lxk	䕕
lxm	䂂
lxn	㐤
lxnd	䡲
lxndz	剦
lxns	ㆆ
lxnz	㥧
lxs	䙖
lxts	挃
lxz	㦕
lyIn	喙
lyInt	㜣
lyR	䙳
m@	㍈
m@C	啕
m@G	唷
m@S	啑
m@St	啒
m@T	啘
m@d	唓
m@g	唔
m@gz	唘
m@k	ど
m@ks	啡
m@l	唧
m@m	唉
m@n	㑲
m@nd	䌵
m@p	唹
m@s	啓
m@t	厙
mE	ㆉ
mES	喀
mEZ	啱
mEg	啳
mEks	㐒
mEl	啶
mElt	啵
mElts	啷
mEm	啸
mEn	ㆈ
mEnt	㢉
mEnts	噅
mEr	嚘
mEs	䐴
mEst	喂
mEt	喃
mEts	喅
mI	䂉
mIC	戄
mIG	㔀
mIJ	䊈
mId	喐
mIk	䤃
mIks	䤄
mIkst	嘐
mIl	喘
mIlk	喗
mIn	㕄
mInd	䍘
mInt	ㆁ
mInts	剈
mInz	瀢
mIs	嘅
mIst	嘆
mIt	傗
mIts	呇
mIz	噈
mO	嘓
mR	㝸
mRd	捱
mRz	䙹
mW	嘹
mWT	噀
mWTs	噂
mWn	嘷
mWnt	㆒
mWs	嘸
mY	劕
mYk	喓
mYks	喔
mYl	喕
mYlz	喖
mYn	嘂
mYnd	嘁
mYndz	愉
mYs	喆
mYt	喒
m^	䤲
m^C	噉
m^G	㆑
m^Gks	㥤
m^S	噙
m^St	噠
m^d	噐
m^g	噒
m^gz	噓
m^k	啤
m^l	噔
m^m	噖
m^n	嘖
m^nC	噗
m^nT	嘠
m^nTs	嘡
m^s	噦
m^st	噤
ma	㈑
mal	唳
malt	唲
mam	嘔
mamz	嘕
man	嘘
mans	嘙
manst	嘗
map	嘩
maps	嘲
mapt	嘰
mar	啀
marC	啁
marS	啈
mark	啄
marks	商
markt	啅
marz	啇
maz	䥤
mc	啠
mcDz	嘶
mcl	唱
mcr	㐕
mcs	嘴
me	ㆂ
med	充
medz	唙
mek	唤
meks	唦
mekt	唥
mel	䕴
meld	唠
melz	唡
men	唢
met	啖
mets	啗
mez	ㆀ
mezd	ㅹ
mi	ㆇ
mil	啥
min	啦
mind	啧
minz	啨
mit	唆
mits	啲
miz	㝹
mo	䕰
mod	嘒
mon	桵
mor	㈸
mos	嘵
most	ㅣ
mot	䕸
moz	䕱
mu	唵
muS	嘥
mud	嘢
mun	嘣
mus	嘤
muv	噃
muvd	噄
muvz	噆
mw^n	攑
mwat	攔
mwer	攕
mx	㊒
mxJd	䊉
mxk	偀
mxl	㈉
mxlz	㈐
mxm	啢
mxn	㡘
mxnd	䍦
mxndz	䍧
mxnt	䖙
mxnts	や
mxnz	吣
mxs	䖐
mxz	唴
my^m	爘
my^mz	爙
myu	㆔
myulz	噕
myuzd	㆓
myx	䠅
n@	㐗
n@C	噶
n@U	圉
n@k	卙
n@n	噰
n@nz	噱
n@p	占
n@ps	噲
n@s	噴
n@t	䤦
nE	䍨
nEd	嚁
nEk	䄗
nEks	刱
nEkst	嚔
nEkt	䄖
nEl	塢
nEs	䆙
nEst	嚈
nEsts	嚉
nEt	剐
nI	㈈
nIC	教
nIG	㍖
nIJ	䑥
nIJd	唶
nIS	䅙
nISt	䜨
nIT	恩
nIg	圃
nIk	䀧
nIks	䀨
nIkt	堀
nIn	呐
nIns	唣
nInt	奴
nIp	唸
nIs	ㄒ
nIst	䀑
nIt	㙀
nIts	㠠
nO	㈘
nOd	堅
nOz	圂
nR	㐠
nRs	圖
nRv	嚅
nRvz	嚆
nRz	䀐
nU	圄
nW	園
nY	䌹
nYf	卣
nYfs	卤
nYn	圀
nYnT	圁
nYs	嚕
nYt	䥁
nYts	嚗
nYz	坠
nYzd	坡
n^	㈣
n^f	䖑
n^m	圕
n^n	刂
n^p	䀓
n^ps	倂
n^t	㠒
n^ts	䑐
na	け
nab	卥
nabz	卦
nak	卧
naks	卩
nakt	卨
nat	㡃
naz	噳
nc	噷
ncl	楳
ncr	䖉
ncrT	圇
ne	㡐
nel	䜥
nelz	䜦
nem	噧
nemd	噩
nemz	器
net	䅈
nez	啣
ni	㈔
niT	㕂
nid	嚂
nidz	嚃
nik	榄
nil	卢
nin	㘥
ninz	㘳
nir	噸
nis	嚖
nit	噹
niz	㈕
no	㘴
non	印
nop	圅
nops	圆
nor	列
not	圐
nots	䄙
noz	危
nozd	圈
nu	㍑
nud	愐
nun	㄂
nut	嘃
nuz	嚓
nx	㈠
nxl	㡒
nxld	䐷
nxldz	䐸
nxlz	㡓
nxm	夂
nxt	䑁
nxz	㈰
nyIn	坒
nyIns	䄸
nyR	匤
nyu	䄰
nyxn	坆
nyxs	䢇
o	㥂
ol	坃
old	坂
olz	坢
on	坈
ond	垁
ot	圙
ots	圠
oz	㤷
p	怔
p@	㌙
p@C	堠
p@Ct	堡
p@T	堢
p@d	呄
p@dz	垈
p@k	垄
p@ks	垇
p@kt	垆
p@l	垘
p@m	垙
p@n	㥠
p@nt	堂
p@nts	堃
p@nz	堁
p@s	堔
p@st	堕
p@t	堙
p@ts	堨
pE	䘵
pEG	塐
pEGg	塒
pEg	塈
pEgz	塉
pEkt	䘰
pEn	䍁
pEnd	䍀
pEndz	䍂
pEnz	塔
pEp	塕
pEr	奶
pErd	䂓
pEs	塤
pEt	塥
pEts	塧
pI	㉕
pI9	墇
pICt	墓
pIG	㞂
pIGk	墆
pIGz	䦘
pId	奀
pIg	塲
pIgz	塶
pIk	塩
pIks	塱
pIkt	塰
pIn	墀
pInC	墂
pInCt	境
pInt	抃
pInz	墈
pIp	墐
pIrz	塇
pIst	䌦
pIt	㡙
pIts	噘
pIz	奁
pO	大
pOn	䎑
pOnt	㉥
pOnts	夦
pOz	夨
pR	㔈
pRd	吤
pRl	塀
pRs	塣
pRz	䀲
pSIs	払
pU	奔
pUS	怲
pUSt	怳
pUl	怠
pUld	怡
pUlz	怢
pUr	奃
pUt	剀
pUts	怵
pW	奘
pWC	套
pWlz	奦
pWn	奡
pWnd	奠
pWndz	奢
pWnt	奙
pWt	焲
pY	䉰
pYk	塷
pYl	塸
pYlz	塹
pYn	墄
pYp	墉
pYr	瀆
pYz	䍑
p^	怗
p^G	怨
p^b	怖
p^f	怘
p^ft	怙
p^m	急
p^mp	怤
p^nC	性
p^p	奆
p^ps	怩
pa	㉈
pad	夥
pan	䅸
pand	夶
pans	愙
panz	䅹
pap	味
paps	呴
papt	奄
par	㉆
park	堈
parkt	堉
part	㉅
parts	堓
pat	奓
pats	奕
paz	䥥
pc	堲
pcl	堰
pclz	報
pcn	榑
pcr	刢
pcz	堳
pczd	場
pe	㉉
peJ	垉
peJd	垐
ped	垑
pel	垒
pen	垓
pent	垔
per	垕
perz	垖
pes	堘
pest	堗
pet	堒
pev	堵
pi	㉒
piC	堹
pid	㢓
pik	塁
piks	塂
pil	塃
pild	塄
pilz	㉑
pin	墁
pip	塅
pipt	塆
pir	䎐
pird	㉔
pis	噁
pit	塦
piz	儈
pkIn	怦
pl@	墖
pl@n	墕
pl@nt	増
pl@nts	墘
pl@s	墙
plE	夈
plEZ	夑
plEn	㉇
plI	䂗
plIG	䔗
plW	夔
plY	㉣
plYd	㉡
plYz	㉢
pl^	榅
pl^g	夕
pl^gd	外
pl^gz	夗
pl^m	夘
pl^mz	夙
pl^nJd	夠
pl^s	夡
plak	爩
plap	夒
plaps	夓
ple	䂔
pled	夃
plen	ㄨ
plenz	㄰
ples	䘓
plest	墔
plet	夀
plets	夁
plez	夆
pli	䂖
plit	䂕
pliz	変
plizd	夐
plo	䔘
plor	䘹
plu	夢
plx	䘷
po	䆈
pok	天
poks	失
pokt	夰
pol	夲
polz	夳
por	奣
porC	奇
pord	奤
port	嚒
porz	奥
pos	契
post	奉
posts	奒
poz	䐉
pozd	坓
pr@k	奧
prE	䙄
prEg	女
prEs	䙂
prEst	判
prEt	妄
prI	㉲
prIk	妈
prIkt	妉
prIn	妓
prIns	妒
prInts	䜧
prIs	奸
prIt	剑
prWd	怇
prWl	怐
prY	妐
prYm	妑
prYs	妇
prYv	䍃
prYvd	䍄
prYz	妕
prYzd	朩
pra	別
prab	妖
pre	奨
prer	奱
prerz	奲
prez	奩
prezd	奰
pri	㉦
priz	㡇
pro	刦
proCt	㉰
prop	㉱
pru	怉
pruf	怃
prunz	怑
pruv	怈
prx	妅
prxn	㉵
pti	䖀
pu	堄
pul	夸
pum	怣
pun	栃
pup	夹
pups	奂
puz	夷
px	㙢
pxl	㉘
pxld	楀
pxlz	㉙
pxn	偒
pxnd	偓
pxnz	偔
pxs	圩
pxt	嘱
pyU	怱
pyu	䂘
pyx	奅
r@	㞐
r@G	㙉
r@S	悀
r@f	䤆
r@fs	䤇
r@g	恣
r@gz	恤
r@l	䅠
r@m	恲
r@n	嘄
r@nC	恴
r@p	恵
r@ps	恶
r@pt	恷
r@s	恹
r@t	悂
r@ts	悃
r@z	悁
rE	ㅩ
rEd	悆
rEg	愂
rEk	㈡
rEks	愱
rEkt	䅡
rEm	愈
rEn	䍶
rEnt	堇
rEnts	愑
rEp	愓
rEr	恸
rEs	䔙
rEst	愠
rEt	㑄
rEts	㑅
rI	㆐
rIC	愹
rIG	ㄦ
rIGz	䔱
rIJ	㕕
rIS	䢖
rIbz	愷
rId	慁
rIf	挤
rIk	㤕
rImp	捙
rIn	䍴
rInJ	坖
rIns	㉓
rInst	慄
rInt	㉐
rInts	堆
rIp	慅
rIps	慈
rIpt	慇
rIs	䜅
rIst	䕶
rIt	㡡
rIts	㡢
rO	䅓
rOz	䅔
rR	䀖
rRz	䕹
rU	慤
rUf	慣
rUt	慧
rW	慳
rWn	朰
rWnd	㊙
rY	ㅱ
rYd	慂
rYdz	慃
rYm	愲
rYmz	愳
rYp	慆
rYs	愸
rYt	ㅰ
rYts	煡
rYvd	㌄
rYz	㊐
r^	慲
r^S	憉
r^St	憐
r^b	慶
r^bd	慷
r^bz	慸
r^f	慱
r^g	憀
r^gz	憃
r^m	憆
r^n	憇
r^nz	憈
r^pt	剒
ra	匰
raZ	䡩
rak	塡
raks	慗
ram	慡
ran	慢
rant	愡
rc	慒
rcG	煢
rcl	㥴
rcs	慩
re	㊃
red	䢀
rek	䔨
rel	恦
ren	㌂
renJ	㌀
renJd	㌁
rend	恨
renz	恰
res	恠
rest	恡
ret	㌢
rets	㌤
rez	恱
ri	㈗
riC	悄
riCt	悅
riT	煙
rid	㞒
ridz	悇
ril	剧
rin	杷
rinz	杸
rir	悈
ris	極
riz	㑴
ro	㙥
rod	㙤
rodz	慉
rol	慘
rold	慙
rolz	慠
rom	劗
rop	慨
ror	慐
rost	慑
rot	慰
rov	慵
roz	儆
ru	㊘
rud	慹
rul	憄
rulz	憅
rum	夅
rumz	噢
run	㑈
runz	㑉
rus	慦
ruz	匩
rx	ゆ
rxk	㤔
rxl	㑂
rxld	䜹
rxlz	㑃
rxm	䠈
rxn	㑇
rxnts	䥦
rxnz	匱
rxp	杤
rxs	䊗
rxz	㠴
s@	憘
s@G	戈
s@d	憑
s@k	卡
s@l	戁
s@m	戂
s@n	戆
s@nd	戅
s@nt	墒
s@t	戉
sE	㢄
sEd	憓
sEg	扵
sEk	扤
sEks	抔
sEl	㢇
sElf	儇
sElt	扶
sElvz	栩
sElz	㢈
sEm	㌥
sEn	㢑
sEnd	扷
sEndz	扸
sEns	批
sEnt	㢐
sEnts	㢔
sEp	〰
sEpt	〩
sEs	䘡
sEst	圤
sEt	抇
sEz	戔
sI	〴
sIG	㖙
sIGk	捲
sIGz	㘀
sIJ	喁
sIZ	䌙
sIb	换
sId	㖘
sIf	匑
sIg	捦
sIk	㈢
sIks	㑓
sIl	捰
sIm	䉱
sIn	㦓
sInd	㦅
sIns	圔
sInt	䌗
sInz	䚃
sIp	捳
sIps	捵
sIpt	捴
sIs	㌦
sIst	剁
sIsts	剃
sIt	㎁
sIts	捶
sIv	ㄐ
sIz	〧
sOld	攆
sR	㈥
sRC	扠
sRCt	扡
sRd	㈦
sRnd	䄃
sRnz	䄄
sRt	䄅
sRts	䄆
sRv	抄
sRvd	抅
sRvz	抆
sRz	㈧
sUr	枅
sW	攱
sWT	攳
sWn	攧
sWnd	攦
sWndz	攨
sY	䌘
sYd	㕉
sYdz	㕐
sYn	捥
sYnd	捧
sYnz	捨
sYt	䘢
sYz	䘦
sYzd	捸
s^	光
s^C	朕
s^b	朐
s^d	朠
s^dz	朙
s^k	朖
s^ks	朘
s^kt	朗
s^l	朤
s^m	攐
s^n	攖
s^nz	攠
s^p	朧
sa	攀
saI	榃
saZ	啔
sak	攁
saks	攂
sam	怒
samz	怓
sapt	攣
sc	䘧
scG	攗
scGz	攙
scf	攄
scft	攃
scl	唈
sclt	戀
sclts	攒
scr	䎄
scrt	㌩
scrts	攥
scrz	䎅
scs	㉗
se	䄇
sef	憒
sek	䠆
seks	憗
sel	憔
seld	憕
sem	戃
sent	憖
sev	我
sevd	戒
sevz	戓
sfYz	成
sfxl	朔
shEd	梙
sh^	捕
si	〄
sid	扰
sidz	扱
sik	儔
sil	扗
silz	托
sim	扲
simd	扳
simz	扴
sin	㦔
sinz	戢
sit	㡣
sits	悐
siv	悑
sivd	悒
sivz	悓
sixm	㠦
siz	〉
sk@	戡
sk@G	捹
sk@m	或
skE	怕
skEl	掃
skI	授
skIG	㌕
skIl	掅
skIlz	掆
skIn	掇
skIp	掉
skIps	掑
skIpt	掐
skIt	㑙
skIts	㑘
skR	坣
skRt	排
skRts	掓
skRz	坤
skY	掖
skYz	掄
sk^	䎔
sk^Gk	掕
sk^l	掔
sk^st	䎗
ska	戳
skaC	兩
skarf	戙
skat	戲
skcr	戱
ske	戠
skel	戕
skept	䘃
sker	戗
skerd	战
sket	掀
skets	掂
ski	嘧
sko	㜦
skord	戰
skot	冄
skoz	㜧
skr@	扁
skr@C	戹
skr@Ct	所
skr@m	戵
skr@ts	噣
skrI	扐
skrInz	朦
skrIp	妀
skr^	打
skr^b	扑
skr^bd	扒
skr^m	扔
skrcs	䈣
skre	戸
skrep	戶
skrept	户
skri	扃
skriC	扅
skrim	扂
skrimz	扄
skrin	扇
skru	扈
skrud	扉
sku	戧
skul	奷
skup	戨
skut	戩
skw	昔
skwEr	料
skwI	昙
skwIS	昗
skwISt	昘
skwId	昐
skwIn	昑
skwR	易
skwRm	昒
skwRt	昖
skwaS	昀
skwaSt	昁
skwc	昂
skwer	斗
skwerz	斘
skwi	昄
skwik	墑
skwiks	昅
skwikt	昃
skwil	昆
skwild	昇
skwiz	昈
skwizd	昉
skx	投
sl@	掙
sl@S	搂
sl@m	掗
sl@md	掘
sl@mz	搀
sl@pt	搁
slEpt	搐
slI	搤
slIG	搡
slIGk	搠
slId	搔
slIk	搓
slIp	搢
slIps	搥
slIpt	搣
slIs	榗
slR	搷
slW	搱
slWC	搰
slY	搗
slYd	搕
slYdz	搖
slYm	搙
slYs	搒
slYt	搘
sl^g	搵
sl^m	搶
sla	搧
slaS	搨
slab	搦
slat	搩
slev	搃
sli	䁁
slik	搄
slip	㌗
slips	搅
slit	搆
slits	搇
sliv	搈
slivz	搉
slo	搲
sloz	搴
slu	搑
slx	䉲
sm@	搹
sm@k	搸
sm@n	䐅
smE	摆
smEl	摄
smEld	摅
smElz	摇
smIT	摒
smY	摑
smYl	摈
smYld	摉
smYlz	摐
sm^	摡
sm^C	摘
sm^S	摙
sm^St	摠
smar	摃
smart	摂
smc	摁
smcl	摀
sme	䐆
smo	摔
smok	摓
smor	摗
smu	摖
smuD	摕
smxs	㦆
sn@	摤
sn@C	摳
sn@Ct	摴
sn@k	摢
sn@ks	摣
sn@p	摰
sn@ps	摲
sn@pt	摱
snI	堐
snIf	摹
snIp	撀
snIps	堑
snIpt	撁
sn^	撓
sn^f	撒
sn^g	撔
sn^k	撑
sna	撈
snat	撇
sncr	撆
sncrt	撅
sne	摩
snek	摧
sneks	摨
snel	摥
snelz	摦
sni	摶
snik	摵
sniz	摷
snizd	摸
sno	撄
snod	撐
snoz	撉
snups	撂
snuz	撃
so	ㅲ
sod	抑
sok	撗
sokt	撘
sol	攈
sold	攇
son	抒
sop	撙
sor	攤
sors	攲
soz	抓
sp@	䝀
sp@Gk	收
sp@N	攷
sp@n	攵
spE	䘄
spEk	䘱
spEks	敃
spEkts	䘳
spEl	敇
spEn	敉
spEnd	效
spEndz	敐
spEns	捷
spEnt	救
spI	㌣
spIl	敕
spIld	敖
spIlz	敗
spIn	敘
spInz	敡
spIt	敢
spIts	散
spOl	敳
spOld	整
spRd	焆
spWt	斆
spY	敓
spYk	敔
spYnz	敠
spYr	剄
spYs	敒
sp^G	斖
sp^d	斕
sp^n	敷
sp^nJ	敶
spa	斅
span	䅢
spand	愘
spar	敀
spat	䡡
spats	斄
sper	改
spes	攴
spi	䈢
spid	故
spidz	敆
spik	敁
spiks	敂
spl@	敥
spl@S	敤
spl@St	敦
spl@k	敲
spl@t	敧
splEn	敨
splI	敩
splIS	数
splIt	敱
splen	䘶
splo	䘸
spok	敵
sport	斂
sports	斃
spozd	䙁
spr@t	文
sprE	䙃
sprEd	㔄
sprEdz	斉
sprIG	斐
sprIGz	斑
sprInt	斓
spre	斈
sprus	斔
spul	數
spulz	敹
spun	斀
spunz	斁
spx	㌡
st@	昢
st@S	噥
st@k	偲
st@ks	偳
st@kt	昡
st@mp	昨
st@n	㦗
st@nd	昰
st@ndz	昲
st@ns	昩
stE	晃
stEd	剆
stEm	晒
stEnt	䙅
stEp	晓
stEps	晕
stEpt	晔
stEst	㕒
stI	攢
stIG	㠆
stIGg	䐒
stIGk	䐑
stIGks	晣
stIGkt	䐐
stId	㠅
stIk	㤖
stIks	晙
stIl	晡
stIn	㙦
stInt	䄡
stR	㑠
stRd	愁
stRz	䁡
stUd	晲
stWt	暀
stY	有
stYl	晠
st^	晦
st^G	月
st^f	朆
st^ft	朇
st^k	朅
sta	晤
stak	㒃
stam	晩
stamp	晧
stampt	晨
stap	䑄
staps	晵
stapt	晴
star	昳
starC	昴
start	昶
starts	昷
starv	昸
starvd	昹
starvz	晀
starz	昵
stc	奵
stcl	昧
stcr	晹
stcrm	晸
ste	映
steJ	昣
sted	晁
stek	晄
steks	晅
stel	昦
sten	昤
ster	春
sterz	䑔
stez	時
sti	㑡
stil	晆
stilz	晇
stim	晈
stimd	晉
stin	慥
stip	晐
stir	晑
stiv	晖
sto	晰
stol	晥
stonz	晱
stor	晶
storz	晷
stov	暁
str@k	䐔
str@kt	䙇
str@kts	䐕
str@p	暄
str@ps	暆
str@pt	暅
strE	暕
strEC	暔
strEGk	暑
strEGkT	暐
strEs	暒
strEst	暓
strIG	㉶
strIGz	挷
strIp	暗
strIs	嘉
strO	䍓
strYk	暖
strYp	暘
strYpt	暙
str^	會
str^k	䍔
str^kt	䄢
str^m	朄
strc	暇
strcG	朂
strcr	䙈
stre	䡐
stren	暃
strenJ	暂
strend	愢
stret	䌶
striks	暈
strim	䑕
strit	嘈
strits	暉
stro	䡶
strok	最
strol	朁
strx	則
strxs	䍤
stu	晗
stul	晳
stx	む
stxd	奐
stxlz	䉈
stxm	䔹
stxmd	い
stxn	即
stxns	剅
stxnt	䄠
stxnz	卲
stxz	其
su	抐
sud	朡
sum	㌰
sumd	㌱
sun	攡
sup	攩
sups	攰
sus	抉
sut	㑦
suts	㑧
suz	朢
sw@m	朴
swE	朸
swEl	材
swEpt	村
swEr	朷
swEt	朹
swI	杓
swIC	杘
swICt	杙
swIG	杕
swIGz	杖
swIS	杗
swIm	杒
swImz	杔
swRd	堖
swUS	条
swa	朳
swc	䞂
swcn	朵
swcnz	朶
swe	恢
swi	杄
swip	杂
swips	杅
swipt	权
swit	杆
swits	杇
swo	杠
sx	〘
sxk	朓
sxl	㜨
sxld	煠
sxlz	㜩
sxm	㍘
sxmd	㘑
sxmz	奈
sxn	爅
sxnt	刧
sxnz	呙
sxs	朲
sxz	ㅂ
t@	㌹
t@C	㌴
t@Ct	㌵
t@G	悕
t@Gk	枀
t@S	嘨
t@b	来
t@bz	杦
t@d	杧
t@g	杨
t@gz	杩
t@k	㌷
t@ks	桦
t@kt	㌸
t@l	剩
t@m	杶
t@n	坘
t@p	枂
t@ps	枉
t@pt	枈
t@s	㡳
t@t	析
t@z	枒
tE	㈩
tEk	怅
tEks	备
tEkst	䄩
tEkt	怄
tEl	栈
tElz	栉
tEm	抁
tEmpt	栐
tEn	㍁
tEnT	树
tEnd	妃
tEns	剉
tEnt	䄧
tEnts	䄨
tEr	栀
tErz	栁
tEst	怆
tI	ち
tIG	す
tIGz	䥳
tIJ	瀡
tIS	戴
tId	〲
tIk	㈱
tIks	㈲
tIl	桳
tIlt	桲
tIm	桴
tImz	桶
tIn	㍅
tIns	㌧
tInt	剂
tIp	䉔
tIps	桹
tIpt	桸
tIs	㠣
tIst	䉨
tIsts	䌸
tIv	つ
tO	梆
tOz	椗
tR	っ
tRb	䐖
tRd	㢒
tRf	㠑
tRm	栒
tRmz	栓
tRn	厐
tRnd	愧
tRnz	堩
tRz	ㅙ
tSI@	㤴
tSR	扆
tSRt	杀
tSRts	杁
tUS	楙
tUk	梖
tUt	椂
tW	椖
tWl	椔
tWlz	椕
tWn	䑖
tY	䖔
tYd	桩
tYl	桱
tYm	㉁
tYmz	攓
tYn	瀃
tYnz	瀄
tYp	楴
tYr	䖕
tYrd	愦
tYrz	梁
tYs	䖓
tYt	㉖
tYts	桰
tYz	嚀
t^	慔
t^C	椉
t^Ct	椐
t^G	梒
t^Gz	梓
t^b	㑱
t^f	椑
t^g	楗
t^gd	楘
t^k	楕
t^kt	楖
t^m	杈
t^mz	杉
t^n	梐
t^nz	梕
ta	倶
taG	梑
tad	梅
tak	梄
tam	梈
tamz	梉
tan	䡢
tap	䅳
taps	椃
tar	倕
tarts	枑
tc	杲
tck	坴
tcks	杴
tckt	杳
tcl	杵
tcr	椆
tcs	椇
tcst	椈
tct	林
te	䄤
tek	嘇
teks	東
tel	䅦
telz	杰
ten	䄣
tend	䄥
tenz	䄦
tep	枃
teps	枇
tept	构
tes	枕
test	枓
tests	枔
tet	䘅
tets	删
ti	で
tiC	枘
tiT	栄
tim	枙
tin	䕐
tinT	䜉
tinz	慴
tir	瀧
tis	栂
tiz	て
tli	㒑
tmInt	も
to	㥀
tod	梀
told	梇
ton	䅉
tor	椄
tord	椒
tordz	椓
torn	椅
tos	梃
tost	梂
toz	嘳
tr@	椠
tr@S	椧
tr@k	㍃
tr@ks	椘
tr@ns	椥
tr@p	䖗
tr@pt	椦
trE	䄲
trI	䕔
trIC	坦
trIk	䄂
trIks	㒔
trIkt	椴
trIm	椸
trIns	䖖
trIp	椹
trIpt	楁
trIs	㦙
trO	䍒
trW	楅
trWt	楆
trY	椳
trYd	椵
trYk	椷
trYz	椶
tr^	椩
tr^Gk	楉
tr^Gks	楐
tr^St	椨
tr^k	䍕
tr^ks	楇
tr^st	楑
tra	䕙
tram	楂
trc	椰
trcf	楄
tre	䄁
tred	椙
treld	椡
trelz	椢
tren	奖
trend	椣
trenz	椤
tret	䄀
tri	䅶
trigd	剔
triks	堧
tris	堦
trit	椱
trits	椲
triz	䅵
tro	䄵
trol	䄳
trold	䄴
trolz	䄶
tru	楈
truT	楒
trup	楃
trx	㡴
trxl	嚐
trxm	敄
trxmz	极
tu	剓
tuT	椀
tub	楓
tubz	楔
tud	㍂
tul	梗
tulz	梘
tun	㡥
tunz	㡦
tur	䍙
tut	朒
tuts	椁
tuz	枖
twElfT	楣
twElv	楤
twEn	楥
twEr	攅
twI	楧
twIG	楨
twIs	楱
twIst	㎐
twR	楰
twRl	楩
twY	楲
twYs	楦
twi	楡
twiks	楠
twin	㕔
twit	楢
tx	〱
txd	㜷
txl	㑶
txld	抈
txlz	㔑
txm	㐨
txmz	㙰
txn	㒓
txnd	㠓
txns	技
txnt	刣
txnz	㠕
txs	夤
txst	䚈
txz	䊅
u	䘕
up	坉
ups	坐
v@	䘇
v@m	瀅
v@n	瀇
v@nst	ゐ
v@nz	瀈
v@t	瀒
vE	杢
vEJ	瀓
vEl	瀕
vEm	圑
vEn	ゑ
vEnt	䘉
vEnts	妆
vEs	剖
vEsts	瀘
vI	づ
vIC	㜳
vIG	ぉ
vIGz	唀
vIZ	标
vId	䌆
vIk	瀙
vIl	堶
vIn	䕥
vInT	䕦
vInz	十
vIs	䌇
vIst	偙
vO	瀤
vOs	瀣
vR	㈖
vRd	䆄
vRn	瀗
vRs	愩
vRz	㒕
vW	䍣
vY	ゔ
vYn	䐠
vYnz	瀠
vYs	ん
vYts	剗
vYv	朱
vYz	吧
v^z	瀑
va	䉳
valvd	剘
valvz	剙
vcl	瀥
ve	ぢ
vel	瀖
velz	瀔
ven	瀐
vi	䄷
vil	愨
viz	噇
vo	䍢
vol	瀦
vrI	䚇
vri	䘐
vrum	瀨
vx	ㆅ
vxl	䍠
vxld	捠
vxlz	捖
vxn	䍡
vxnt	偩
vxnz	傒
vxs	嚇
vxt	妔
vyR	㔤
vyu	堸
w@	瀩
w@g	瀱
w@k	炁
w@ks	灡
w@m	炄
wE	灨
wEb	灩
wEbz	䁦
wEl	灷
wEn	炑
wEnt	灸
wEnz	灰
wEr	㍗
wErz	榁
wEst	喑
wEt	炀
wEw	炔
wI	䐓
wIC	炕
wID	焷
wIG	搳
wIGk	桷
wIGz	焩
wIS	焵
wISt	然
wIdT	焘
wIg	焠
wIk	焖
wIl	焣
wIld	焢
wIn	焥
wInd	焦
wIndz	焧
wInz	塓
wIp	焀
wIs	焅
wIt	焇
wR	吂
wRT	煗
wRd	䕄
wRdz	㄃
wRk	兇
wRks	煑
wRkt	煉
wRld	焃
wRldz	煒
wRm	利
wRmz	煓
wRnt	灹
wRs	煕
wRst	煖
wU	焒
wUd	元
wUdz	煆
wUf	煇
wUl	煂
wUlf	煁
wUp	焔
wUs	煣
wW	㚄
wWnd	煘
wY	炙
wYd	焗
wYf	焙
wYl	啩
wYld	無
wYn	炖
wYp	焰
wYps	焳
wYpt	焱
wYr	㐴
wYrz	焴
wYt	䔣
wYz	坧
w^	坅
w^n	㈹
w^ns	坄
w^nt	灃
w^nts	灅
w^nz	䘒
w^t	炅
w^ts	炆
w^z	灐
wa	㥒
waC	灗
waCt	灘
waS	儷
wal	灀
wan	灂
wand	灁
wants	灄
wasp	灔
wasps	灕
wc	瀰
wcS	灑
wcSt	灓
wck	捣
wcks	瀷
wckt	瀶
wcl	瀴
wclt	瀹
wclz	瀸
wcr	灆
wcrd	愰
wcrm	灇
wcrmd	灈
wcrn	灉
we	㉂
wek	㍕
weks	瀳
wel	炂
welz	炃
wer	㉄
werd	炓
werz	灧
west	灖
wet	瀲
wev	喉
wevd	灙
wevz	灠
wez	㉃
wi	単
wid	灢
widz	灱
wik	灦
wiks	灳
wil	灣
wilz	炐
win	倸
winz	灴
wir	灤
wird	灶
wit	炈
wiv	灥
wiz	灵
wo	焉
wok	煀
wont	煄
wor	煈
worn	煔
wu	煅
wuS	焕
wum	煃
wup	焑
wups	焓
x	〔
xb	〡
xd	塠
xl	ぱ
xlz	㢖
xm	㉸
xmz	嘑
xn	呒
xnz	呓
xp	榐
xs	㌘
xst	晢
xts	䍲
xz	㊂
y@G	煵
y@Gk	煳
y@Gks	煶
y@Gkt	煴
y@k	煨
y@ks	煩
y@m	煱
y@mz	煲
yE	熇
yEl	熈
yEld	熉
yElz	熐
yEp	熑
yEs	熓
yEt	熕
yI	熖
yIG	㉤
yIn	剰
yIpt	熘
yIr	呀
yR	䜘
yRd	䜖
yRz	䜗
yU	䘆
yUr	爐
yUrz	爑
yYks	熗
y^	爔
y^G	䕈
y^k	爓
y^ks	爕
y^m	爗
y^p	爠
ya	煦
yan	爃
yard	䚀
yarn	煷
yat	照
yaz	熂
yc	熀
ycl	煰
ycn	煸
ycnd	煹
ycr	爄
ycrk	爆
ye	熁
yeps	熒
yi	熃
yir	熄
yirz	熅
yist	熆
yo	熙
yok	爂
yu	㊈
yuT	爒
yuZ	榘
yud	䄱
yul	爇
yur	爈
yus	榖
yuv	爉
yuz	啙
yuzd	榆
yx	㕩
yxl	䊘
yxm	焤
yxnd	堷
yxnz	嘀
yxz	恇
z@	爢
z@g	爨
z@k	爡
z@kt	䘖
z@m	䘙
z@n	ㅄ
z@ps	爣
z@s	䎒
zE	坶
zEG	爥
zEn	愒
zI	䁖
zIG	ㆃ
zIg	爧
zIk	剥
zIlz	㑕
zIn	䆂
zInd	桓
zIns	妁
zInt	偢
zInts	如
zInz	䆃
zIp	榈
zIps	爰
zIpt	榉
zIs	愗
zIsts	䘨
zIt	䁂
zIts	坔
zIz	ゕ
zR	㚇
zRd	側
zRdz	呥
zRt	䍅
zRv	䍆
zRvd	圣
zRz	戦
zUn	倣
zY	煥
zYn	䍇
zYr	䍈
z^dz	爱
z^l	愤
z^lt	愣
z^lts	愥
z^nd	䢒
z^z	爳
za	䤷
zcl	䘗
zcr	〢
ze	䀀
zev	煤
zi	㙑
zin	唕
zinz	唖
ziz	䊄
zo	爵
zon	爴
zu	爲
zum	父
zus	爦
zuz	爷
zx	䔶
zxl	㑔
zxlz	怶
zxnt	䐤
zxs	劘
zxz	㉠
